"Lake","Date","Year","Month","DOY","Precip","SW_Inflw","TOTAL_GW_INTO_LAKE","Total_Inputs"
"AL","1975-09-30",1975,9,273,0,0,0,0
"AL","1975-10-01",1975,10,274,3650,9060,8980,21690
"AL","1975-10-02",1975,10,275,1710,7140,8520,17370
"AL","1975-10-03",1975,10,276,0,7070,8660,15730
"AL","1975-10-04",1975,10,277,0,7310,8750,16060
"AL","1975-10-05",1975,10,278,0,7350,8830,16180
"AL","1975-10-06",1975,10,279,0,7400,8890,16290
"AL","1975-10-07",1975,10,280,0,7500,8930,16430
"AL","1975-10-08",1975,10,281,0,7600,8960,16560
"AL","1975-10-09",1975,10,282,0,7900,8990,16890
"AL","1975-10-10",1975,10,283,0,8050,9020,17070
"AL","1975-10-11",1975,10,284,2730,8320,9000,20050
"AL","1975-10-12",1975,10,285,369,8220,8970,17559
"AL","1975-10-13",1975,10,286,3220,8210,8970,20400
"AL","1975-10-14",1975,10,287,3200,8620,8950,20770
"AL","1975-10-15",1975,10,288,1740,8370,8950,19060
"AL","1975-10-16",1975,10,289,0,8380,8990,17370
"AL","1975-10-17",1975,10,290,0,8400,9000,17400
"AL","1975-10-18",1975,10,291,0,8440,9010,17450
"AL","1975-10-19",1975,10,292,0,8510,9020,17530
"AL","1975-10-20",1975,10,293,0,8550,9020,17570
"AL","1975-10-21",1975,10,294,0,8560,9040,17600
"AL","1975-10-22",1975,10,295,0,8570,9060,17630
"AL","1975-10-23",1975,10,296,670,8580,9070,18320
"AL","1975-10-24",1975,10,297,18800,9830,9460,38090
"AL","1975-10-25",1975,10,298,17300,10200,9490,36990
"AL","1975-10-26",1975,10,299,32200,17500,20300,70000
"AL","1975-10-27",1975,10,300,0,10500,10100,20600
"AL","1975-10-28",1975,10,301,0,10100,8850,18950
"AL","1975-10-29",1975,10,302,0,10000,8930,18930
"AL","1975-10-30",1975,10,303,0,9950,8960,18910
"AL","1975-10-31",1975,10,304,0,9860,8980,18840
"AL","1975-11-01",1975,11,305,0,9790,9000,18790
"AL","1975-11-02",1975,11,306,0,9750,9030,18780
"AL","1975-11-03",1975,11,307,0,9730,9080,18810
"AL","1975-11-04",1975,11,308,0,9700,9130,18830
"AL","1975-11-05",1975,11,309,0,9650,9160,18810
"AL","1975-11-06",1975,11,310,0,9620,9200,18820
"AL","1975-11-07",1975,11,311,0,9600,9230,18830
"AL","1975-11-08",1975,11,312,1120,9590,9260,19970
"AL","1975-11-09",1975,11,313,6920,11000,9350,27270
"AL","1975-11-10",1975,11,314,3500,9800,9320,22620
"AL","1975-11-11",1975,11,315,105000,25700,12500,143200
"AL","1975-11-12",1975,11,316,1360,12400,12600,26360
"AL","1975-11-13",1975,11,317,18800,16100,14900,49800
"AL","1975-11-14",1975,11,318,2170,12100,9000,23270
"AL","1975-11-15",1975,11,319,0,11900,8740,20640
"AL","1975-11-16",1975,11,320,0,11700,8860,20560
"AL","1975-11-17",1975,11,321,0,11900,12000,23900
"AL","1975-11-18",1975,11,322,0,12700,14300,27000
"AL","1975-11-19",1975,11,323,0,13100,15900,29000
"AL","1975-11-20",1975,11,324,2040,13000,25700,40740
"AL","1975-11-21",1975,11,325,10800,12000,14100,36900
"AL","1975-11-22",1975,11,326,30600,11500,10100,52200
"AL","1975-11-23",1975,11,327,0,11300,9880,21180
"AL","1975-11-24",1975,11,328,0,11200,10000,21200
"AL","1975-11-25",1975,11,329,0,11100,10100,21200
"AL","1975-11-26",1975,11,330,0,11100,10100,21200
"AL","1975-11-27",1975,11,331,0,11000,10200,21200
"AL","1975-11-28",1975,11,332,0,11000,10200,21200
"AL","1975-11-29",1975,11,333,0,10900,10200,21100
"AL","1975-11-30",1975,11,334,13700,10900,9940,34540
"AL","1975-12-01",1975,12,335,44300,10800,9280,64380
"AL","1975-12-02",1975,12,336,1460,10800,9450,21710
"AL","1975-12-03",1975,12,337,0,10800,9750,20550
"AL","1975-12-04",1975,12,338,0,10700,9830,20530
"AL","1975-12-05",1975,12,339,1910,10700,9840,22450
"AL","1975-12-06",1975,12,340,0,10700,9890,20590
"AL","1975-12-07",1975,12,341,644,10600,9920,21164
"AL","1975-12-08",1975,12,342,0,10600,9940,20540
"AL","1975-12-09",1975,12,343,0,10600,9970,20570
"AL","1975-12-10",1975,12,344,0,10600,9990,20590
"AL","1975-12-11",1975,12,345,3990,10500,9920,24410
"AL","1975-12-12",1975,12,346,386,10500,9940,20826
"AL","1975-12-13",1975,12,347,0,10500,9960,20460
"AL","1975-12-14",1975,12,348,0,10500,9980,20480
"AL","1975-12-15",1975,12,349,30600,10500,9430,50530
"AL","1975-12-16",1975,12,350,7200,10500,9360,27060
"AL","1975-12-17",1975,12,351,0,10500,9570,20070
"AL","1975-12-18",1975,12,352,0,10500,9680,20180
"AL","1975-12-19",1975,12,353,0,10400,9740,20140
"AL","1975-12-20",1975,12,354,0,10400,9780,20180
"AL","1975-12-21",1975,12,355,6770,10400,9680,26850
"AL","1975-12-22",1975,12,356,129,10400,9730,20259
"AL","1975-12-23",1975,12,357,0,10400,9790,20190
"AL","1975-12-24",1975,12,358,0,10400,9820,20220
"AL","1975-12-25",1975,12,359,0,10400,9840,20240
"AL","1975-12-26",1975,12,360,620,10400,9840,20860
"AL","1975-12-27",1975,12,361,129,10400,9860,20389
"AL","1975-12-28",1975,12,362,0,10400,9870,20270
"AL","1975-12-29",1975,12,363,0,10400,9890,20290
"AL","1975-12-30",1975,12,364,0,10300,9890,20190
"AL","1975-12-31",1975,12,365,0,10300,9900,20200
"AL","1976-01-01",1976,1,1,0,10300,9910,20210
"AL","1976-01-02",1976,1,2,0,10300,9920,20220
"AL","1976-01-03",1976,1,3,17700,10300,9590,37590
"AL","1976-01-04",1976,1,4,3690,10300,9560,23550
"AL","1976-01-05",1976,1,5,0,10300,9680,19980
"AL","1976-01-06",1976,1,6,0,10300,9730,20030
"AL","1976-01-07",1976,1,7,8670,10300,9600,28570
"AL","1976-01-08",1976,1,8,4260,10300,9560,24120
"AL","1976-01-09",1976,1,9,0,10300,9640,19940
"AL","1976-01-10",1976,1,10,0,10300,9690,19990
"AL","1976-01-11",1976,1,11,0,10300,9720,20020
"AL","1976-01-12",1976,1,12,18400,10300,9400,38100
"AL","1976-01-13",1976,1,13,0,10300,9460,19760
"AL","1976-01-14",1976,1,14,0,10300,9590,19890
"AL","1976-01-15",1976,1,15,0,10300,9640,19940
"AL","1976-01-16",1976,1,16,1560,10300,9630,21490
"AL","1976-01-17",1976,1,17,4730,10300,9570,24600
"AL","1976-01-18",1976,1,18,0,10300,9610,19910
"AL","1976-01-19",1976,1,19,0,10300,9650,19950
"AL","1976-01-20",1976,1,20,11400,10300,9460,31160
"AL","1976-01-21",1976,1,21,6100,10300,9390,25790
"AL","1976-01-22",1976,1,22,3670,10300,9420,23390
"AL","1976-01-23",1976,1,23,645,10300,9480,20425
"AL","1976-01-24",1976,1,24,7710,10300,9390,27400
"AL","1976-01-25",1976,1,25,7930,10300,9310,27540
"AL","1976-01-26",1976,1,26,3660,10300,9330,23290
"AL","1976-01-27",1976,1,27,1510,10300,9400,21210
"AL","1976-01-28",1976,1,28,0,10300,9460,19760
"AL","1976-01-29",1976,1,29,645,10300,9490,20435
"AL","1976-01-30",1976,1,30,10800,10200,9330,30330
"AL","1976-01-31",1976,1,31,11800,10200,9160,31160
"AL","1976-02-01",1976,2,32,0,10200,9270,19470
"AL","1976-02-02",1976,2,33,2760,10200,9330,22290
"AL","1976-02-03",1976,2,34,0,10200,9390,19590
"AL","1976-02-04",1976,2,35,1400,10200,9410,21010
"AL","1976-02-05",1976,2,36,2250,10200,9400,21850
"AL","1976-02-06",1976,2,37,0,10200,9430,19630
"AL","1976-02-07",1976,2,38,0,10200,9470,19670
"AL","1976-02-08",1976,2,39,0,10200,9490,19690
"AL","1976-02-09",1976,2,40,0,10200,9510,19710
"AL","1976-02-10",1976,2,41,0,10100,9520,19620
"AL","1976-02-11",1976,2,42,1220,10100,9510,20830
"AL","1976-02-12",1976,2,43,1060,10100,9500,20660
"AL","1976-02-13",1976,2,44,0,10100,9510,19610
"AL","1976-02-14",1976,2,45,0,10100,9520,19620
"AL","1976-02-15",1976,2,46,0,10100,9520,19620
"AL","1976-02-16",1976,2,47,23000,10100,9110,42210
"AL","1976-02-17",1976,2,48,258,10100,9140,19498
"AL","1976-02-18",1976,2,49,0,10000,9290,19290
"AL","1976-02-19",1976,2,50,4270,10000,9250,23520
"AL","1976-02-20",1976,2,51,2890,10000,9240,22130
"AL","1976-02-21",1976,2,52,692,10000,9280,19972
"AL","1976-02-22",1976,2,53,0,9990,9320,19310
"AL","1976-02-23",1976,2,54,281,9970,9330,19581
"AL","1976-02-24",1976,2,55,0,9960,9350,19310
"AL","1976-02-25",1976,2,56,0,9950,9360,19310
"AL","1976-02-26",1976,2,57,0,9930,9370,19300
"AL","1976-02-27",1976,2,58,0,9920,9380,19300
"AL","1976-02-28",1976,2,59,0,9900,9390,19290
"AL","1976-02-29",1976,2,60,0,9890,9380,19270
"AL","1976-03-01",1976,3,61,1170,9870,9350,20390
"AL","1976-03-02",1976,3,62,8270,9860,9190,27320
"AL","1976-03-03",1976,3,63,26600,9850,8750,45200
"AL","1976-03-04",1976,3,64,1660,9840,8810,20310
"AL","1976-03-05",1976,3,65,2410,9830,8950,21190
"AL","1976-03-06",1976,3,66,16900,9820,8720,35440
"AL","1976-03-07",1976,3,67,0,9810,8790,18600
"AL","1976-03-08",1976,3,68,949,9800,8910,19659
"AL","1976-03-09",1976,3,69,0,9790,8970,18760
"AL","1976-03-10",1976,3,70,0,9780,9030,18810
"AL","1976-03-11",1976,3,71,0,9760,9070,18830
"AL","1976-03-12",1976,3,72,0,9750,9100,18850
"AL","1976-03-13",1976,3,73,29400,9730,8590,47720
"AL","1976-03-14",1976,3,74,9120,9720,8490,27330
"AL","1976-03-15",1976,3,75,0,9710,8700,18410
"AL","1976-03-16",1976,3,76,0,9700,8840,18540
"AL","1976-03-17",1976,3,77,861,9690,8880,19431
"AL","1976-03-18",1976,3,78,237,9670,8910,18817
"AL","1976-03-19",1976,3,79,2630,9660,8930,21220
"AL","1976-03-20",1976,3,80,0,9640,9000,18640
"AL","1976-03-21",1976,3,81,0,9620,9090,18710
"AL","1976-03-22",1976,3,82,0,9610,9140,18750
"AL","1976-03-23",1976,3,83,0,9590,9120,18710
"AL","1976-03-24",1976,3,84,0,9570,9140,18710
"AL","1976-03-25",1976,3,85,0,9560,9170,18730
"AL","1976-03-26",1976,3,86,474,9540,9180,19194
"AL","1976-03-27",1976,3,87,558,9520,9180,19258
"AL","1976-03-28",1976,3,88,1440,9510,9160,20110
"AL","1976-03-29",1976,3,89,1940,9490,10300,21730
"AL","1976-03-30",1976,3,90,3900,11100,18000,33000
"AL","1976-03-31",1976,3,91,26700,16600,32600,75900
"AL","1976-04-01",1976,4,92,8770,13100,14000,35870
"AL","1976-04-02",1976,4,93,2050,12000,12800,26850
"AL","1976-04-03",1976,4,94,0,12100,12900,25000
"AL","1976-04-04",1976,4,95,0,14000,16300,30300
"AL","1976-04-05",1976,4,96,0,11900,12000,23900
"AL","1976-04-06",1976,4,97,0,12800,14100,26900
"AL","1976-04-07",1976,4,98,0,13900,16100,30000
"AL","1976-04-08",1976,4,99,0,14000,15500,29500
"AL","1976-04-09",1976,4,100,0,13000,13500,26500
"AL","1976-04-10",1976,4,101,0,13700,15900,29600
"AL","1976-04-11",1976,4,102,6220,71600,89700,167520
"AL","1976-04-12",1976,4,103,522,17800,18300,36622
"AL","1976-04-13",1976,4,104,0,13800,14200,28000
"AL","1976-04-14",1976,4,105,0,16100,18900,35000
"AL","1976-04-15",1976,4,106,1580,78800,96200,176580
"AL","1976-04-16",1976,4,107,0,32900,24900,57800
"AL","1976-04-17",1976,4,108,759,16000,12300,29059
"AL","1976-04-18",1976,4,109,0,14500,12300,26800
"AL","1976-04-19",1976,4,110,9680,15900,12600,38180
"AL","1976-04-20",1976,4,111,12100,18100,13700,43900
"AL","1976-04-21",1976,4,112,0,14400,12500,26900
"AL","1976-04-22",1976,4,113,10600,15800,13600,40000
"AL","1976-04-23",1976,4,114,16000,21000,18000,55000
"AL","1976-04-24",1976,4,115,0,14600,12300,26900
"AL","1976-04-25",1976,4,116,0,14300,12300,26600
"AL","1976-04-26",1976,4,117,0,14100,12200,26300
"AL","1976-04-27",1976,4,118,0,13900,12100,26000
"AL","1976-04-28",1976,4,119,0,13800,11900,25700
"AL","1976-04-29",1976,4,120,0,13600,11800,25400
"AL","1976-04-30",1976,4,121,0,13500,11800,25300
"AL","1976-05-01",1976,5,122,3290,13400,11800,28490
"AL","1976-05-02",1976,5,123,10300,16300,11900,38500
"AL","1976-05-03",1976,5,124,27700,19400,20100,67200
"AL","1976-05-04",1976,5,125,5330,14600,13100,33030
"AL","1976-05-05",1976,5,126,0,13600,11700,25300
"AL","1976-05-06",1976,5,127,0,13500,11800,25300
"AL","1976-05-07",1976,5,128,508,13500,11600,25608
"AL","1976-05-08",1976,5,129,0,13000,11500,24500
"AL","1976-05-09",1976,5,130,0,12800,11400,24200
"AL","1976-05-10",1976,5,131,0,12500,11400,23900
"AL","1976-05-11",1976,5,132,0,11900,11300,23200
"AL","1976-05-12",1976,5,133,0,11700,11300,23000
"AL","1976-05-13",1976,5,134,0,11400,11200,22600
"AL","1976-05-14",1976,5,135,0,11300,11100,22400
"AL","1976-05-15",1976,5,136,508,11300,11100,22908
"AL","1976-05-16",1976,5,137,0,11100,11100,22200
"AL","1976-05-17",1976,5,138,23000,12800,11000,46800
"AL","1976-05-18",1976,5,139,6170,12900,10800,29870
"AL","1976-05-19",1976,5,140,0,11900,10900,22800
"AL","1976-05-20",1976,5,141,0,11700,11000,22700
"AL","1976-05-21",1976,5,142,0,11300,11000,22300
"AL","1976-05-22",1976,5,143,0,10900,11000,21900
"AL","1976-05-23",1976,5,144,0,10900,10900,21800
"AL","1976-05-24",1976,5,145,0,10800,10900,21700
"AL","1976-05-25",1976,5,146,0,10800,10900,21700
"AL","1976-05-26",1976,5,147,0,10800,10900,21700
"AL","1976-05-27",1976,5,148,0,10800,10900,21700
"AL","1976-05-28",1976,5,149,0,10700,10900,21600
"AL","1976-05-29",1976,5,150,0,10700,10800,21500
"AL","1976-05-30",1976,5,151,14400,10700,10700,35800
"AL","1976-05-31",1976,5,152,30600,14900,10400,55900
"AL","1976-06-01",1976,6,153,3580,11900,10300,25780
"AL","1976-06-02",1976,6,154,0,11600,10500,22100
"AL","1976-06-03",1976,6,155,0,11400,10600,22000
"AL","1976-06-04",1976,6,156,0,11100,10700,21800
"AL","1976-06-05",1976,6,157,0,10800,10700,21500
"AL","1976-06-06",1976,6,158,0,10800,10800,21600
"AL","1976-06-07",1976,6,159,0,10700,10800,21500
"AL","1976-06-08",1976,6,160,0,10700,10800,21500
"AL","1976-06-09",1976,6,161,10700,11300,10600,32600
"AL","1976-06-10",1976,6,162,5320,11500,10500,27320
"AL","1976-06-11",1976,6,163,0,10800,10500,21300
"AL","1976-06-12",1976,6,164,28100,14700,10300,53100
"AL","1976-06-13",1976,6,165,0,11600,10100,21700
"AL","1976-06-14",1976,6,166,37200,15100,10500,62800
"AL","1976-06-15",1976,6,167,1910,11900,10000,23810
"AL","1976-06-16",1976,6,168,46600,12400,17400,76400
"AL","1976-06-17",1976,6,169,5110,12100,10400,27610
"AL","1976-06-18",1976,6,170,0,11300,10400,21700
"AL","1976-06-19",1976,6,171,32000,12900,16300,61200
"AL","1976-06-20",1976,6,172,6080,13200,10800,30080
"AL","1976-06-21",1976,6,173,1450,12100,10700,24250
"AL","1976-06-22",1976,6,174,0,11600,10700,22300
"AL","1976-06-23",1976,6,175,0,11300,10700,22000
"AL","1976-06-24",1976,6,176,0,11000,10700,21700
"AL","1976-06-25",1976,6,177,0,10900,10600,21500
"AL","1976-06-26",1976,6,178,7130,11200,10500,28830
"AL","1976-06-27",1976,6,179,0,10700,10500,21200
"AL","1976-06-28",1976,6,180,552,10700,10500,21752
"AL","1976-06-29",1976,6,181,0,10600,10500,21100
"AL","1976-06-30",1976,6,182,38900,12300,10900,62100
"AL","1976-07-01",1976,7,183,1520,11600,10200,23320
"AL","1976-07-02",1976,7,184,0,11000,10500,21500
"AL","1976-07-03",1976,7,185,0,10800,10700,21500
"AL","1976-07-04",1976,7,186,0,10400,10700,21100
"AL","1976-07-05",1976,7,187,0,10400,10800,21200
"AL","1976-07-06",1976,7,188,0,10300,10900,21200
"AL","1976-07-07",1976,7,189,0,10300,10900,21200
"AL","1976-07-08",1976,7,190,7920,10800,10700,29420
"AL","1976-07-09",1976,7,191,0,10200,10600,20800
"AL","1976-07-10",1976,7,192,0,10200,10700,20900
"AL","1976-07-11",1976,7,193,0,10200,10700,20900
"AL","1976-07-12",1976,7,194,1710,10100,10600,22410
"AL","1976-07-13",1976,7,195,0,10100,10700,20800
"AL","1976-07-14",1976,7,196,0,10000,10600,20600
"AL","1976-07-15",1976,7,197,0,10000,10600,20600
"AL","1976-07-16",1976,7,198,467,9990,10600,21057
"AL","1976-07-17",1976,7,199,2310,10100,10500,22910
"AL","1976-07-18",1976,7,200,0,9930,10400,20330
"AL","1976-07-19",1976,7,201,0,9890,10500,20390
"AL","1976-07-20",1976,7,202,0,9860,10500,20360
"AL","1976-07-21",1976,7,203,27900,12500,10200,50600
"AL","1976-07-22",1976,7,204,0,10500,9990,20490
"AL","1976-07-23",1976,7,205,0,10300,10300,20600
"AL","1976-07-24",1976,7,206,0,9890,10300,20190
"AL","1976-07-25",1976,7,207,0,9820,10300,20120
"AL","1976-07-26",1976,7,208,0,9760,10200,19960
"AL","1976-07-27",1976,7,209,0,9720,10200,19920
"AL","1976-07-28",1976,7,210,0,9680,10200,19880
"AL","1976-07-29",1976,7,211,2920,9650,10200,22770
"AL","1976-07-30",1976,7,212,0,9620,10100,19720
"AL","1976-07-31",1976,7,213,1520,9580,10100,21200
"AL","1976-08-01",1976,8,214,14400,11300,9910,35610
"AL","1976-08-02",1976,8,215,0,10100,9830,19930
"AL","1976-08-03",1976,8,216,0,9910,10000,19910
"AL","1976-08-04",1976,8,217,0,9550,10000,19550
"AL","1976-08-05",1976,8,218,15300,9500,9820,34620
"AL","1976-08-06",1976,8,219,112000,44300,37200,193500
"AL","1976-08-07",1976,8,220,0,14800,12000,26800
"AL","1976-08-08",1976,8,221,0,12700,9310,22010
"AL","1976-08-09",1976,8,222,0,12300,9560,21860
"AL","1976-08-10",1976,8,223,0,12100,9650,21750
"AL","1976-08-11",1976,8,224,8600,12200,9690,30490
"AL","1976-08-12",1976,8,225,11500,13800,9720,35020
"AL","1976-08-13",1976,8,226,0,12000,9750,21750
"AL","1976-08-14",1976,8,227,2980,11700,9880,24560
"AL","1976-08-15",1976,8,228,0,11300,9890,21190
"AL","1976-08-16",1976,8,229,0,11100,9930,21030
"AL","1976-08-17",1976,8,230,0,10900,10000,20900
"AL","1976-08-18",1976,8,231,0,10600,10100,20700
"AL","1976-08-19",1976,8,232,0,10400,10200,20600
"AL","1976-08-20",1976,8,233,0,10300,10100,20400
"AL","1976-08-21",1976,8,234,0,10200,10100,20300
"AL","1976-08-22",1976,8,235,0,10100,10100,20200
"AL","1976-08-23",1976,8,236,0,10100,10000,20100
"AL","1976-08-24",1976,8,237,0,9990,10100,20090
"AL","1976-08-25",1976,8,238,0,9930,10100,20030
"AL","1976-08-26",1976,8,239,0,9870,10200,20070
"AL","1976-08-27",1976,8,240,877,9820,10100,20797
"AL","1976-08-28",1976,8,241,0,9780,10000,19780
"AL","1976-08-29",1976,8,242,0,9730,10100,19830
"AL","1976-08-30",1976,8,243,0,9680,9990,19670
"AL","1976-08-31",1976,8,244,4910,9640,9830,24380
"AL","1976-09-01",1976,9,245,0,9620,9790,19410
"AL","1976-09-02",1976,9,246,8760,10500,9670,28930
"AL","1976-09-03",1976,9,247,0,9890,9570,19460
"AL","1976-09-04",1976,9,248,0,9910,9610,19520
"AL","1976-09-05",1976,9,249,0,9780,9630,19410
"AL","1976-09-06",1976,9,250,0,9600,9600,19200
"AL","1976-09-07",1976,9,251,879,9540,9570,19989
"AL","1976-09-08",1976,9,252,0,9480,9590,19070
"AL","1976-09-09",1976,9,253,0,9370,9630,19000
"AL","1976-09-10",1976,9,254,0,9330,9610,18940
"AL","1976-09-11",1976,9,255,0,9300,9550,18850
"AL","1976-09-12",1976,9,256,0,9290,9520,18810
"AL","1976-09-13",1976,9,257,0,9240,9500,18740
"AL","1976-09-14",1976,9,258,0,9210,9500,18710
"AL","1976-09-15",1976,9,259,11600,9600,9350,30550
"AL","1976-09-16",1976,9,260,0,9290,9260,18550
"AL","1976-09-17",1976,9,261,0,9330,9300,18630
"AL","1976-09-18",1976,9,262,0,9290,9300,18590
"AL","1976-09-19",1976,9,263,0,9240,9300,18540
"AL","1976-09-20",1976,9,264,0,9180,9300,18480
"AL","1976-09-21",1976,9,265,2760,9300,9230,21290
"AL","1976-09-22",1976,9,266,371,9220,9190,18781
"AL","1976-09-23",1976,9,267,1990,9230,9160,20380
"AL","1976-09-24",1976,9,268,0,9220,9130,18350
"AL","1976-09-25",1976,9,269,0,9280,9120,18400
"AL","1976-09-26",1976,9,270,0,9280,9120,18400
"AL","1976-09-27",1976,9,271,110,9250,9110,18470
"AL","1976-09-28",1976,9,272,1950,9320,9070,20340
"AL","1976-09-29",1976,9,273,0,9230,9050,18280
"AL","1976-09-30",1976,9,274,0,9330,9060,18390
"AL","1976-10-01",1976,10,275,0,9290,9070,18360
"AL","1976-10-02",1976,10,276,0,9210,9070,18280
"AL","1976-10-03",1976,10,277,0,9050,9060,18110
"AL","1976-10-04",1976,10,278,0,8910,9040,17950
"AL","1976-10-05",1976,10,279,3080,8850,9000,20930
"AL","1976-10-06",1976,10,280,4640,9550,8850,23040
"AL","1976-10-07",1976,10,281,0,9380,8810,18190
"AL","1976-10-08",1976,10,282,0,9370,8840,18210
"AL","1976-10-09",1976,10,283,0,9450,8830,18280
"AL","1976-10-10",1976,10,284,4510,9750,8790,23050
"AL","1976-10-11",1976,10,285,0,9550,8770,18320
"AL","1976-10-12",1976,10,286,0,9590,8810,18400
"AL","1976-10-13",1976,10,287,0,9610,8840,18450
"AL","1976-10-14",1976,10,288,0,9640,8870,18510
"AL","1976-10-15",1976,10,289,0,9640,8870,18510
"AL","1976-10-16",1976,10,290,1340,9650,8880,19870
"AL","1976-10-17",1976,10,291,5840,10200,8820,24860
"AL","1976-10-18",1976,10,292,1480,10200,8830,20510
"AL","1976-10-19",1976,10,293,0,9710,8860,18570
"AL","1976-10-20",1976,10,294,1720,9720,8850,20290
"AL","1976-10-21",1976,10,295,0,9720,8880,18600
"AL","1976-10-22",1976,10,296,243,9710,8890,18843
"AL","1976-10-23",1976,10,297,0,9670,8890,18560
"AL","1976-10-24",1976,10,298,0,9670,8900,18570
"AL","1976-10-25",1976,10,299,0,9660,8910,18570
"AL","1976-10-26",1976,10,300,0,9650,8930,18580
"AL","1976-10-27",1976,10,301,0,9640,8940,18580
"AL","1976-10-28",1976,10,302,0,9630,8940,18570
"AL","1976-10-29",1976,10,303,0,9620,8970,18590
"AL","1976-10-30",1976,10,304,0,9610,9000,18610
"AL","1976-10-31",1976,10,305,0,9590,9010,18600
"AL","1976-11-01",1976,11,306,0,9590,9010,18600
"AL","1976-11-02",1976,11,307,0,9580,9020,18600
"AL","1976-11-03",1976,11,308,1720,9590,9030,20340
"AL","1976-11-04",1976,11,309,0,9550,9040,18590
"AL","1976-11-05",1976,11,310,2730,9540,8990,21260
"AL","1976-11-06",1976,11,311,0,9530,9000,18530
"AL","1976-11-07",1976,11,312,0,9510,9020,18530
"AL","1976-11-08",1976,11,313,333,9500,9010,18843
"AL","1976-11-09",1976,11,314,230,9500,8980,18710
"AL","1976-11-10",1976,11,315,0,9500,8980,18480
"AL","1976-11-11",1976,11,316,4710,9490,8900,23100
"AL","1976-11-12",1976,11,317,230,9470,8900,18600
"AL","1976-11-13",1976,11,318,230,9460,8920,18610
"AL","1976-11-14",1976,11,319,0,9450,8930,18380
"AL","1976-11-15",1976,11,320,0,9430,8930,18360
"AL","1976-11-16",1976,11,321,0,9420,8930,18350
"AL","1976-11-17",1976,11,322,0,9410,8930,18340
"AL","1976-11-18",1976,11,323,0,9390,8930,18320
"AL","1976-11-19",1976,11,324,0,9370,8940,18310
"AL","1976-11-20",1976,11,325,0,9360,8940,18300
"AL","1976-11-21",1976,11,326,0,9350,8930,18280
"AL","1976-11-22",1976,11,327,1690,9330,8890,19910
"AL","1976-11-23",1976,11,328,0,9320,8880,18200
"AL","1976-11-24",1976,11,329,0,9310,8870,18180
"AL","1976-11-25",1976,11,330,0,9290,8860,18150
"AL","1976-11-26",1976,11,331,3000,9280,8810,21090
"AL","1976-11-27",1976,11,332,17100,9280,8510,34890
"AL","1976-11-28",1976,11,333,1290,9260,8530,19080
"AL","1976-11-29",1976,11,334,0,9250,8630,17880
"AL","1976-11-30",1976,11,335,0,9240,8660,17900
"AL","1976-12-01",1976,12,336,0,9230,8680,17910
"AL","1976-12-02",1976,12,337,0,9220,8690,17910
"AL","1976-12-03",1976,12,338,0,9210,8700,17910
"AL","1976-12-04",1976,12,339,655,9200,8690,18545
"AL","1976-12-05",1976,12,340,1810,9190,8670,19670
"AL","1976-12-06",1976,12,341,0,9180,8680,17860
"AL","1976-12-07",1976,12,342,1290,9170,8670,19130
"AL","1976-12-08",1976,12,343,0,9160,8670,17830
"AL","1976-12-09",1976,12,344,0,9140,8680,17820
"AL","1976-12-10",1976,12,345,222,9130,8680,18032
"AL","1976-12-11",1976,12,346,526,9120,8670,18316
"AL","1976-12-12",1976,12,347,0,9110,8670,17780
"AL","1976-12-13",1976,12,348,0,9100,8670,17770
"AL","1976-12-14",1976,12,349,0,9080,8670,17750
"AL","1976-12-15",1976,12,350,0,9070,8670,17740
"AL","1976-12-16",1976,12,351,0,9060,8670,17730
"AL","1976-12-17",1976,12,352,0,9050,8670,17720
"AL","1976-12-18",1976,12,353,0,9030,8660,17690
"AL","1976-12-19",1976,12,354,0,9020,8660,17680
"AL","1976-12-20",1976,12,355,0,9010,8650,17660
"AL","1976-12-21",1976,12,356,3580,9000,8580,21160
"AL","1976-12-22",1976,12,357,129,8990,8580,17699
"AL","1976-12-23",1976,12,358,281,8980,8580,17841
"AL","1976-12-24",1976,12,359,632,8970,8570,18172
"AL","1976-12-25",1976,12,360,597,8950,8560,18107
"AL","1976-12-26",1976,12,361,995,8940,8550,18485
"AL","1976-12-27",1976,12,362,0,8930,8550,17480
"AL","1976-12-28",1976,12,363,3490,8920,8490,20900
"AL","1976-12-29",1976,12,364,129,8910,8500,17539
"AL","1976-12-30",1976,12,365,0,8900,8520,17420
"AL","1976-12-31",1976,12,366,0,8880,8520,17400
"AL","1977-01-01",1977,1,1,0,8870,8520,17390
"AL","1977-01-02",1977,1,2,0,8860,8520,17380
"AL","1977-01-03",1977,1,3,215,8850,8510,17575
"AL","1977-01-04",1977,1,4,3870,8840,8440,21150
"AL","1977-01-05",1977,1,5,430,8830,8440,17700
"AL","1977-01-06",1977,1,6,0,8820,8460,17280
"AL","1977-01-07",1977,1,7,0,8800,8460,17260
"AL","1977-01-08",1977,1,8,0,8790,8460,17250
"AL","1977-01-09",1977,1,9,3140,8780,8400,20320
"AL","1977-01-10",1977,1,10,0,8770,8410,17180
"AL","1977-01-11",1977,1,11,0,8760,8430,17190
"AL","1977-01-12",1977,1,12,0,8750,8430,17180
"AL","1977-01-13",1977,1,13,0,8740,8430,17170
"AL","1977-01-14",1977,1,14,4300,8730,8350,21380
"AL","1977-01-15",1977,1,15,742,8720,8340,17802
"AL","1977-01-16",1977,1,16,0,8710,8360,17070
"AL","1977-01-17",1977,1,17,0,8700,8370,17070
"AL","1977-01-18",1977,1,18,0,8690,8370,17060
"AL","1977-01-19",1977,1,19,312,8670,8370,17352
"AL","1977-01-20",1977,1,20,0,8660,8370,17030
"AL","1977-01-21",1977,1,21,0,8650,8370,17020
"AL","1977-01-22",1977,1,22,0,8640,8360,17000
"AL","1977-01-23",1977,1,23,0,8630,8360,16990
"AL","1977-01-24",1977,1,24,3240,8620,8300,20160
"AL","1977-01-25",1977,1,25,1210,8610,8290,18110
"AL","1977-01-26",1977,1,26,2640,8600,8260,19500
"AL","1977-01-27",1977,1,27,2600,8590,8230,19420
"AL","1977-01-28",1977,1,28,0,8580,8250,16830
"AL","1977-01-29",1977,1,29,781,8560,8250,17591
"AL","1977-01-30",1977,1,30,840,8550,8240,17630
"AL","1977-01-31",1977,1,31,0,8540,8250,16790
"AL","1977-02-01",1977,2,32,312,8530,8250,17092
"AL","1977-02-02",1977,2,33,0,8520,8250,16770
"AL","1977-02-03",1977,2,34,0,8510,8260,16770
"AL","1977-02-04",1977,2,35,985,8500,8240,17725
"AL","1977-02-05",1977,2,36,0,8490,8240,16730
"AL","1977-02-06",1977,2,37,0,8480,8240,16720
"AL","1977-02-07",1977,2,38,0,8460,8230,16690
"AL","1977-02-08",1977,2,39,0,8450,8230,16680
"AL","1977-02-09",1977,2,40,750,8440,8210,17400
"AL","1977-02-10",1977,2,41,0,8430,8210,16640
"AL","1977-02-11",1977,2,42,0,8420,8220,16640
"AL","1977-02-12",1977,2,43,0,8410,8220,16630
"AL","1977-02-13",1977,2,44,0,8430,8220,16650
"AL","1977-02-14",1977,2,45,1380,8430,8190,18000
"AL","1977-02-15",1977,2,46,551,8400,8170,17121
"AL","1977-02-16",1977,2,47,0,8380,8170,16550
"AL","1977-02-17",1977,2,48,0,8360,8160,16520
"AL","1977-02-18",1977,2,49,0,8350,8160,16510
"AL","1977-02-19",1977,2,50,0,8340,8160,16500
"AL","1977-02-20",1977,2,51,0,8330,8150,16480
"AL","1977-02-21",1977,2,52,0,8320,8140,16460
"AL","1977-02-22",1977,2,53,0,8310,8130,16440
"AL","1977-02-23",1977,2,54,0,8300,8130,16430
"AL","1977-02-24",1977,2,55,1220,8290,8100,17610
"AL","1977-02-25",1977,2,56,7330,8280,7970,23580
"AL","1977-02-26",1977,2,57,5260,8280,7890,21430
"AL","1977-02-27",1977,2,58,0,8270,7940,16210
"AL","1977-02-28",1977,2,59,258,8260,7980,16498
"AL","1977-03-01",1977,3,60,0,8250,8000,16250
"AL","1977-03-02",1977,3,61,0,8240,8010,16250
"AL","1977-03-03",1977,3,62,0,8230,8030,16260
"AL","1977-03-04",1977,3,63,9280,8220,7870,25370
"AL","1977-03-05",1977,3,64,23900,8220,7520,39640
"AL","1977-03-06",1977,3,65,16100,8210,7370,31680
"AL","1977-03-07",1977,3,66,0,8210,7550,15760
"AL","1977-03-08",1977,3,67,0,8200,7720,15920
"AL","1977-03-09",1977,3,68,0,8190,7820,16010
"AL","1977-03-10",1977,3,69,0,8190,7920,16110
"AL","1977-03-11",1977,3,70,0,8500,8320,16820
"AL","1977-03-12",1977,3,71,0,9270,8720,17990
"AL","1977-03-13",1977,3,72,25300,116000,70600,211900
"AL","1977-03-14",1977,3,73,10800,16200,19900,46900
"AL","1977-03-15",1977,3,74,1410,11400,9340,22150
"AL","1977-03-16",1977,3,75,0,10200,7660,17860
"AL","1977-03-17",1977,3,76,0,10000,7750,17750
"AL","1977-03-18",1977,3,77,0,9780,7740,17520
"AL","1977-03-19",1977,3,78,23900,9610,7400,40910
"AL","1977-03-20",1977,3,79,0,9440,7490,16930
"AL","1977-03-21",1977,3,80,0,9300,7680,16980
"AL","1977-03-22",1977,3,81,0,9190,7760,16950
"AL","1977-03-23",1977,3,82,0,9090,7850,16940
"AL","1977-03-24",1977,3,83,237,9730,8330,18297
"AL","1977-03-25",1977,3,84,0,9100,8070,17170
"AL","1977-03-26",1977,3,85,0,8940,8090,17030
"AL","1977-03-27",1977,3,86,0,8850,8100,16950
"AL","1977-03-28",1977,3,87,11400,9990,8310,29700
"AL","1977-03-29",1977,3,88,512,8960,8000,17472
"AL","1977-03-30",1977,3,89,20700,12000,10500,43200
"AL","1977-03-31",1977,3,90,5800,10200,8060,24060
"AL","1977-04-01",1977,4,91,1290,9420,7880,18590
"AL","1977-04-02",1977,4,92,1120,9090,7900,18110
"AL","1977-04-03",1977,4,93,27200,9420,7660,44280
"AL","1977-04-04",1977,4,94,9660,9180,7720,26560
"AL","1977-04-05",1977,4,95,1490,9440,10600,21530
"AL","1977-04-06",1977,4,96,18700,9140,7860,35700
"AL","1977-04-07",1977,4,97,0,9060,7710,16770
"AL","1977-04-08",1977,4,98,558,9010,7830,17398
"AL","1977-04-09",1977,4,99,0,8960,7920,16880
"AL","1977-04-10",1977,4,100,0,8930,8090,17020
"AL","1977-04-11",1977,4,101,0,10600,16900,27500
"AL","1977-04-12",1977,4,102,0,14600,12100,26700
"AL","1977-04-13",1977,4,103,885,9750,8100,18735
"AL","1977-04-14",1977,4,104,29300,16300,16700,62300
"AL","1977-04-15",1977,4,105,0,10300,7860,18160
"AL","1977-04-16",1977,4,106,13400,13300,10700,37400
"AL","1977-04-17",1977,4,107,15600,14000,13000,42600
"AL","1977-04-18",1977,4,108,10200,11700,10600,32500
"AL","1977-04-19",1977,4,109,19500,14200,14100,47800
"AL","1977-04-20",1977,4,110,15200,13900,12800,41900
"AL","1977-04-21",1977,4,111,2530,10900,8230,21660
"AL","1977-04-22",1977,4,112,37100,18600,21100,76800
"AL","1977-04-23",1977,4,113,871,11900,8300,21071
"AL","1977-04-24",1977,4,114,0,11200,8510,19710
"AL","1977-04-25",1977,4,115,632,11000,8580,20212
"AL","1977-04-26",1977,4,116,0,10800,8580,19380
"AL","1977-04-27",1977,4,117,0,10700,8640,19340
"AL","1977-04-28",1977,4,118,0,10500,8700,19200
"AL","1977-04-29",1977,4,119,0,10400,8760,19160
"AL","1977-04-30",1977,4,120,0,10300,8800,19100
"AL","1977-05-01",1977,5,121,0,10300,8850,19150
"AL","1977-05-02",1977,5,122,0,10200,8900,19100
"AL","1977-05-03",1977,5,123,0,10100,8950,19050
"AL","1977-05-04",1977,5,124,0,10000,8990,18990
"AL","1977-05-05",1977,5,125,0,9980,8990,18970
"AL","1977-05-06",1977,5,126,25100,13200,12800,51100
"AL","1977-05-07",1977,5,127,1780,10600,8690,21070
"AL","1977-05-08",1977,5,128,0,10100,8740,18840
"AL","1977-05-09",1977,5,129,0,9540,8690,18230
"AL","1977-05-10",1977,5,130,0,9290,8680,17970
"AL","1977-05-11",1977,5,131,0,8990,8660,17650
"AL","1977-05-12",1977,5,132,0,8750,8620,17370
"AL","1977-05-13",1977,5,133,0,8680,8630,17310
"AL","1977-05-14",1977,5,134,0,8630,8650,17280
"AL","1977-05-15",1977,5,135,0,8580,8650,17230
"AL","1977-05-16",1977,5,136,0,8550,8630,17180
"AL","1977-05-17",1977,5,137,7250,9380,8470,25100
"AL","1977-05-18",1977,5,138,0,8800,8390,17190
"AL","1977-05-19",1977,5,139,8240,9260,8330,25830
"AL","1977-05-20",1977,5,140,0,8510,8290,16800
"AL","1977-05-21",1977,5,141,0,8420,8320,16740
"AL","1977-05-22",1977,5,142,9790,9120,8220,27130
"AL","1977-05-23",1977,5,143,8610,9050,8100,25760
"AL","1977-05-24",1977,5,144,0,8510,8120,16630
"AL","1977-05-25",1977,5,145,0,8400,8190,16590
"AL","1977-05-26",1977,5,146,6090,8320,8150,22560
"AL","1977-05-27",1977,5,147,369,8290,8180,16839
"AL","1977-05-28",1977,5,148,0,8260,8240,16500
"AL","1977-05-29",1977,5,149,0,8240,8260,16500
"AL","1977-05-30",1977,5,150,0,8210,8270,16480
"AL","1977-05-31",1977,5,151,0,8180,8270,16450
"AL","1977-06-01",1977,6,152,16000,8790,8100,32890
"AL","1977-06-02",1977,6,153,33500,12800,7800,54100
"AL","1977-06-03",1977,6,154,4490,9890,7590,21970
"AL","1977-06-04",1977,6,155,0,9260,7810,17070
"AL","1977-06-05",1977,6,156,26400,12000,7980,46380
"AL","1977-06-06",1977,6,157,29400,10200,12800,52400
"AL","1977-06-07",1977,6,158,3640,9850,7710,21200
"AL","1977-06-08",1977,6,159,3520,9640,7840,21000
"AL","1977-06-09",1977,6,160,507,9440,7960,17907
"AL","1977-06-10",1977,6,161,1010,9090,8020,18120
"AL","1977-06-11",1977,6,162,4050,8850,8070,20970
"AL","1977-06-12",1977,6,163,253,8750,8080,17083
"AL","1977-06-13",1977,6,164,0,8550,8120,16670
"AL","1977-06-14",1977,6,165,0,8410,8160,16570
"AL","1977-06-15",1977,6,166,0,8350,8180,16530
"AL","1977-06-16",1977,6,167,0,8300,8210,16510
"AL","1977-06-17",1977,6,168,8190,8480,8140,24810
"AL","1977-06-18",1977,6,169,2280,8730,8100,19110
"AL","1977-06-19",1977,6,170,13100,9040,8050,30190
"AL","1977-06-20",1977,6,171,5760,9040,7960,22760
"AL","1977-06-21",1977,6,172,22600,11300,7970,41870
"AL","1977-06-22",1977,6,173,0,8970,7860,16830
"AL","1977-06-23",1977,6,174,0,8800,8050,16850
"AL","1977-06-24",1977,6,175,11100,8740,8050,27890
"AL","1977-06-25",1977,6,176,5110,9080,8010,22200
"AL","1977-06-26",1977,6,177,12300,13000,8010,33310
"AL","1977-06-27",1977,6,178,0,9280,7960,17240
"AL","1977-06-28",1977,6,179,13300,9060,8060,30420
"AL","1977-06-29",1977,6,180,16500,11000,8260,35760
"AL","1977-06-30",1977,6,181,6580,9940,7930,24450
"AL","1977-07-01",1977,7,182,25300,10700,8670,44670
"AL","1977-07-02",1977,7,183,16200,12600,8470,37270
"AL","1977-07-03",1977,7,184,0,9520,7920,17440
"AL","1977-07-04",1977,7,185,34100,14900,15200,64200
"AL","1977-07-05",1977,7,186,1520,9900,7810,19230
"AL","1977-07-06",1977,7,187,14500,13300,8920,36720
"AL","1977-07-07",1977,7,188,0,9770,8040,17810
"AL","1977-07-08",1977,7,189,0,9340,8190,17530
"AL","1977-07-09",1977,7,190,11400,10200,8200,29800
"AL","1977-07-10",1977,7,191,0,9130,8130,17260
"AL","1977-07-11",1977,7,192,0,8890,8220,17110
"AL","1977-07-12",1977,7,193,0,8700,8250,16950
"AL","1977-07-13",1977,7,194,350,8620,8300,17270
"AL","1977-07-14",1977,7,195,1770,8600,8280,18650
"AL","1977-07-15",1977,7,196,7000,8510,8260,23770
"AL","1977-07-16",1977,7,197,5250,8940,8240,22430
"AL","1977-07-17",1977,7,198,656,8510,8260,17426
"AL","1977-07-18",1977,7,199,6400,8970,8240,23610
"AL","1977-07-19",1977,7,200,0,8430,8240,16670
"AL","1977-07-20",1977,7,201,0,8350,8310,16660
"AL","1977-07-21",1977,7,202,1870,8430,8310,18610
"AL","1977-07-22",1977,7,203,0,8280,8300,16580
"AL","1977-07-23",1977,7,204,0,8350,8360,16710
"AL","1977-07-24",1977,7,205,0,8230,8340,16570
"AL","1977-07-25",1977,7,206,0,8310,8310,16620
"AL","1977-07-26",1977,7,207,0,8170,8400,16570
"AL","1977-07-27",1977,7,208,0,8220,8330,16550
"AL","1977-07-28",1977,7,209,0,8120,8260,16380
"AL","1977-07-29",1977,7,210,13100,8860,8100,30060
"AL","1977-07-30",1977,7,211,1450,8470,8000,17920
"AL","1977-07-31",1977,7,212,9980,9200,7990,27170
"AL","1977-08-01",1977,8,213,29000,11300,7750,48050
"AL","1977-08-02",1977,8,214,1710,8890,7600,18200
"AL","1977-08-03",1977,8,215,0,8600,7810,16410
"AL","1977-08-04",1977,8,216,18800,8870,7790,35460
"AL","1977-08-05",1977,8,217,6440,9410,7720,23570
"AL","1977-08-06",1977,8,218,3640,8820,7820,20280
"AL","1977-08-07",1977,8,219,0,8470,7900,16370
"AL","1977-08-08",1977,8,220,0,8370,7980,16350
"AL","1977-08-09",1977,8,221,0,8220,8040,16260
"AL","1977-08-10",1977,8,222,0,8090,8060,16150
"AL","1977-08-11",1977,8,223,9240,8630,7980,25850
"AL","1977-08-12",1977,8,224,0,8230,7940,16170
"AL","1977-08-13",1977,8,225,0,8170,8000,16170
"AL","1977-08-14",1977,8,226,19000,9500,7880,36380
"AL","1977-08-15",1977,8,227,9870,9780,7750,27400
"AL","1977-08-16",1977,8,228,0,8660,7810,16470
"AL","1977-08-17",1977,8,229,50100,17200,10900,78200
"AL","1977-08-18",1977,8,230,0,9540,7490,17030
"AL","1977-08-19",1977,8,231,0,9490,7720,17210
"AL","1977-08-20",1977,8,232,0,9310,7800,17110
"AL","1977-08-21",1977,8,233,0,9090,7840,16930
"AL","1977-08-22",1977,8,234,18900,10800,7970,37670
"AL","1977-08-23",1977,8,235,0,9310,7750,17060
"AL","1977-08-24",1977,8,236,0,9120,7880,17000
"AL","1977-08-25",1977,8,237,0,8890,7910,16800
"AL","1977-08-26",1977,8,238,0,8720,7930,16650
"AL","1977-08-27",1977,8,239,11000,9910,7910,28820
"AL","1977-08-28",1977,8,240,133000,48800,58400,240200
"AL","1977-08-29",1977,8,241,17600,19200,27200,64000
"AL","1977-08-30",1977,8,242,0,13200,12500,25700
"AL","1977-08-31",1977,8,243,0,11700,8490,20190
"AL","1977-09-01",1977,9,244,181000,79000,87600,347600
"AL","1977-09-02",1977,9,245,7600,22600,32900,63100
"AL","1977-09-03",1977,9,246,6620,17600,21300,45520
"AL","1977-09-04",1977,9,247,1210,14700,10900,26810
"AL","1977-09-05",1977,9,248,16800,15400,15200,47400
"AL","1977-09-06",1977,9,249,163,14100,11200,25463
"AL","1977-09-07",1977,9,250,26800,20400,19700,66900
"AL","1977-09-08",1977,9,251,1360,14900,11800,28060
"AL","1977-09-09",1977,9,252,0,14200,11700,25900
"AL","1977-09-10",1977,9,253,13900,17600,13300,44800
"AL","1977-09-11",1977,9,254,0,14200,11600,25800
"AL","1977-09-12",1977,9,255,3190,13700,11500,28390
"AL","1977-09-13",1977,9,256,16000,17300,14200,47500
"AL","1977-09-14",1977,9,257,0,13900,11200,25100
"AL","1977-09-15",1977,9,258,0,13500,11200,24700
"AL","1977-09-16",1977,9,259,0,13200,11100,24300
"AL","1977-09-17",1977,9,260,6490,13500,11000,30990
"AL","1977-09-18",1977,9,261,1060,13000,10800,24860
"AL","1977-09-19",1977,9,262,2200,12700,10800,25700
"AL","1977-09-20",1977,9,263,31100,18000,16000,65100
"AL","1977-09-21",1977,9,264,715,13300,10600,24615
"AL","1977-09-22",1977,9,265,0,12900,10600,23500
"AL","1977-09-23",1977,9,266,13000,13700,12300,39000
"AL","1977-09-24",1977,9,267,8750,15500,12800,37050
"AL","1977-09-25",1977,9,268,33000,22500,25400,80900
"AL","1977-09-26",1977,9,269,13200,18800,17700,49700
"AL","1977-09-27",1977,9,270,4070,16200,13700,33970
"AL","1977-09-28",1977,9,271,756,14200,11100,26056
"AL","1977-09-29",1977,9,272,303,13700,11200,25203
"AL","1977-09-30",1977,9,273,9150,14400,11600,35150
"AL","1977-10-01",1977,10,274,495,14000,11300,25795
"AL","1977-10-02",1977,10,275,0,13500,11200,24700
"AL","1977-10-03",1977,10,276,0,13200,11100,24300
"AL","1977-10-04",1977,10,277,0,12900,11000,23900
"AL","1977-10-05",1977,10,278,1740,12700,10900,25340
"AL","1977-10-06",1977,10,279,4630,13100,10900,28630
"AL","1977-10-07",1977,10,280,0,13100,10900,24000
"AL","1977-10-08",1977,10,281,0,12900,10900,23800
"AL","1977-10-09",1977,10,282,35600,20900,19000,75500
"AL","1977-10-10",1977,10,283,4980,17000,13900,35880
"AL","1977-10-11",1977,10,284,0,14400,11300,25700
"AL","1977-10-12",1977,10,285,29100,20800,22200,72100
"AL","1977-10-13",1977,10,286,9840,17800,16700,44340
"AL","1977-10-14",1977,10,287,0,15100,11900,27000
"AL","1977-10-15",1977,10,288,0,14400,11400,25800
"AL","1977-10-16",1977,10,289,0,14300,11400,25700
"AL","1977-10-17",1977,10,290,0,14200,11300,25500
"AL","1977-10-18",1977,10,291,0,14100,11300,25400
"AL","1977-10-19",1977,10,292,11700,15100,11500,38300
"AL","1977-10-20",1977,10,293,1110,14300,11500,26910
"AL","1977-10-21",1977,10,294,0,13800,11300,25100
"AL","1977-10-22",1977,10,295,0,13800,11200,25000
"AL","1977-10-23",1977,10,296,0,13700,11200,24900
"AL","1977-10-24",1977,10,297,0,13700,11100,24800
"AL","1977-10-25",1977,10,298,0,13600,11100,24700
"AL","1977-10-26",1977,10,299,1090,13600,11100,25790
"AL","1977-10-27",1977,10,300,0,13500,11100,24600
"AL","1977-10-28",1977,10,301,0,13500,11100,24600
"AL","1977-10-29",1977,10,302,0,13400,11100,24500
"AL","1977-10-30",1977,10,303,0,13400,11100,24500
"AL","1977-10-31",1977,10,304,0,13400,11100,24500
"AL","1977-11-01",1977,11,305,5360,13300,11300,29960
"AL","1977-11-02",1977,11,306,8290,15000,11200,34490
"AL","1977-11-03",1977,11,307,256,13500,11000,24756
"AL","1977-11-04",1977,11,308,1280,13500,11000,25780
"AL","1977-11-05",1977,11,309,0,13200,10900,24100
"AL","1977-11-06",1977,11,310,0,13100,11000,24100
"AL","1977-11-07",1977,11,311,93.1,13100,11000,24193.1
"AL","1977-11-08",1977,11,312,12200,15900,11300,39400
"AL","1977-11-09",1977,11,313,1700,14300,11100,27100
"AL","1977-11-10",1977,11,314,1250,13600,10900,25750
"AL","1977-11-11",1977,11,315,1300,13400,10900,25600
"AL","1977-11-12",1977,11,316,5400,13200,10700,29300
"AL","1977-11-13",1977,11,317,0,13200,10700,23900
"AL","1977-11-14",1977,11,318,0,13200,10800,24000
"AL","1977-11-15",1977,11,319,0,13100,10800,23900
"AL","1977-11-16",1977,11,320,0,13100,10900,24000
"AL","1977-11-17",1977,11,321,128,13000,10800,23928
"AL","1977-11-18",1977,11,322,1690,13100,10800,25590
"AL","1977-11-19",1977,11,323,230,13000,10800,24030
"AL","1977-11-20",1977,11,324,0,12900,10800,23700
"AL","1977-11-21",1977,11,325,21400,13000,10700,45100
"AL","1977-11-22",1977,11,326,6130,14900,12200,33230
"AL","1977-11-23",1977,11,327,0,13300,10900,24200
"AL","1977-11-24",1977,11,328,7000,13100,10800,30900
"AL","1977-11-25",1977,11,329,7090,13100,10700,30890
"AL","1977-11-26",1977,11,330,4440,13000,10700,28140
"AL","1977-11-27",1977,11,331,0,13000,10800,23800
"AL","1977-11-28",1977,11,332,3500,12900,10800,27200
"AL","1977-11-29",1977,11,333,6090,12900,10700,29690
"AL","1977-11-30",1977,11,334,0,12800,10800,23600
"AL","1977-12-01",1977,12,335,0,12800,10900,23700
"AL","1977-12-02",1977,12,336,5680,12800,10800,29280
"AL","1977-12-03",1977,12,337,0,12700,10800,23500
"AL","1977-12-04",1977,12,338,0,12700,10900,23600
"AL","1977-12-05",1977,12,339,0,12700,10900,23600
"AL","1977-12-06",1977,12,340,4050,12600,10800,27450
"AL","1977-12-07",1977,12,341,2760,12600,10800,26160
"AL","1977-12-08",1977,12,342,0,12600,10800,23400
"AL","1977-12-09",1977,12,343,632,12600,10800,24032
"AL","1977-12-10",1977,12,344,7150,12500,10700,30350
"AL","1977-12-11",1977,12,345,386,12500,10700,23586
"AL","1977-12-12",1977,12,346,0,12500,10800,23300
"AL","1977-12-13",1977,12,347,0,12400,10800,23200
"AL","1977-12-14",1977,12,348,0,12400,10800,23200
"AL","1977-12-15",1977,12,349,0,12400,10800,23200
"AL","1977-12-16",1977,12,350,0,12300,10800,23100
"AL","1977-12-17",1977,12,351,0,12300,10800,23100
"AL","1977-12-18",1977,12,352,1930,12300,10800,25030
"AL","1977-12-19",1977,12,353,9760,16700,19300,45760
"AL","1977-12-20",1977,12,354,442,14200,14100,28742
"AL","1977-12-21",1977,12,355,3850,13200,11700,28750
"AL","1977-12-22",1977,12,356,8650,12900,10800,32350
"AL","1977-12-23",1977,12,357,1030,12700,10700,24430
"AL","1977-12-24",1977,12,358,0,12600,10800,23400
"AL","1977-12-25",1977,12,359,2120,12600,10700,25420
"AL","1977-12-26",1977,12,360,5960,12500,10600,29060
"AL","1977-12-27",1977,12,361,0,12400,10700,23100
"AL","1977-12-28",1977,12,362,0,12400,10700,23100
"AL","1977-12-29",1977,12,363,258,12300,10700,23258
"AL","1977-12-30",1977,12,364,0,12200,10700,22900
"AL","1977-12-31",1977,12,365,0,12200,10700,22900
"AL","1978-01-01",1978,1,1,0,12100,10700,22800
"AL","1978-01-02",1978,1,2,8360,12100,10500,30960
"AL","1978-01-03",1978,1,3,625,12100,10500,23225
"AL","1978-01-04",1978,1,4,215,12000,10600,22815
"AL","1978-01-05",1978,1,5,0,12000,10600,22600
"AL","1978-01-06",1978,1,6,0,11900,10600,22500
"AL","1978-01-07",1978,1,7,14500,11900,10300,36700
"AL","1978-01-08",1978,1,8,5380,11900,10200,27480
"AL","1978-01-09",1978,1,9,6720,11800,10200,28720
"AL","1978-01-10",1978,1,10,3120,11800,10200,25120
"AL","1978-01-11",1978,1,11,430,11800,10300,22530
"AL","1978-01-12",1978,1,12,0,11700,10300,22000
"AL","1978-01-13",1978,1,13,0,11700,10400,22100
"AL","1978-01-14",1978,1,14,0,11700,10400,22100
"AL","1978-01-15",1978,1,15,0,11600,10400,22000
"AL","1978-01-16",1978,1,16,0,11600,10400,22000
"AL","1978-01-17",1978,1,17,312,11600,10400,22312
"AL","1978-01-18",1978,1,18,0,11500,10400,21900
"AL","1978-01-19",1978,1,19,0,11500,10400,21900
"AL","1978-01-20",1978,1,20,0,11500,10400,21900
"AL","1978-01-21",1978,1,21,0,11400,10400,21800
"AL","1978-01-22",1978,1,22,0,11400,10400,21800
"AL","1978-01-23",1978,1,23,0,11400,10400,21800
"AL","1978-01-24",1978,1,24,0,11300,10400,21700
"AL","1978-01-25",1978,1,25,0,11300,10300,21600
"AL","1978-01-26",1978,1,26,937,11300,10300,22537
"AL","1978-01-27",1978,1,27,7230,11300,10200,28730
"AL","1978-01-28",1978,1,28,1080,11200,10200,22480
"AL","1978-01-29",1978,1,29,0,11200,10200,21400
"AL","1978-01-30",1978,1,30,0,11200,10200,21400
"AL","1978-01-31",1978,1,31,0,11100,10200,21300
"AL","1978-02-01",1978,2,32,0,11100,10200,21300
"AL","1978-02-02",1978,2,33,0,11100,10200,21300
"AL","1978-02-03",1978,2,34,0,11000,10200,21200
"AL","1978-02-04",1978,2,35,0,11000,10200,21200
"AL","1978-02-05",1978,2,36,938,11000,10100,22038
"AL","1978-02-06",1978,2,37,4620,11000,10000,25620
"AL","1978-02-07",1978,2,38,0,10900,10000,20900
"AL","1978-02-08",1978,2,39,0,10900,10100,21000
"AL","1978-02-09",1978,2,40,0,10900,10100,21000
"AL","1978-02-10",1978,2,41,0,10900,10100,21000
"AL","1978-02-11",1978,2,42,0,10800,10000,20800
"AL","1978-02-12",1978,2,43,0,10800,10000,20800
"AL","1978-02-13",1978,2,44,0,10800,10000,20800
"AL","1978-02-14",1978,2,45,0,10800,10000,20800
"AL","1978-02-15",1978,2,46,375,10700,10000,21075
"AL","1978-02-16",1978,2,47,0,10700,10000,20700
"AL","1978-02-17",1978,2,48,0,10700,9980,20680
"AL","1978-02-18",1978,2,49,0,10700,9970,20670
"AL","1978-02-19",1978,2,50,0,10600,9950,20550
"AL","1978-02-20",1978,2,51,0,10600,9940,20540
"AL","1978-02-21",1978,2,52,0,10600,9940,20540
"AL","1978-02-22",1978,2,53,0,10600,9910,20510
"AL","1978-02-23",1978,2,54,0,10500,9910,20410
"AL","1978-02-24",1978,2,55,0,10500,9880,20380
"AL","1978-02-25",1978,2,56,1690,10500,9850,22040
"AL","1978-02-26",1978,2,57,7390,10500,9710,27600
"AL","1978-02-27",1978,2,58,129,10500,9710,20339
"AL","1978-02-28",1978,2,59,0,10400,9750,20150
"AL","1978-03-01",1978,3,60,188,10400,9750,20338
"AL","1978-03-02",1978,3,61,0,10400,9740,20140
"AL","1978-03-03",1978,3,62,0,10400,9740,20140
"AL","1978-03-04",1978,3,63,8690,10300,9580,28570
"AL","1978-03-05",1978,3,64,0,10300,9590,19890
"AL","1978-03-06",1978,3,65,0,10300,9630,19930
"AL","1978-03-07",1978,3,66,0,10300,9640,19940
"AL","1978-03-08",1978,3,67,0,10300,9650,19950
"AL","1978-03-09",1978,3,68,0,10200,9670,19870
"AL","1978-03-10",1978,3,69,0,10200,9680,19880
"AL","1978-03-11",1978,3,70,0,10200,9710,19910
"AL","1978-03-12",1978,3,71,0,10200,9720,19920
"AL","1978-03-13",1978,3,72,0,10200,9720,19920
"AL","1978-03-14",1978,3,73,1030,10100,9710,20840
"AL","1978-03-15",1978,3,74,2070,10100,9650,21820
"AL","1978-03-16",1978,3,75,689,10100,9640,20429
"AL","1978-03-17",1978,3,76,6490,10100,9500,26090
"AL","1978-03-18",1978,3,77,0,10000,9500,19500
"AL","1978-03-19",1978,3,78,0,10000,9550,19550
"AL","1978-03-20",1978,3,79,0,10000,9570,19570
"AL","1978-03-21",1978,3,80,3270,9980,9530,22780
"AL","1978-03-22",1978,3,81,3080,9960,9500,22540
"AL","1978-03-23",1978,3,82,237,9940,9530,19707
"AL","1978-03-24",1978,3,83,0,10400,10200,20600
"AL","1978-03-25",1978,3,84,0,10000,9630,19630
"AL","1978-03-26",1978,3,85,0,9930,9540,19470
"AL","1978-03-27",1978,3,86,0,9900,9550,19450
"AL","1978-03-28",1978,3,87,0,9880,9570,19450
"AL","1978-03-29",1978,3,88,0,9860,12100,21960
"AL","1978-03-30",1978,3,89,0,10600,11800,22400
"AL","1978-03-31",1978,3,90,0,11000,12900,23900
"AL","1978-04-01",1978,4,91,186,14500,22200,36886
"AL","1978-04-02",1978,4,92,0,13000,15400,28400
"AL","1978-04-03",1978,4,93,5950,11100,10600,27650
"AL","1978-04-04",1978,4,94,17600,10800,9680,38080
"AL","1978-04-05",1978,4,95,16200,11600,13300,41100
"AL","1978-04-06",1978,4,96,0,12000,12800,24800
"AL","1978-04-07",1978,4,97,11800,15800,22500,50100
"AL","1978-04-08",1978,4,98,6440,20200,23700,50340
"AL","1978-04-09",1978,4,99,0,12600,10700,23300
"AL","1978-04-10",1978,4,100,28200,14700,15300,58200
"AL","1978-04-11",1978,4,101,29400,13600,14100,57100
"AL","1978-04-12",1978,4,102,6090,13900,14800,34790
"AL","1978-04-13",1978,4,103,7140,13400,15500,36040
"AL","1978-04-14",1978,4,104,6680,19000,21300,46980
"AL","1978-04-15",1978,4,105,256,13300,11800,25356
"AL","1978-04-16",1978,4,106,0,12300,10800,23100
"AL","1978-04-17",1978,4,107,0,12100,10800,22900
"AL","1978-04-18",1978,4,108,0,11900,10700,22600
"AL","1978-04-19",1978,4,109,0,11800,10700,22500
"AL","1978-04-20",1978,4,110,17200,14300,12500,44000
"AL","1978-04-21",1978,4,111,7400,13700,12600,33700
"AL","1978-04-22",1978,4,112,0,11800,10500,22300
"AL","1978-04-23",1978,4,113,0,11700,10500,22200
"AL","1978-04-24",1978,4,114,1140,11600,10500,23240
"AL","1978-04-25",1978,4,115,3720,12000,10500,26220
"AL","1978-04-26",1978,4,116,0,11400,10400,21800
"AL","1978-04-27",1978,4,117,0,11300,10400,21700
"AL","1978-04-28",1978,4,118,0,11200,10300,21500
"AL","1978-04-29",1978,4,119,0,11200,10300,21500
"AL","1978-04-30",1978,4,120,0,11100,10400,21500
"AL","1978-05-01",1978,5,121,0,11000,10400,21400
"AL","1978-05-02",1978,5,122,0,11000,10400,21400
"AL","1978-05-03",1978,5,123,0,10900,10500,21400
"AL","1978-05-04",1978,5,124,0,10900,10500,21400
"AL","1978-05-05",1978,5,125,0,10800,10600,21400
"AL","1978-05-06",1978,5,126,0,10800,10600,21400
"AL","1978-05-07",1978,5,127,0,10700,10600,21300
"AL","1978-05-08",1978,5,128,0,10700,10600,21300
"AL","1978-05-09",1978,5,129,17300,12700,11400,41400
"AL","1978-05-10",1978,5,130,31300,15500,21000,67800
"AL","1978-05-11",1978,5,131,0,11000,10400,21400
"AL","1978-05-12",1978,5,132,0,10700,10300,21000
"AL","1978-05-13",1978,5,133,0,10400,10400,20800
"AL","1978-05-14",1978,5,134,0,9870,10200,20070
"AL","1978-05-15",1978,5,135,17900,12300,10200,40400
"AL","1978-05-16",1978,5,136,1780,11100,10100,22980
"AL","1978-05-17",1978,5,137,0,10600,10200,20800
"AL","1978-05-18",1978,5,138,0,10300,10200,20500
"AL","1978-05-19",1978,5,139,0,9750,10200,19950
"AL","1978-05-20",1978,5,140,0,9570,10100,19670
"AL","1978-05-21",1978,5,141,0,9450,10000,19450
"AL","1978-05-22",1978,5,142,0,9370,10000,19370
"AL","1978-05-23",1978,5,143,0,9330,10000,19330
"AL","1978-05-24",1978,5,144,0,9290,9990,19280
"AL","1978-05-25",1978,5,145,0,9250,9940,19190
"AL","1978-05-26",1978,5,146,8680,9220,9840,27740
"AL","1978-05-27",1978,5,147,50400,22900,10900,84200
"AL","1978-05-28",1978,5,148,56900,23600,27500,108000
"AL","1978-05-29",1978,5,149,26400,18500,19600,64500
"AL","1978-05-30",1978,5,150,67600,21100,36000,124700
"AL","1978-05-31",1978,5,151,34600,27100,27700,89400
"AL","1978-06-01",1978,6,152,4940,14800,12000,31740
"AL","1978-06-02",1978,6,153,51900,25600,32000,109500
"AL","1978-06-03",1978,6,154,4510,15600,12600,32710
"AL","1978-06-04",1978,6,155,5010,14600,12800,32410
"AL","1978-06-05",1978,6,156,3500,14000,13000,30500
"AL","1978-06-06",1978,6,157,0,13800,12900,26700
"AL","1978-06-07",1978,6,158,0,13400,12800,26200
"AL","1978-06-08",1978,6,159,6810,12900,12800,32510
"AL","1978-06-09",1978,6,160,7250,13200,12600,33050
"AL","1978-06-10",1978,6,161,0,12700,12400,25100
"AL","1978-06-11",1978,6,162,2390,12400,12300,27090
"AL","1978-06-12",1978,6,163,6990,11900,12200,31090
"AL","1978-06-13",1978,6,164,32700,19400,13200,65300
"AL","1978-06-14",1978,6,165,0,13200,11800,25000
"AL","1978-06-15",1978,6,166,12900,13100,12700,38700
"AL","1978-06-16",1978,6,167,37800,25200,23700,86700
"AL","1978-06-17",1978,6,168,7360,15100,13800,36260
"AL","1978-06-18",1978,6,169,26300,21300,21500,69100
"AL","1978-06-19",1978,6,170,6330,15300,12700,34330
"AL","1978-06-20",1978,6,171,0,13900,12400,26300
"AL","1978-06-21",1978,6,172,368,13500,12400,26268
"AL","1978-06-22",1978,6,173,5550,13700,12300,31550
"AL","1978-06-23",1978,6,174,0,13000,12200,25200
"AL","1978-06-24",1978,6,175,0,12800,12100,24900
"AL","1978-06-25",1978,6,176,6080,13400,12000,31480
"AL","1978-06-26",1978,6,177,2580,12600,11900,27080
"AL","1978-06-27",1978,6,178,7070,13300,11900,32270
"AL","1978-06-28",1978,6,179,0,12400,11800,24200
"AL","1978-06-29",1978,6,180,0,12100,11800,23900
"AL","1978-06-30",1978,6,181,0,11800,11700,23500
"AL","1978-07-01",1978,7,182,2940,11700,11700,26340
"AL","1978-07-02",1978,7,183,25100,13600,11700,50400
"AL","1978-07-03",1978,7,184,26800,16200,12400,55400
"AL","1978-07-04",1978,7,185,22200,17700,13700,53600
"AL","1978-07-05",1978,7,186,0,13400,11700,25100
"AL","1978-07-06",1978,7,187,12500,14600,12100,39200
"AL","1978-07-07",1978,7,188,2010,13500,11900,27410
"AL","1978-07-08",1978,7,189,5950,12700,12000,30650
"AL","1978-07-09",1978,7,190,7390,13300,12000,32690
"AL","1978-07-10",1978,7,191,4260,12700,11900,28860
"AL","1978-07-11",1978,7,192,482,12300,11800,24582
"AL","1978-07-12",1978,7,193,0,12100,11800,23900
"AL","1978-07-13",1978,7,194,700,12000,11800,24500
"AL","1978-07-14",1978,7,195,7250,13000,11700,31950
"AL","1978-07-15",1978,7,196,0,12200,11700,23900
"AL","1978-07-16",1978,7,197,0,12000,11700,23700
"AL","1978-07-17",1978,7,198,0,11800,11700,23500
"AL","1978-07-18",1978,7,199,7370,12300,11600,31270
"AL","1978-07-19",1978,7,200,35100,15700,12000,62800
"AL","1978-07-20",1978,7,201,10100,14500,11400,36000
"AL","1978-07-21",1978,7,202,1840,13100,11500,26440
"AL","1978-07-22",1978,7,203,1170,12400,11500,25070
"AL","1978-07-23",1978,7,204,10800,12400,11600,34800
"AL","1978-07-24",1978,7,205,22900,16700,12100,51700
"AL","1978-07-25",1978,7,206,0,13100,11400,24500
"AL","1978-07-26",1978,7,207,25100,15700,12400,53200
"AL","1978-07-27",1978,7,208,5290,13400,11500,30190
"AL","1978-07-28",1978,7,209,321,12700,11600,24621
"AL","1978-07-29",1978,7,210,2100,12300,11600,26000
"AL","1978-07-30",1978,7,211,1930,12300,11500,25730
"AL","1978-07-31",1978,7,212,0,12100,11500,23600
"AL","1978-08-01",1978,8,213,2850,12200,11500,26550
"AL","1978-08-02",1978,8,214,0,12000,11400,23400
"AL","1978-08-03",1978,8,215,82300,25300,27000,134600
"AL","1978-08-04",1978,8,216,0,13700,11300,25000
"AL","1978-08-05",1978,8,217,0,13700,11700,25400
"AL","1978-08-06",1978,8,218,0,13500,11700,25200
"AL","1978-08-07",1978,8,219,0,13100,11700,24800
"AL","1978-08-08",1978,8,220,0,12700,11600,24300
"AL","1978-08-09",1978,8,221,0,12400,11600,24000
"AL","1978-08-10",1978,8,222,0,12200,11600,23800
"AL","1978-08-11",1978,8,223,0,12000,11500,23500
"AL","1978-08-12",1978,8,224,0,11900,11400,23300
"AL","1978-08-13",1978,8,225,0,11800,11400,23200
"AL","1978-08-14",1978,8,226,0,11700,11400,23100
"AL","1978-08-15",1978,8,227,0,11600,11400,23000
"AL","1978-08-16",1978,8,228,25200,13700,11300,50200
"AL","1978-08-17",1978,8,229,53300,21900,17400,92600
"AL","1978-08-18",1978,8,230,14100,17600,15300,47000
"AL","1978-08-19",1978,8,231,20400,14400,17500,52300
"AL","1978-08-20",1978,8,232,51300,29600,33000,113900
"AL","1978-08-21",1978,8,233,0,15300,12200,27500
"AL","1978-08-22",1978,8,234,0,14800,12200,27000
"AL","1978-08-23",1978,8,235,0,14300,12200,26500
"AL","1978-08-24",1978,8,236,223000,68600,108000,399600
"AL","1978-08-25",1978,8,237,13400,28000,45200,86600
"AL","1978-08-26",1978,8,238,0,19700,26600,46300
"AL","1978-08-27",1978,8,239,395,17300,16100,33795
"AL","1978-08-28",1978,8,240,113000,77200,65700,255900
"AL","1978-08-29",1978,8,241,64100,75900,57600,197600
"AL","1978-08-30",1978,8,242,0,23900,27700,51600
"AL","1978-08-31",1978,8,243,5730,21200,18600,45530
"AL","1978-09-01",1978,9,244,0,19400,16700,36100
"AL","1978-09-02",1978,9,245,0,19400,17100,36500
"AL","1978-09-03",1978,9,246,1430,19100,17100,37630
"AL","1978-09-04",1978,9,247,9020,21500,17600,48120
"AL","1978-09-05",1978,9,248,0,19300,17200,36500
"AL","1978-09-06",1978,9,249,439,19100,17300,36839
"AL","1978-09-07",1978,9,250,303,18400,17300,36003
"AL","1978-09-08",1978,9,251,0,17800,17400,35200
"AL","1978-09-09",1978,9,252,0,17400,17400,34800
"AL","1978-09-10",1978,9,253,0,17000,17200,34200
"AL","1978-09-11",1978,9,254,0,16700,17100,33800
"AL","1978-09-12",1978,9,255,5190,17200,17000,39390
"AL","1978-09-13",1978,9,256,30500,22000,18300,70800
"AL","1978-09-14",1978,9,257,16800,21200,18900,56900
"AL","1978-09-15",1978,9,258,26800,30200,24800,81800
"AL","1978-09-16",1978,9,259,1210,19500,17300,38010
"AL","1978-09-17",1978,9,260,4280,18600,17600,40480
"AL","1978-09-18",1978,9,261,5530,19400,17900,42830
"AL","1978-09-19",1978,9,262,4950,19200,17800,41950
"AL","1978-09-20",1978,9,263,7070,20600,18700,46370
"AL","1978-09-21",1978,9,264,1810,18500,17200,37510
"AL","1978-09-22",1978,9,265,2780,18600,17100,38480
"AL","1978-09-23",1978,9,266,303,18000,16800,35103
"AL","1978-09-24",1978,9,267,0,17800,16600,34400
"AL","1978-09-25",1978,9,268,0,17700,16500,34200
"AL","1978-09-26",1978,9,269,0,17500,16300,33800
"AL","1978-09-27",1978,9,270,1510,17400,16200,35110
"AL","1978-09-28",1978,9,271,27100,23700,19900,70700
"AL","1978-09-29",1978,9,272,0,18800,16600,35400
"AL","1978-09-30",1978,9,273,20500,25400,24500,70400
"AL","1978-10-01",1978,10,274,12800,24100,23200,60100
"AL","1978-10-02",1978,10,275,369,20900,17500,38769
"AL","1978-10-03",1978,10,276,3870,19900,16900,40670
"AL","1978-10-04",1978,10,277,7290,19800,17300,44390
"AL","1978-10-05",1978,10,278,1010,20100,17200,38310
"AL","1978-10-06",1978,10,279,16400,22900,22800,62100
"AL","1978-10-07",1978,10,280,3440,21100,18400,42940
"AL","1978-10-08",1978,10,281,7560,20500,18400,46460
"AL","1978-10-09",1978,10,282,485,19300,16900,36685
"AL","1978-10-10",1978,10,283,0,18700,16400,35100
"AL","1978-10-11",1978,10,284,0,18600,16200,34800
"AL","1978-10-12",1978,10,285,0,18500,16100,34600
"AL","1978-10-13",1978,10,286,2130,18800,15900,36830
"AL","1978-10-14",1978,10,287,1880,18200,15800,35880
"AL","1978-10-15",1978,10,288,0,18100,15600,33700
"AL","1978-10-16",1978,10,289,6110,18700,16200,41010
"AL","1978-10-17",1978,10,290,1210,18500,16000,35710
"AL","1978-10-18",1978,10,291,0,17900,15600,33500
"AL","1978-10-19",1978,10,292,0,17800,15500,33300
"AL","1978-10-20",1978,10,293,0,17700,15400,33100
"AL","1978-10-21",1978,10,294,0,17700,15400,33100
"AL","1978-10-22",1978,10,295,0,17600,15400,33000
"AL","1978-10-23",1978,10,296,0,17600,15300,32900
"AL","1978-10-24",1978,10,297,0,17500,15300,32800
"AL","1978-10-25",1978,10,298,0,17400,15200,32600
"AL","1978-10-26",1978,10,299,0,17400,15200,32600
"AL","1978-10-27",1978,10,300,0,17300,15100,32400
"AL","1978-10-28",1978,10,301,0,17200,15100,32300
"AL","1978-10-29",1978,10,302,0,17200,15000,32200
"AL","1978-10-30",1978,10,303,0,17100,15000,32100
"AL","1978-10-31",1978,10,304,0,17000,14900,31900
"AL","1978-11-01",1978,11,305,0,17000,14900,31900
"AL","1978-11-02",1978,11,306,0,16900,14800,31700
"AL","1978-11-03",1978,11,307,0,16800,14800,31600
"AL","1978-11-04",1978,11,308,0,16800,14800,31600
"AL","1978-11-05",1978,11,309,0,16700,14700,31400
"AL","1978-11-06",1978,11,310,2040,16800,14700,33540
"AL","1978-11-07",1978,11,311,0,16600,14600,31200
"AL","1978-11-08",1978,11,312,0,16500,14600,31100
"AL","1978-11-09",1978,11,313,0,16400,14600,31000
"AL","1978-11-10",1978,11,314,0,16400,14500,30900
"AL","1978-11-11",1978,11,315,1300,16300,14500,32100
"AL","1978-11-12",1978,11,316,459,16300,14400,31159
"AL","1978-11-13",1978,11,317,0,16200,14400,30600
"AL","1978-11-14",1978,11,318,16800,16300,14300,47400
"AL","1978-11-15",1978,11,319,1840,18300,17000,37140
"AL","1978-11-16",1978,11,320,0,16500,14500,31000
"AL","1978-11-17",1978,11,321,0,16300,14300,30600
"AL","1978-11-18",1978,11,322,41300,16300,13900,71500
"AL","1978-11-19",1978,11,323,27400,16200,13500,57100
"AL","1978-11-20",1978,11,324,333,16100,14000,30433
"AL","1978-11-21",1978,11,325,0,16000,14200,30200
"AL","1978-11-22",1978,11,326,0,16000,14300,30300
"AL","1978-11-23",1978,11,327,0,15900,14300,30200
"AL","1978-11-24",1978,11,328,7190,15800,14200,37190
"AL","1978-11-25",1978,11,329,1150,15800,14200,31150
"AL","1978-11-26",1978,11,330,0,15700,14200,29900
"AL","1978-11-27",1978,11,331,0,15700,14200,29900
"AL","1978-11-28",1978,11,332,459,15600,14200,30259
"AL","1978-11-29",1978,11,333,1310,15600,14200,31110
"AL","1978-11-30",1978,11,334,4150,15500,14000,33650
"AL","1978-12-01",1978,12,335,0,15500,14000,29500
"AL","1978-12-02",1978,12,336,0,15400,14000,29400
"AL","1978-12-03",1978,12,337,0,15400,14000,29400
"AL","1978-12-04",1978,12,338,3970,15300,13900,33170
"AL","1978-12-05",1978,12,339,1780,15300,13800,30880
"AL","1978-12-06",1978,12,340,679,15200,13800,29679
"AL","1978-12-07",1978,12,341,187,15100,13800,29087
"AL","1978-12-08",1978,12,342,0,15100,13800,28900
"AL","1978-12-09",1978,12,343,0,15000,13700,28700
"AL","1978-12-10",1978,12,344,0,15000,13700,28700
"AL","1978-12-11",1978,12,345,0,14900,13600,28500
"AL","1978-12-12",1978,12,346,93.5,14900,13600,28593.5
"AL","1978-12-13",1978,12,347,0,14800,13600,28400
"AL","1978-12-14",1978,12,348,1080,14800,13500,29380
"AL","1978-12-15",1978,12,349,0,14700,13500,28200
"AL","1978-12-16",1978,12,350,0,14700,13500,28200
"AL","1978-12-17",1978,12,351,0,14600,13500,28100
"AL","1978-12-18",1978,12,352,0,14600,13400,28000
"AL","1978-12-19",1978,12,353,0,14500,13400,27900
"AL","1978-12-20",1978,12,354,187,14500,13300,27987
"AL","1978-12-21",1978,12,355,8660,14500,13200,36360
"AL","1978-12-22",1978,12,356,6980,14400,13100,34480
"AL","1978-12-23",1978,12,357,0,14400,13100,27500
"AL","1978-12-24",1978,12,358,2990,14300,13100,30390
"AL","1978-12-25",1978,12,359,7020,14300,13000,34320
"AL","1978-12-26",1978,12,360,0,14200,13000,27200
"AL","1978-12-27",1978,12,361,0,14200,13000,27200
"AL","1978-12-28",1978,12,362,0,14100,13000,27100
"AL","1978-12-29",1978,12,363,0,14100,13000,27100
"AL","1978-12-30",1978,12,364,4870,14000,12900,31770
"AL","1978-12-31",1978,12,365,9150,14000,12800,35950
"AL","1979-01-01",1979,1,1,0,14000,12800,26800
"AL","1979-01-02",1979,1,2,0,13900,12800,26700
"AL","1979-01-03",1979,1,3,0,13900,12800,26700
"AL","1979-01-04",1979,1,4,0,13800,12800,26600
"AL","1979-01-05",1979,1,5,0,13800,12800,26600
"AL","1979-01-06",1979,1,6,0,13700,12700,26400
"AL","1979-01-07",1979,1,7,0,13700,12700,26400
"AL","1979-01-08",1979,1,8,0,13700,12700,26400
"AL","1979-01-09",1979,1,9,0,13600,12600,26200
"AL","1979-01-10",1979,1,10,430,13600,12600,26630
"AL","1979-01-11",1979,1,11,0,13500,12600,26100
"AL","1979-01-12",1979,1,12,0,13500,12500,26000
"AL","1979-01-13",1979,1,13,0,13400,12500,25900
"AL","1979-01-14",1979,1,14,1110,13400,12500,27010
"AL","1979-01-15",1979,1,15,0,13400,12400,25800
"AL","1979-01-16",1979,1,16,0,13300,12400,25700
"AL","1979-01-17",1979,1,17,0,13300,12400,25700
"AL","1979-01-18",1979,1,18,10700,13300,12200,36200
"AL","1979-01-19",1979,1,19,0,13200,12200,25400
"AL","1979-01-20",1979,1,20,3650,13200,12200,29050
"AL","1979-01-21",1979,1,21,12700,13200,12000,37900
"AL","1979-01-22",1979,1,22,2010,13100,12000,27110
"AL","1979-01-23",1979,1,23,586,13100,12100,25786
"AL","1979-01-24",1979,1,24,21100,13100,11800,46000
"AL","1979-01-25",1979,1,25,6740,13000,11800,31540
"AL","1979-01-26",1979,1,26,0,13000,12000,25000
"AL","1979-01-27",1979,1,27,0,13000,12000,25000
"AL","1979-01-28",1979,1,28,2600,12900,12000,27500
"AL","1979-01-29",1979,1,29,2950,12900,12000,27850
"AL","1979-01-30",1979,1,30,586,12900,12000,25486
"AL","1979-01-31",1979,1,31,312,12900,12000,25212
"AL","1979-02-01",1979,2,32,0,12800,12000,24800
"AL","1979-02-02",1979,2,33,0,12800,12000,24800
"AL","1979-02-03",1979,2,34,0,12800,11900,24700
"AL","1979-02-04",1979,2,35,0,12700,11900,24600
"AL","1979-02-05",1979,2,36,258,12700,11900,24858
"AL","1979-02-06",1979,2,37,129,12700,11900,24729
"AL","1979-02-07",1979,2,38,1430,12700,11900,26030
"AL","1979-02-08",1979,2,39,0,12600,11800,24400
"AL","1979-02-09",1979,2,40,0,12600,11800,24400
"AL","1979-02-10",1979,2,41,0,12600,11800,24400
"AL","1979-02-11",1979,2,42,0,12500,11800,24300
"AL","1979-02-12",1979,2,43,1500,12500,11800,25800
"AL","1979-02-13",1979,2,44,0,12500,11700,24200
"AL","1979-02-14",1979,2,45,2530,12500,11700,26730
"AL","1979-02-15",1979,2,46,4050,12400,11600,28050
"AL","1979-02-16",1979,2,47,6720,12400,11500,30620
"AL","1979-02-17",1979,2,48,4680,12400,11400,28480
"AL","1979-02-18",1979,2,49,0,12400,11500,23900
"AL","1979-02-19",1979,2,50,0,12300,11500,23800
"AL","1979-02-20",1979,2,51,0,12300,11500,23800
"AL","1979-02-21",1979,2,52,0,12300,11500,23800
"AL","1979-02-22",1979,2,53,7750,12300,11400,31450
"AL","1979-02-23",1979,2,54,0,12200,11400,23600
"AL","1979-02-24",1979,2,55,19700,12200,11100,43000
"AL","1979-02-25",1979,2,56,0,12200,11200,23400
"AL","1979-02-26",1979,2,57,0,12200,11300,23500
"AL","1979-02-27",1979,2,58,0,12100,11300,23400
"AL","1979-02-28",1979,2,59,0,12100,11400,23500
"AL","1979-03-01",1979,3,60,0,12100,11400,23500
"AL","1979-03-02",1979,3,61,0,12100,11400,23500
"AL","1979-03-03",1979,3,62,0,12000,11400,23400
"AL","1979-03-04",1979,3,63,4310,12000,11400,27710
"AL","1979-03-05",1979,3,64,24400,12000,10900,47300
"AL","1979-03-06",1979,3,65,31500,12000,10500,54000
"AL","1979-03-07",1979,3,66,0,11900,10800,22700
"AL","1979-03-08",1979,3,67,0,11900,11000,22900
"AL","1979-03-09",1979,3,68,0,11900,11100,23000
"AL","1979-03-10",1979,3,69,4160,11900,11100,27160
"AL","1979-03-11",1979,3,70,0,11800,11100,22900
"AL","1979-03-12",1979,3,71,345,11800,11100,23245
"AL","1979-03-13",1979,3,72,0,11800,11200,23000
"AL","1979-03-14",1979,3,73,0,11800,11200,23000
"AL","1979-03-15",1979,3,74,1880,11700,11200,24780
"AL","1979-03-16",1979,3,75,0,11700,11200,22900
"AL","1979-03-17",1979,3,76,0,11700,11200,22900
"AL","1979-03-18",1979,3,77,0,11700,11200,22900
"AL","1979-03-19",1979,3,78,256,11600,11300,23156
"AL","1979-03-20",1979,3,79,6400,11600,11100,29100
"AL","1979-03-21",1979,3,80,512,11600,14600,26712
"AL","1979-03-22",1979,3,81,0,11700,12800,24500
"AL","1979-03-23",1979,3,82,0,12700,14400,27100
"AL","1979-03-24",1979,3,83,26900,56500,82600,166000
"AL","1979-03-25",1979,3,84,34100,13600,10700,58400
"AL","1979-03-26",1979,3,85,949,13100,11000,25049
"AL","1979-03-27",1979,3,86,0,12900,11400,24300
"AL","1979-03-28",1979,3,87,0,12700,11500,24200
"AL","1979-03-29",1979,3,88,926,12600,11500,25026
"AL","1979-03-30",1979,3,89,712,12400,11600,24712
"AL","1979-03-31",1979,3,90,21400,12300,11200,44900
"AL","1979-04-01",1979,4,91,0,12200,11300,23500
"AL","1979-04-02",1979,4,92,0,12100,11500,23600
"AL","1979-04-03",1979,4,93,0,12000,11400,23400
"AL","1979-04-04",1979,4,94,0,12000,11400,23400
"AL","1979-04-05",1979,4,95,0,11900,11400,23300
"AL","1979-04-06",1979,4,96,186,11800,11400,23386
"AL","1979-04-07",1979,4,97,1540,11800,11300,24640
"AL","1979-04-08",1979,4,98,0,11700,11300,23000
"AL","1979-04-09",1979,4,99,0,11700,11300,23000
"AL","1979-04-10",1979,4,100,4350,11600,11200,27150
"AL","1979-04-11",1979,4,101,0,11600,11200,22800
"AL","1979-04-12",1979,4,102,0,11600,11200,22800
"AL","1979-04-13",1979,4,103,3320,11500,11200,26020
"AL","1979-04-14",1979,4,104,3510,12700,20800,37010
"AL","1979-04-15",1979,4,105,348,15900,19800,36048
"AL","1979-04-16",1979,4,106,0,13600,15100,28700
"AL","1979-04-17",1979,4,107,0,13600,15100,28700
"AL","1979-04-18",1979,4,108,0,14600,17000,31600
"AL","1979-04-19",1979,4,109,0,15600,18500,34100
"AL","1979-04-20",1979,4,110,0,17700,23000,40700
"AL","1979-04-21",1979,4,111,1720,107000,144000,252720
"AL","1979-04-22",1979,4,112,9490,97500,101000,207990
"AL","1979-04-23",1979,4,113,0,19800,15900,35700
"AL","1979-04-24",1979,4,114,0,20600,14100,34700
"AL","1979-04-25",1979,4,115,0,22400,14700,37100
"AL","1979-04-26",1979,4,116,4020,16600,13200,33820
"AL","1979-04-27",1979,4,117,10300,18500,14100,42900
"AL","1979-04-28",1979,4,118,0,15800,13400,29200
"AL","1979-04-29",1979,4,119,0,15600,13500,29100
"AL","1979-04-30",1979,4,120,0,15300,13700,29000
"AL","1979-05-01",1979,5,121,522,15100,13800,29422
"AL","1979-05-02",1979,5,122,0,14900,13800,28700
"AL","1979-05-03",1979,5,123,4590,15100,13900,33590
"AL","1979-05-04",1979,5,124,0,14600,13600,28200
"AL","1979-05-05",1979,5,125,0,14300,13600,27900
"AL","1979-05-06",1979,5,126,17600,15900,14500,48000
"AL","1979-05-07",1979,5,127,19600,15100,21700,56400
"AL","1979-05-08",1979,5,128,2800,20000,15200,38000
"AL","1979-05-09",1979,5,129,10700,14800,16000,41500
"AL","1979-05-10",1979,5,130,51000,31500,35200,117700
"AL","1979-05-11",1979,5,131,1270,16000,14300,31570
"AL","1979-05-12",1979,5,132,31300,21800,25800,78900
"AL","1979-05-13",1979,5,133,763,15000,14000,29763
"AL","1979-05-14",1979,5,134,10200,14700,15000,39900
"AL","1979-05-15",1979,5,135,7950,15800,15900,39650
"AL","1979-05-16",1979,5,136,0,14600,14300,28900
"AL","1979-05-17",1979,5,137,0,14300,14300,28600
"AL","1979-05-18",1979,5,138,0,14000,14200,28200
"AL","1979-05-19",1979,5,139,9330,13700,14200,37230
"AL","1979-05-20",1979,5,140,28100,20100,20100,68300
"AL","1979-05-21",1979,5,141,808,14500,14000,29308
"AL","1979-05-22",1979,5,142,0,14000,13900,27900
"AL","1979-05-23",1979,5,143,4800,13900,14000,32700
"AL","1979-05-24",1979,5,144,3170,13900,13900,30970
"AL","1979-05-25",1979,5,145,0,13600,13800,27400
"AL","1979-05-26",1979,5,146,0,13600,13700,27300
"AL","1979-05-27",1979,5,147,0,13000,13500,26500
"AL","1979-05-28",1979,5,148,0,12600,13300,25900
"AL","1979-05-29",1979,5,149,0,12600,13200,25800
"AL","1979-05-30",1979,5,150,0,12500,13100,25600
"AL","1979-05-31",1979,5,151,8290,13100,12900,34290
"AL","1979-06-01",1979,6,152,13800,13600,12800,40200
"AL","1979-06-02",1979,6,153,13700,15500,12900,42100
"AL","1979-06-03",1979,6,154,5520,13800,12900,32220
"AL","1979-06-04",1979,6,155,1010,13200,12900,27110
"AL","1979-06-05",1979,6,156,4530,13200,12900,30630
"AL","1979-06-06",1979,6,157,10700,14400,12900,38000
"AL","1979-06-07",1979,6,158,7910,13100,13000,34010
"AL","1979-06-08",1979,6,159,14700,15700,13300,43700
"AL","1979-06-09",1979,6,160,13600,18800,13200,45600
"AL","1979-06-10",1979,6,161,1630,14100,12800,28530
"AL","1979-06-11",1979,6,162,40700,19600,18100,78400
"AL","1979-06-12",1979,6,163,10200,17800,14900,42900
"AL","1979-06-13",1979,6,164,0,14700,13100,27800
"AL","1979-06-14",1979,6,165,0,14300,13200,27500
"AL","1979-06-15",1979,6,166,0,13700,13200,26900
"AL","1979-06-16",1979,6,167,0,13300,13000,26300
"AL","1979-06-17",1979,6,168,32000,12900,14300,59200
"AL","1979-06-18",1979,6,169,79200,40200,44500,163900
"AL","1979-06-19",1979,6,170,0,16500,17700,34200
"AL","1979-06-20",1979,6,171,0,15500,13900,29400
"AL","1979-06-21",1979,6,172,4370,15900,13900,34170
"AL","1979-06-22",1979,6,173,12900,16200,14400,43500
"AL","1979-06-23",1979,6,174,760,15000,13800,29560
"AL","1979-06-24",1979,6,175,0,14400,13800,28200
"AL","1979-06-25",1979,6,176,0,14300,13700,28000
"AL","1979-06-26",1979,6,177,0,14000,13600,27600
"AL","1979-06-27",1979,6,178,0,13700,13500,27200
"AL","1979-06-28",1979,6,179,19300,16600,13500,49400
"AL","1979-06-29",1979,6,180,0,14300,13300,27600
"AL","1979-06-30",1979,6,181,2210,14000,13300,29510
"AL","1979-07-01",1979,7,182,0,13600,13200,26800
"AL","1979-07-02",1979,7,183,0,13300,13100,26400
"AL","1979-07-03",1979,7,184,0,13000,13100,26100
"AL","1979-07-04",1979,7,185,31100,16100,13500,60700
"AL","1979-07-05",1979,7,186,6260,15000,13000,34260
"AL","1979-07-06",1979,7,187,0,14000,13100,27100
"AL","1979-07-07",1979,7,188,0,13500,13000,26500
"AL","1979-07-08",1979,7,189,0,13200,13000,26200
"AL","1979-07-09",1979,7,190,0,12900,12900,25800
"AL","1979-07-10",1979,7,191,0,12800,12900,25700
"AL","1979-07-11",1979,7,192,0,12700,12800,25500
"AL","1979-07-12",1979,7,193,0,12600,12800,25400
"AL","1979-07-13",1979,7,194,0,12600,12700,25300
"AL","1979-07-14",1979,7,195,2490,12500,12600,27590
"AL","1979-07-15",1979,7,196,1450,12500,12600,26550
"AL","1979-07-16",1979,7,197,0,12400,12500,24900
"AL","1979-07-17",1979,7,198,0,12300,12500,24800
"AL","1979-07-18",1979,7,199,0,12300,12400,24700
"AL","1979-07-19",1979,7,200,0,12300,12400,24700
"AL","1979-07-20",1979,7,201,3030,12200,12300,27530
"AL","1979-07-21",1979,7,202,4740,12900,12300,29940
"AL","1979-07-22",1979,7,203,0,12300,12200,24500
"AL","1979-07-23",1979,7,204,467,12200,12300,24967
"AL","1979-07-24",1979,7,205,0,12100,12300,24400
"AL","1979-07-25",1979,7,206,0,12000,12300,24300
"AL","1979-07-26",1979,7,207,26600,15300,12000,53900
"AL","1979-07-27",1979,7,208,8170,12900,11800,32870
"AL","1979-07-28",1979,7,209,30200,17100,12300,59600
"AL","1979-07-29",1979,7,210,0,13400,11800,25200
"AL","1979-07-30",1979,7,211,0,13200,12100,25300
"AL","1979-07-31",1979,7,212,5860,13200,12100,31160
"AL","1979-08-01",1979,8,213,3210,13100,12100,28410
"AL","1979-08-02",1979,8,214,0,12500,12100,24600
"AL","1979-08-03",1979,8,215,0,12500,12100,24600
"AL","1979-08-04",1979,8,216,0,12200,12100,24300
"AL","1979-08-05",1979,8,217,4560,12100,12100,28760
"AL","1979-08-06",1979,8,218,0,12000,12100,24100
"AL","1979-08-07",1979,8,219,0,12000,12100,24100
"AL","1979-08-08",1979,8,220,0,11900,12100,24000
"AL","1979-08-09",1979,8,221,0,11800,12000,23800
"AL","1979-08-10",1979,8,222,1930,11800,12000,25730
"AL","1979-08-11",1979,8,223,13000,13700,11900,38600
"AL","1979-08-12",1979,8,224,0,12500,11800,24300
"AL","1979-08-13",1979,8,225,17600,13900,11900,43400
"AL","1979-08-14",1979,8,226,26700,15000,12600,54300
"AL","1979-08-15",1979,8,227,3330,13000,11700,28030
"AL","1979-08-16",1979,8,228,0,12600,11800,24400
"AL","1979-08-17",1979,8,229,3550,12800,11900,28250
"AL","1979-08-18",1979,8,230,3180,13000,11900,28080
"AL","1979-08-19",1979,8,231,0,12500,11900,24400
"AL","1979-08-20",1979,8,232,0,12200,11900,24100
"AL","1979-08-21",1979,8,233,0,12100,11900,24000
"AL","1979-08-22",1979,8,234,0,11900,11900,23800
"AL","1979-08-23",1979,8,235,18200,12300,11900,42400
"AL","1979-08-24",1979,8,236,37000,18400,13700,69100
"AL","1979-08-25",1979,8,237,13600,16700,13800,44100
"AL","1979-08-26",1979,8,238,725,13700,11600,26025
"AL","1979-08-27",1979,8,239,12100,13300,13100,38500
"AL","1979-08-28",1979,8,240,25400,17200,20200,62800
"AL","1979-08-29",1979,8,241,0,13600,11800,25400
"AL","1979-08-30",1979,8,242,8540,14900,12300,35740
"AL","1979-08-31",1979,8,243,13300,13400,14700,41400
"AL","1979-09-01",1979,9,244,351,13100,11900,25351
"AL","1979-09-02",1979,9,245,14000,16500,14000,44500
"AL","1979-09-03",1979,9,246,14600,15600,15800,46000
"AL","1979-09-04",1979,9,247,454,13500,11900,25854
"AL","1979-09-05",1979,9,248,0,13000,12000,25000
"AL","1979-09-06",1979,9,249,0,12900,12000,24900
"AL","1979-09-07",1979,9,250,549,12600,11900,25049
"AL","1979-09-08",1979,9,251,2540,12300,11800,26640
"AL","1979-09-09",1979,9,252,0,12200,11700,23900
"AL","1979-09-10",1979,9,253,0,12200,11700,23900
"AL","1979-09-11",1979,9,254,0,12200,11700,23900
"AL","1979-09-12",1979,9,255,12700,12600,11700,37000
"AL","1979-09-13",1979,9,256,18700,13600,12200,44500
"AL","1979-09-14",1979,9,257,12800,14700,12600,40100
"AL","1979-09-15",1979,9,258,756,12900,11600,25256
"AL","1979-09-16",1979,9,259,303,12600,11600,24503
"AL","1979-09-17",1979,9,260,0,12400,11700,24100
"AL","1979-09-18",1979,9,261,0,12300,11700,24000
"AL","1979-09-19",1979,9,262,0,12100,11600,23700
"AL","1979-09-20",1979,9,263,0,11900,11600,23500
"AL","1979-09-21",1979,9,264,0,11800,11500,23300
"AL","1979-09-22",1979,9,265,0,11800,11500,23300
"AL","1979-09-23",1979,9,266,0,11700,11500,23200
"AL","1979-09-24",1979,9,267,0,11600,11400,23000
"AL","1979-09-25",1979,9,268,0,11600,11400,23000
"AL","1979-09-26",1979,9,269,0,11500,11400,22900
"AL","1979-09-27",1979,9,270,0,11400,11400,22800
"AL","1979-09-28",1979,9,271,0,11300,11300,22600
"AL","1979-09-29",1979,9,272,0,11300,11300,22600
"AL","1979-09-30",1979,9,273,0,11100,11300,22400
"AL","1979-10-01",1979,10,274,0,11100,11200,22300
"AL","1979-10-02",1979,10,275,3220,11100,11200,25520
"AL","1979-10-03",1979,10,276,18200,13700,11000,42900
"AL","1979-10-04",1979,10,277,754,12300,11000,24054
"AL","1979-10-05",1979,10,278,3540,12100,11100,26740
"AL","1979-10-06",1979,10,279,922,11800,11100,23822
"AL","1979-10-07",1979,10,280,10100,12700,11200,34000
"AL","1979-10-08",1979,10,281,1480,12400,11000,24880
"AL","1979-10-09",1979,10,282,0,12000,11000,23000
"AL","1979-10-10",1979,10,283,5500,12400,11000,28900
"AL","1979-10-11",1979,10,284,2820,12600,11100,26520
"AL","1979-10-12",1979,10,285,2530,12300,11000,25830
"AL","1979-10-13",1979,10,286,4140,12600,11000,27740
"AL","1979-10-14",1979,10,287,1570,12300,10900,24770
"AL","1979-10-15",1979,10,288,485,12100,10900,23485
"AL","1979-10-16",1979,10,289,0,12000,10900,22900
"AL","1979-10-17",1979,10,290,0,12000,10900,22900
"AL","1979-10-18",1979,10,291,0,12000,10800,22800
"AL","1979-10-19",1979,10,292,0,11900,10800,22700
"AL","1979-10-20",1979,10,293,22800,15600,11300,49700
"AL","1979-10-21",1979,10,294,3320,13300,10700,27320
"AL","1979-10-22",1979,10,295,14600,13600,11100,39300
"AL","1979-10-23",1979,10,296,59200,29500,33300,122000
"AL","1979-10-24",1979,10,297,62600,18000,15600,96200
"AL","1979-10-25",1979,10,298,485,14500,11100,26085
"AL","1979-10-26",1979,10,299,0,14300,11400,25700
"AL","1979-10-27",1979,10,300,0,14100,11500,25600
"AL","1979-10-28",1979,10,301,7090,14000,11800,32890
"AL","1979-10-29",1979,10,302,0,14300,13900,28200
"AL","1979-10-30",1979,10,303,0,15400,15300,30700
"AL","1979-10-31",1979,10,304,0,15900,17100,33000
"AL","1979-11-01",1979,11,305,0,18200,19800,38000
"AL","1979-11-02",1979,11,306,18300,31600,25800,75700
"AL","1979-11-03",1979,11,307,2230,17000,14500,33730
"AL","1979-11-04",1979,11,308,230,15500,12300,28030
"AL","1979-11-05",1979,11,309,0,15100,12200,27300
"AL","1979-11-06",1979,11,310,0,14900,12100,27000
"AL","1979-11-07",1979,11,311,3250,15000,12100,30350
"AL","1979-11-08",1979,11,312,0,14700,12000,26700
"AL","1979-11-09",1979,11,313,8890,14500,11800,35190
"AL","1979-11-10",1979,11,314,1690,14300,11800,27790
"AL","1979-11-11",1979,11,315,0,14200,11900,26100
"AL","1979-11-12",1979,11,316,0,14100,11900,26000
"AL","1979-11-13",1979,11,317,0,14000,11900,25900
"AL","1979-11-14",1979,11,318,0,13900,11800,25700
"AL","1979-11-15",1979,11,319,0,13800,11800,25600
"AL","1979-11-16",1979,11,320,2090,13800,11700,27590
"AL","1979-11-17",1979,11,321,0,13700,11700,25400
"AL","1979-11-18",1979,11,322,0,13600,11800,25400
"AL","1979-11-19",1979,11,323,0,14200,11800,26000
"AL","1979-11-20",1979,11,324,0,13400,11500,24900
"AL","1979-11-21",1979,11,325,4470,14000,11400,29870
"AL","1979-11-22",1979,11,326,5440,14100,11600,31140
"AL","1979-11-23",1979,11,327,14300,13900,11300,39500
"AL","1979-11-24",1979,11,328,3040,13600,11200,27840
"AL","1979-11-25",1979,11,329,459,13500,11300,25259
"AL","1979-11-26",1979,11,330,0,13400,11400,24800
"AL","1979-11-27",1979,11,331,7920,13300,11200,32420
"AL","1979-11-28",1979,11,332,1150,13300,11300,25750
"AL","1979-11-29",1979,11,333,500,13200,11300,25000
"AL","1979-11-30",1979,11,334,4750,13200,11300,29250
"AL","1979-12-01",1979,12,335,0,13100,11300,24400
"AL","1979-12-02",1979,12,336,281,13100,11300,24681
"AL","1979-12-03",1979,12,337,0,13100,11300,24400
"AL","1979-12-04",1979,12,338,0,13000,11300,24300
"AL","1979-12-05",1979,12,339,0,13000,11300,24300
"AL","1979-12-06",1979,12,340,0,13000,11300,24300
"AL","1979-12-07",1979,12,341,0,12900,11300,24200
"AL","1979-12-08",1979,12,342,12400,12900,11000,36300
"AL","1979-12-09",1979,12,343,187,12900,11100,24187
"AL","1979-12-10",1979,12,344,374,12900,11100,24374
"AL","1979-12-11",1979,12,345,0,12800,11200,24000
"AL","1979-12-12",1979,12,346,0,12800,11200,24000
"AL","1979-12-13",1979,12,347,0,12800,11200,24000
"AL","1979-12-14",1979,12,348,0,12700,11200,23900
"AL","1979-12-15",1979,12,349,0,12700,11200,23900
"AL","1979-12-16",1979,12,350,0,12700,11200,23900
"AL","1979-12-17",1979,12,351,129,12700,11200,24029
"AL","1979-12-18",1979,12,352,0,12700,11200,23900
"AL","1979-12-19",1979,12,353,0,12600,11200,23800
"AL","1979-12-20",1979,12,354,0,12600,11200,23800
"AL","1979-12-21",1979,12,355,0,12600,11200,23800
"AL","1979-12-22",1979,12,356,0,12600,11200,23800
"AL","1979-12-23",1979,12,357,0,12600,11200,23800
"AL","1979-12-24",1979,12,358,5900,12500,11100,29500
"AL","1979-12-25",1979,12,359,386,12500,11100,23986
"AL","1979-12-26",1979,12,360,0,12500,11100,23600
"AL","1979-12-27",1979,12,361,0,12500,11100,23600
"AL","1979-12-28",1979,12,362,0,12500,11100,23600
"AL","1979-12-29",1979,12,363,0,12500,11100,23600
"AL","1979-12-30",1979,12,364,0,12500,11100,23600
"AL","1979-12-31",1979,12,365,0,12400,11100,23500
"AL","1980-01-01",1980,1,1,0,12400,11100,23500
"AL","1980-01-02",1980,1,2,0,12400,11100,23500
"AL","1980-01-03",1980,1,3,0,12400,11100,23500
"AL","1980-01-04",1980,1,4,371,12400,11100,23871
"AL","1980-01-05",1980,1,5,0,12300,11100,23400
"AL","1980-01-06",1980,1,6,0,12300,11100,23400
"AL","1980-01-07",1980,1,7,4350,12300,11000,27650
"AL","1980-01-08",1980,1,8,33400,12300,10400,56100
"AL","1980-01-09",1980,1,9,0,12300,10400,22700
"AL","1980-01-10",1980,1,10,0,12300,10600,22900
"AL","1980-01-11",1980,1,11,0,12200,10700,22900
"AL","1980-01-12",1980,1,12,6890,12200,10600,29690
"AL","1980-01-13",1980,1,13,2890,12200,10600,25690
"AL","1980-01-14",1980,1,14,7500,12200,10500,30200
"AL","1980-01-15",1980,1,15,0,12200,10600,22800
"AL","1980-01-16",1980,1,16,7180,12200,10600,29980
"AL","1980-01-17",1980,1,17,23300,12100,10200,45600
"AL","1980-01-18",1980,1,18,21600,12100,10100,43800
"AL","1980-01-19",1980,1,19,0,12100,10300,22400
"AL","1980-01-20",1980,1,20,0,12100,10600,22700
"AL","1980-01-21",1980,1,21,0,12100,10600,22700
"AL","1980-01-22",1980,1,22,0,12100,10600,22700
"AL","1980-01-23",1980,1,23,3030,12000,10600,25630
"AL","1980-01-24",1980,1,24,2380,12000,10600,24980
"AL","1980-01-25",1980,1,25,1150,12000,10600,23750
"AL","1980-01-26",1980,1,26,879,12000,10600,23479
"AL","1980-01-27",1980,1,27,0,12000,10700,22700
"AL","1980-01-28",1980,1,28,0,11900,10700,22600
"AL","1980-01-29",1980,1,29,0,11900,10700,22600
"AL","1980-01-30",1980,1,30,0,11900,10700,22600
"AL","1980-01-31",1980,1,31,0,11900,10700,22600
"AL","1980-02-01",1980,2,32,0,11800,10700,22500
"AL","1980-02-02",1980,2,33,0,11800,10700,22500
"AL","1980-02-03",1980,2,34,0,11800,10700,22500
"AL","1980-02-04",1980,2,35,0,11800,10700,22500
"AL","1980-02-05",1980,2,36,0,11800,10700,22500
"AL","1980-02-06",1980,2,37,0,11700,10700,22400
"AL","1980-02-07",1980,2,38,0,11700,10700,22400
"AL","1980-02-08",1980,2,39,0,11700,10700,22400
"AL","1980-02-09",1980,2,40,0,11700,10700,22400
"AL","1980-02-10",1980,2,41,281,11700,10700,22681
"AL","1980-02-11",1980,2,42,188,11600,10600,22388
"AL","1980-02-12",1980,2,43,1550,11600,10600,23750
"AL","1980-02-13",1980,2,44,0,11600,10600,22200
"AL","1980-02-14",1980,2,45,0,11600,10600,22200
"AL","1980-02-15",1980,2,46,0,11500,10600,22100
"AL","1980-02-16",1980,2,47,0,11500,10600,22100
"AL","1980-02-17",1980,2,48,1030,11500,10600,23130
"AL","1980-02-18",1980,2,49,0,11500,10600,22100
"AL","1980-02-19",1980,2,50,0,11400,10600,22000
"AL","1980-02-20",1980,2,51,0,11400,10500,21900
"AL","1980-02-21",1980,2,52,2090,11400,10500,23990
"AL","1980-02-22",1980,2,53,0,11400,10500,21900
"AL","1980-02-23",1980,2,54,375,11400,10500,22275
"AL","1980-02-24",1980,2,55,0,11300,10500,21800
"AL","1980-02-25",1980,2,56,0,11300,10500,21800
"AL","1980-02-26",1980,2,57,0,11300,10500,21800
"AL","1980-02-27",1980,2,58,0,11300,10500,21800
"AL","1980-02-28",1980,2,59,504,11300,10500,22304
"AL","1980-02-29",1980,2,60,0,11200,10400,21600
"AL","1980-03-01",1980,3,61,0,11200,10400,21600
"AL","1980-03-02",1980,3,62,0,11200,10400,21600
"AL","1980-03-03",1980,3,63,0,11200,10400,21600
"AL","1980-03-04",1980,3,64,0,11200,10400,21600
"AL","1980-03-05",1980,3,65,0,11100,10400,21500
"AL","1980-03-06",1980,3,66,1900,11100,10400,23400
"AL","1980-03-07",1980,3,67,0,11100,10300,21400
"AL","1980-03-08",1980,3,68,0,11100,10400,21500
"AL","1980-03-09",1980,3,69,0,11100,10300,21400
"AL","1980-03-10",1980,3,70,0,11000,10400,21400
"AL","1980-03-11",1980,3,71,4990,11000,10300,26290
"AL","1980-03-12",1980,3,72,0,11000,10200,21200
"AL","1980-03-13",1980,3,73,0,11000,10300,21300
"AL","1980-03-14",1980,3,74,0,11000,10300,21300
"AL","1980-03-15",1980,3,75,0,10900,10300,21200
"AL","1980-03-16",1980,3,76,0,10900,10300,21200
"AL","1980-03-17",1980,3,77,1890,10900,10300,23090
"AL","1980-03-18",1980,3,78,12000,10900,10000,32900
"AL","1980-03-19",1980,3,79,0,10900,10100,21000
"AL","1980-03-20",1980,3,80,0,10900,10200,21100
"AL","1980-03-21",1980,3,81,0,10800,10200,21000
"AL","1980-03-22",1980,3,82,0,10800,10200,21000
"AL","1980-03-23",1980,3,83,0,10800,10200,21000
"AL","1980-03-24",1980,3,84,6870,10800,10100,27770
"AL","1980-03-25",1980,3,85,949,10800,10100,21849
"AL","1980-03-26",1980,3,86,0,10700,10200,20900
"AL","1980-03-27",1980,3,87,0,10700,10200,20900
"AL","1980-03-28",1980,3,88,7520,10700,10100,28320
"AL","1980-03-29",1980,3,89,0,10700,10100,20800
"AL","1980-03-30",1980,3,90,0,10700,10500,21200
"AL","1980-03-31",1980,3,91,0,10700,11900,22600
"AL","1980-04-01",1980,4,92,0,11600,13900,25500
"AL","1980-04-02",1980,4,93,0,12100,13900,26000
"AL","1980-04-03",1980,4,94,0,13000,15300,28300
"AL","1980-04-04",1980,4,95,0,13600,15800,29400
"AL","1980-04-05",1980,4,96,7030,12700,15400,35130
"AL","1980-04-06",1980,4,97,0,14000,16600,30600
"AL","1980-04-07",1980,4,98,4810,20300,33100,58210
"AL","1980-04-08",1980,4,99,9950,22200,25200,57350
"AL","1980-04-09",1980,4,100,12900,24700,18400,56000
"AL","1980-04-10",1980,4,101,10600,16200,14000,40800
"AL","1980-04-11",1980,4,102,6120,14400,12400,32920
"AL","1980-04-12",1980,4,103,1840,14000,13100,28940
"AL","1980-04-13",1980,4,104,1070,15200,11900,28170
"AL","1980-04-14",1980,4,105,2140,13900,11400,27440
"AL","1980-04-15",1980,4,106,0,13300,11200,24500
"AL","1980-04-16",1980,4,107,0,13100,11100,24200
"AL","1980-04-17",1980,4,108,0,13000,11000,24000
"AL","1980-04-18",1980,4,109,0,12900,11000,23900
"AL","1980-04-19",1980,4,110,0,12700,10900,23600
"AL","1980-04-20",1980,4,111,0,12600,10800,23400
"AL","1980-04-21",1980,4,112,0,12500,10800,23300
"AL","1980-04-22",1980,4,113,0,12400,10800,23200
"AL","1980-04-23",1980,4,114,0,12300,10800,23100
"AL","1980-04-24",1980,4,115,759,12200,10800,23759
"AL","1980-04-25",1980,4,116,0,12200,10800,23000
"AL","1980-04-26",1980,4,117,512,12100,10800,23412
"AL","1980-04-27",1980,4,118,0,12000,10800,22800
"AL","1980-04-28",1980,4,119,0,11900,10800,22700
"AL","1980-04-29",1980,4,120,0,11900,10800,22700
"AL","1980-04-30",1980,4,121,0,11800,10800,22600
"AL","1980-05-01",1980,5,122,0,11800,10800,22600
"AL","1980-05-02",1980,5,123,0,11700,10900,22600
"AL","1980-05-03",1980,5,124,0,11700,10900,22600
"AL","1980-05-04",1980,5,125,0,11600,11000,22600
"AL","1980-05-05",1980,5,126,0,11600,11000,22600
"AL","1980-05-06",1980,5,127,0,11500,11100,22600
"AL","1980-05-07",1980,5,128,0,11500,11000,22500
"AL","1980-05-08",1980,5,129,1350,11000,11000,23350
"AL","1980-05-09",1980,5,130,731,10800,10900,22431
"AL","1980-05-10",1980,5,131,0,10700,10800,21500
"AL","1980-05-11",1980,5,132,4800,10700,10700,26200
"AL","1980-05-12",1980,5,133,22000,14300,11300,47600
"AL","1980-05-13",1980,5,134,0,11300,10400,21700
"AL","1980-05-14",1980,5,135,1040,11200,10500,22740
"AL","1980-05-15",1980,5,136,0,10900,10500,21400
"AL","1980-05-16",1980,5,137,0,10800,10500,21300
"AL","1980-05-17",1980,5,138,0,10600,10500,21100
"AL","1980-05-18",1980,5,139,0,10300,10400,20700
"AL","1980-05-19",1980,5,140,7600,10900,10300,28800
"AL","1980-05-20",1980,5,141,0,10300,10300,20600
"AL","1980-05-21",1980,5,142,0,9970,10300,20270
"AL","1980-05-22",1980,5,143,0,9850,10300,20150
"AL","1980-05-23",1980,5,144,0,9800,10300,20100
"AL","1980-05-24",1980,5,145,0,9760,10200,19960
"AL","1980-05-25",1980,5,146,0,9720,10200,19920
"AL","1980-05-26",1980,5,147,0,9690,10100,19790
"AL","1980-05-27",1980,5,148,0,9670,10100,19770
"AL","1980-05-28",1980,5,149,24800,11500,9780,46080
"AL","1980-05-29",1980,5,150,18200,13000,9470,40670
"AL","1980-05-30",1980,5,151,0,10600,9490,20090
"AL","1980-05-31",1980,5,152,43800,14400,10600,68800
"AL","1980-06-01",1980,6,153,28400,19700,17400,65500
"AL","1980-06-02",1980,6,154,1100,11900,9320,22320
"AL","1980-06-03",1980,6,155,4470,12400,9600,26470
"AL","1980-06-04",1980,6,156,0,11600,9670,21270
"AL","1980-06-05",1980,6,157,0,11300,9760,21060
"AL","1980-06-06",1980,6,158,7130,11800,9770,28700
"AL","1980-06-07",1980,6,159,27700,16800,12100,56600
"AL","1980-06-08",1980,6,160,22900,16600,16700,56200
"AL","1980-06-09",1980,6,161,14000,19200,14100,47300
"AL","1980-06-10",1980,6,162,3430,13700,10100,27230
"AL","1980-06-11",1980,6,163,0,12500,9980,22480
"AL","1980-06-12",1980,6,164,0,12000,10000,22000
"AL","1980-06-13",1980,6,165,0,11800,10000,21800
"AL","1980-06-14",1980,6,166,7180,11400,10000,28580
"AL","1980-06-15",1980,6,167,16900,13900,10200,41000
"AL","1980-06-16",1980,6,168,0,11700,9900,21600
"AL","1980-06-17",1980,6,169,0,11300,10000,21300
"AL","1980-06-18",1980,6,170,0,11200,10000,21200
"AL","1980-06-19",1980,6,171,21500,13200,10300,45000
"AL","1980-06-20",1980,6,172,28300,17700,14800,60800
"AL","1980-06-21",1980,6,173,0,12200,9820,22020
"AL","1980-06-22",1980,6,174,368,11900,10000,22268
"AL","1980-06-23",1980,6,175,1520,11400,10000,22920
"AL","1980-06-24",1980,6,176,0,11100,10000,21100
"AL","1980-06-25",1980,6,177,0,10800,10000,20800
"AL","1980-06-26",1980,6,178,0,10700,9990,20690
"AL","1980-06-27",1980,6,179,828,10600,9960,21388
"AL","1980-06-28",1980,6,180,9750,10400,9880,30030
"AL","1980-06-29",1980,6,181,37000,16500,10200,63700
"AL","1980-06-30",1980,6,182,11100,13000,9780,33880
"AL","1980-07-01",1980,7,183,760,12000,9690,22450
"AL","1980-07-02",1980,7,184,4390,11900,9890,26180
"AL","1980-07-03",1980,7,185,3050,11800,9990,24840
"AL","1980-07-04",1980,7,186,0,10900,9980,20880
"AL","1980-07-05",1980,7,187,0,10700,10000,20700
"AL","1980-07-06",1980,7,188,3360,10600,10000,23960
"AL","1980-07-07",1980,7,189,0,10400,10000,20400
"AL","1980-07-08",1980,7,190,0,10300,10100,20400
"AL","1980-07-09",1980,7,191,4140,10300,10200,24640
"AL","1980-07-10",1980,7,192,0,10200,10100,20300
"AL","1980-07-11",1980,7,193,0,10100,10100,20200
"AL","1980-07-12",1980,7,194,30500,13400,9880,53780
"AL","1980-07-13",1980,7,195,5510,11600,9690,26800
"AL","1980-07-14",1980,7,196,0,10700,9840,20540
"AL","1980-07-15",1980,7,197,8840,10300,9890,29030
"AL","1980-07-16",1980,7,198,1210,10200,9900,21310
"AL","1980-07-17",1980,7,199,9160,10800,9910,29870
"AL","1980-07-18",1980,7,200,5470,10800,9840,26110
"AL","1980-07-19",1980,7,201,8750,10100,9850,28700
"AL","1980-07-20",1980,7,202,14900,12100,9820,36820
"AL","1980-07-21",1980,7,203,50800,19400,11900,82100
"AL","1980-07-22",1980,7,204,5950,11700,9560,27210
"AL","1980-07-23",1980,7,205,0,11400,9710,21110
"AL","1980-07-24",1980,7,206,0,11100,9800,20900
"AL","1980-07-25",1980,7,207,0,10900,9820,20720
"AL","1980-07-26",1980,7,208,18600,12700,9850,41150
"AL","1980-07-27",1980,7,209,0,11200,9690,20890
"AL","1980-07-28",1980,7,210,0,10900,9830,20730
"AL","1980-07-29",1980,7,211,0,10500,9850,20350
"AL","1980-07-30",1980,7,212,12900,12300,9780,34980
"AL","1980-07-31",1980,7,213,3680,11200,9700,24580
"AL","1980-08-01",1980,8,214,1450,11000,9760,22210
"AL","1980-08-02",1980,8,215,0,10400,9780,20180
"AL","1980-08-03",1980,8,216,351,10300,9820,20471
"AL","1980-08-04",1980,8,217,0,10100,9810,19910
"AL","1980-08-05",1980,8,218,18800,11400,9730,39930
"AL","1980-08-06",1980,8,219,5690,11600,9610,26900
"AL","1980-08-07",1980,8,220,0,10700,9690,20390
"AL","1980-08-08",1980,8,221,24000,14200,9960,48160
"AL","1980-08-09",1980,8,222,35900,20600,11800,68300
"AL","1980-08-10",1980,8,223,0,12100,9350,21450
"AL","1980-08-11",1980,8,224,0,11900,9610,21510
"AL","1980-08-12",1980,8,225,32000,18000,14800,64800
"AL","1980-08-13",1980,8,226,0,12400,9380,21780
"AL","1980-08-14",1980,8,227,0,12100,9650,21750
"AL","1980-08-15",1980,8,228,2420,11800,9660,23880
"AL","1980-08-16",1980,8,229,0,11400,9650,21050
"AL","1980-08-17",1980,8,230,0,11300,9690,20990
"AL","1980-08-18",1980,8,231,4780,11200,9660,25640
"AL","1980-08-19",1980,8,232,1210,11100,9650,21960
"AL","1980-08-20",1980,8,233,49300,10800,15500,75600
"AL","1980-08-21",1980,8,234,26400,12200,17600,56200
"AL","1980-08-22",1980,8,235,24700,14700,17000,56400
"AL","1980-08-23",1980,8,236,0,11600,9660,21260
"AL","1980-08-24",1980,8,237,0,11400,9890,21290
"AL","1980-08-25",1980,8,238,31400,13200,15900,60500
"AL","1980-08-26",1980,8,239,38300,27700,25400,91400
"AL","1980-08-27",1980,8,240,82700,42400,47500,172600
"AL","1980-08-28",1980,8,241,61300,42000,46300,149600
"AL","1980-08-29",1980,8,242,943,19400,21100,41443
"AL","1980-08-30",1980,8,243,637,15900,12600,29137
"AL","1980-08-31",1980,8,244,16800,18200,16500,51500
"AL","1980-09-01",1980,9,245,5400,15900,13100,34400
"AL","1980-09-02",1980,9,246,20500,22800,20400,63700
"AL","1980-09-03",1980,9,247,0,16100,13100,29200
"AL","1980-09-04",1980,9,248,17700,17300,17300,52300
"AL","1980-09-05",1980,9,249,38300,31800,29600,99700
"AL","1980-09-06",1980,9,250,0,16900,13600,30500
"AL","1980-09-07",1980,9,251,0,16400,13500,29900
"AL","1980-09-08",1980,9,252,0,15800,13500,29300
"AL","1980-09-09",1980,9,253,0,15300,13300,28600
"AL","1980-09-10",1980,9,254,6950,16100,13200,36250
"AL","1980-09-11",1980,9,255,0,15100,12900,28000
"AL","1980-09-12",1980,9,256,0,15000,12800,27800
"AL","1980-09-13",1980,9,257,2240,14700,12600,29540
"AL","1980-09-14",1980,9,258,74700,31300,33200,139200
"AL","1980-09-15",1980,9,259,4850,18500,15100,38450
"AL","1980-09-16",1980,9,260,151,16300,13000,29451
"AL","1980-09-17",1980,9,261,1360,16300,13100,30760
"AL","1980-09-18",1980,9,262,0,15800,13000,28800
"AL","1980-09-19",1980,9,263,1360,15800,12900,30060
"AL","1980-09-20",1980,9,264,0,15300,12800,28100
"AL","1980-09-21",1980,9,265,4950,16000,12800,33750
"AL","1980-09-22",1980,9,266,69400,41800,39100,150300
"AL","1980-09-23",1980,9,267,0,18400,15400,33800
"AL","1980-09-24",1980,9,268,0,16800,13400,30200
"AL","1980-09-25",1980,9,269,4960,17500,13500,35960
"AL","1980-09-26",1980,9,270,7530,19100,16100,42730
"AL","1980-09-27",1980,9,271,854,17900,14600,33354
"AL","1980-09-28",1980,9,272,989,17000,13600,31589
"AL","1980-09-29",1980,9,273,0,16500,13500,30000
"AL","1980-09-30",1980,9,274,0,16400,13500,29900
"AL","1980-10-01",1980,10,275,948,16200,13400,30548
"AL","1980-10-02",1980,10,276,988,15800,13200,29988
"AL","1980-10-03",1980,10,277,4150,15400,13100,32650
"AL","1980-10-04",1980,10,278,10600,18000,13400,42000
"AL","1980-10-05",1980,10,279,0,16600,13200,29800
"AL","1980-10-06",1980,10,280,0,16200,13100,29300
"AL","1980-10-07",1980,10,281,0,16100,13000,29100
"AL","1980-10-08",1980,10,282,0,16100,12900,29000
"AL","1980-10-09",1980,10,283,0,16100,12900,29000
"AL","1980-10-10",1980,10,284,0,16100,12900,29000
"AL","1980-10-11",1980,10,285,0,16000,12900,28900
"AL","1980-10-12",1980,10,286,3500,16300,12900,32700
"AL","1980-10-13",1980,10,287,937,16100,12800,29837
"AL","1980-10-14",1980,10,288,0,15800,12800,28600
"AL","1980-10-15",1980,10,289,485,15900,12800,29185
"AL","1980-10-16",1980,10,290,243,15900,12800,28943
"AL","1980-10-17",1980,10,291,938,15800,12800,29538
"AL","1980-10-18",1980,10,292,12500,17800,13500,43800
"AL","1980-10-19",1980,10,293,2630,16300,13500,32430
"AL","1980-10-20",1980,10,294,1080,16000,12800,29880
"AL","1980-10-21",1980,10,295,0,15900,12800,28700
"AL","1980-10-22",1980,10,296,881,15900,12800,29581
"AL","1980-10-23",1980,10,297,0,15800,12700,28500
"AL","1980-10-24",1980,10,298,5200,16500,13100,34800
"AL","1980-10-25",1980,10,299,38000,22000,25200,85200
"AL","1980-10-26",1980,10,300,19100,20200,18000,57300
"AL","1980-10-27",1980,10,301,3120,16900,13500,33520
"AL","1980-10-28",1980,10,302,0,16700,13400,30100
"AL","1980-10-29",1980,10,303,0,16500,13500,30000
"AL","1980-10-30",1980,10,304,0,16400,13500,29900
"AL","1980-10-31",1980,10,305,0,16600,15000,31600
"AL","1980-11-01",1980,11,306,0,18900,15700,34600
"AL","1980-11-02",1980,11,307,0,16800,13600,30400
"AL","1980-11-03",1980,11,308,0,16100,13100,29200
"AL","1980-11-04",1980,11,309,93.1,16100,13000,29193.1
"AL","1980-11-05",1980,11,310,0,16000,12900,28900
"AL","1980-11-06",1980,11,311,0,15900,12800,28700
"AL","1980-11-07",1980,11,312,0,15800,12700,28500
"AL","1980-11-08",1980,11,313,1830,15700,12800,30330
"AL","1980-11-09",1980,11,314,5090,15700,12600,33390
"AL","1980-11-10",1980,11,315,8840,16600,12800,38240
"AL","1980-11-11",1980,11,316,918,16400,12700,30018
"AL","1980-11-12",1980,11,317,0,15900,12700,28600
"AL","1980-11-13",1980,11,318,9420,15700,12700,37820
"AL","1980-11-14",1980,11,319,5240,15600,12700,33540
"AL","1980-11-15",1980,11,320,1840,15600,12800,30240
"AL","1980-11-16",1980,11,321,0,15500,12900,28400
"AL","1980-11-17",1980,11,322,0,15400,12900,28300
"AL","1980-11-18",1980,11,323,0,15400,12900,28300
"AL","1980-11-19",1980,11,324,0,15300,12900,28200
"AL","1980-11-20",1980,11,325,0,15300,12900,28200
"AL","1980-11-21",1980,11,326,0,15500,13100,28600
"AL","1980-11-22",1980,11,327,2230,17700,16300,36230
"AL","1980-11-23",1980,11,328,0,15200,12900,28100
"AL","1980-11-24",1980,11,329,0,15200,12700,27900
"AL","1980-11-25",1980,11,330,1360,15100,12500,28960
"AL","1980-11-26",1980,11,331,0,15000,12500,27500
"AL","1980-11-27",1980,11,332,0,15000,12400,27400
"AL","1980-11-28",1980,11,333,0,14900,12400,27300
"AL","1980-11-29",1980,11,334,0,14900,12300,27200
"AL","1980-11-30",1980,11,335,0,14800,12300,27100
"AL","1980-12-01",1980,12,336,0,14700,12200,26900
"AL","1980-12-02",1980,12,337,0,14700,12200,26900
"AL","1980-12-03",1980,12,338,386,14600,12100,27086
"AL","1980-12-04",1980,12,339,842,14600,12200,27642
"AL","1980-12-05",1980,12,340,1840,14500,12200,28540
"AL","1980-12-06",1980,12,341,93.5,14500,12200,26793.5
"AL","1980-12-07",1980,12,342,258,14600,12500,27358
"AL","1980-12-08",1980,12,343,1710,15000,12400,29110
"AL","1980-12-09",1980,12,344,2430,14800,12400,29630
"AL","1980-12-10",1980,12,345,93.5,14500,12200,26793.5
"AL","1980-12-11",1980,12,346,632,14400,12200,27232
"AL","1980-12-12",1980,12,347,0,14300,12200,26500
"AL","1980-12-13",1980,12,348,1220,14300,12200,27720
"AL","1980-12-14",1980,12,349,258,14200,12200,26658
"AL","1980-12-15",1980,12,350,0,14200,12100,26300
"AL","1980-12-16",1980,12,351,0,14200,12100,26300
"AL","1980-12-17",1980,12,352,1040,14100,12100,27240
"AL","1980-12-18",1980,12,353,948,14100,12100,27148
"AL","1980-12-19",1980,12,354,1940,14000,12000,27940
"AL","1980-12-20",1980,12,355,0,14000,12000,26000
"AL","1980-12-21",1980,12,356,0,14000,12000,26000
"AL","1980-12-22",1980,12,357,0,13900,12000,25900
"AL","1980-12-23",1980,12,358,1760,13900,12000,27660
"AL","1980-12-24",1980,12,359,1280,13800,11900,26980
"AL","1980-12-25",1980,12,360,1170,13800,11900,26870
"AL","1980-12-26",1980,12,361,0,13800,11900,25700
"AL","1980-12-27",1980,12,362,0,13700,11900,25600
"AL","1980-12-28",1980,12,363,0,13700,11900,25600
"AL","1980-12-29",1980,12,364,0,13600,11900,25500
"AL","1980-12-30",1980,12,365,0,13600,11900,25500
"AL","1980-12-31",1980,12,366,748,13500,11800,26048
"AL","1981-01-01",1981,1,1,10300,13500,11600,35400
"AL","1981-01-02",1981,1,2,0,13500,11700,25200
"AL","1981-01-03",1981,1,3,1910,13400,11700,27010
"AL","1981-01-04",1981,1,4,645,13400,11700,25745
"AL","1981-01-05",1981,1,5,0,13400,11700,25100
"AL","1981-01-06",1981,1,6,0,13300,11700,25000
"AL","1981-01-07",1981,1,7,0,13300,11700,25000
"AL","1981-01-08",1981,1,8,0,13200,11600,24800
"AL","1981-01-09",1981,1,9,0,13200,11600,24800
"AL","1981-01-10",1981,1,10,0,13200,11600,24800
"AL","1981-01-11",1981,1,11,0,13100,11600,24700
"AL","1981-01-12",1981,1,12,0,13100,11600,24700
"AL","1981-01-13",1981,1,13,0,13000,11600,24600
"AL","1981-01-14",1981,1,14,0,13000,11600,24600
"AL","1981-01-15",1981,1,15,937,13000,11500,25437
"AL","1981-01-16",1981,1,16,1890,12900,11500,26290
"AL","1981-01-17",1981,1,17,4900,12900,11400,29200
"AL","1981-01-18",1981,1,18,0,12900,11400,24300
"AL","1981-01-19",1981,1,19,0,12800,11400,24200
"AL","1981-01-20",1981,1,20,0,12800,11400,24200
"AL","1981-01-21",1981,1,21,0,12800,11400,24200
"AL","1981-01-22",1981,1,22,0,12800,11400,24200
"AL","1981-01-23",1981,1,23,0,12700,11400,24100
"AL","1981-01-24",1981,1,24,0,12700,11400,24100
"AL","1981-01-25",1981,1,25,0,12700,11400,24100
"AL","1981-01-26",1981,1,26,0,12600,11400,24000
"AL","1981-01-27",1981,1,27,0,12800,12100,24900
"AL","1981-01-28",1981,1,28,215,12600,11400,24215
"AL","1981-01-29",1981,1,29,0,12600,11400,24000
"AL","1981-01-30",1981,1,30,0,12500,11300,23800
"AL","1981-01-31",1981,1,31,0,12500,11300,23800
"AL","1981-02-01",1981,2,32,0,12500,11300,23800
"AL","1981-02-02",1981,2,33,5220,12500,11200,28920
"AL","1981-02-03",1981,2,34,258,12400,11200,23858
"AL","1981-02-04",1981,2,35,0,12400,11100,23500
"AL","1981-02-05",1981,2,36,0,12400,11100,23500
"AL","1981-02-06",1981,2,37,844,12300,11100,24244
"AL","1981-02-07",1981,2,38,129,12300,11100,23529
"AL","1981-02-08",1981,2,39,2180,12300,11100,25580
"AL","1981-02-09",1981,2,40,1940,12300,11000,25240
"AL","1981-02-10",1981,2,41,129,12200,11000,23329
"AL","1981-02-11",1981,2,42,2630,12200,11000,25830
"AL","1981-02-12",1981,2,43,1810,12200,10900,24910
"AL","1981-02-13",1981,2,44,0,12100,10900,23000
"AL","1981-02-14",1981,2,45,0,12100,11000,23100
"AL","1981-02-15",1981,2,46,0,12100,11000,23100
"AL","1981-02-16",1981,2,47,0,12100,10900,23000
"AL","1981-02-17",1981,2,48,0,12000,11000,23000
"AL","1981-02-18",1981,2,49,0,13200,13600,26800
"AL","1981-02-19",1981,2,50,1620,19300,20800,41720
"AL","1981-02-20",1981,2,51,3000,13600,12600,29200
"AL","1981-02-21",1981,2,52,0,13000,11100,24100
"AL","1981-02-22",1981,2,53,0,12800,10900,23700
"AL","1981-02-23",1981,2,54,12100,14500,15200,41800
"AL","1981-02-24",1981,2,55,21800,14300,12100,48200
"AL","1981-02-25",1981,2,56,3920,12900,10800,27620
"AL","1981-02-26",1981,2,57,0,12700,10800,23500
"AL","1981-02-27",1981,2,58,0,12600,10900,23500
"AL","1981-02-28",1981,2,59,844,12500,10900,24244
"AL","1981-03-01",1981,3,60,6000,12500,10800,29300
"AL","1981-03-02",1981,3,61,0,12400,10800,23200
"AL","1981-03-03",1981,3,62,0,12300,10900,23200
"AL","1981-03-04",1981,3,63,0,12300,10900,23200
"AL","1981-03-05",1981,3,64,0,12200,10900,23100
"AL","1981-03-06",1981,3,65,0,12100,10900,23000
"AL","1981-03-07",1981,3,66,237,12100,10900,23237
"AL","1981-03-08",1981,3,67,0,12000,10900,22900
"AL","1981-03-09",1981,3,68,0,12000,10900,22900
"AL","1981-03-10",1981,3,69,0,12000,10900,22900
"AL","1981-03-11",1981,3,70,0,11900,10900,22800
"AL","1981-03-12",1981,3,71,0,11900,10900,22800
"AL","1981-03-13",1981,3,72,0,11900,11000,22900
"AL","1981-03-14",1981,3,73,0,11900,11600,23500
"AL","1981-03-15",1981,3,74,0,11800,11000,22800
"AL","1981-03-16",1981,3,75,0,11900,11400,23300
"AL","1981-03-17",1981,3,76,0,12000,11000,23000
"AL","1981-03-18",1981,3,77,5090,11900,10600,27590
"AL","1981-03-19",1981,3,78,0,11800,10600,22400
"AL","1981-03-20",1981,3,79,0,11700,10700,22400
"AL","1981-03-21",1981,3,80,0,11700,10700,22400
"AL","1981-03-22",1981,3,81,0,11700,10700,22400
"AL","1981-03-23",1981,3,82,0,11900,10700,22600
"AL","1981-03-24",1981,3,83,0,11600,10500,22100
"AL","1981-03-25",1981,3,84,0,11500,10400,21900
"AL","1981-03-26",1981,3,85,0,11500,10500,22000
"AL","1981-03-27",1981,3,86,2550,12000,10500,25050
"AL","1981-03-28",1981,3,87,474,11600,10400,22474
"AL","1981-03-29",1981,3,88,372,11400,10400,22172
"AL","1981-03-30",1981,3,89,3400,11700,10500,25600
"AL","1981-03-31",1981,3,90,4960,12000,10500,27460
"AL","1981-04-01",1981,4,91,512,11500,10400,22412
"AL","1981-04-02",1981,4,92,6580,12500,10500,29580
"AL","1981-04-03",1981,4,93,512,11500,10300,22312
"AL","1981-04-04",1981,4,94,3160,11400,10400,24960
"AL","1981-04-05",1981,4,95,83500,32400,41500,157400
"AL","1981-04-06",1981,4,96,7360,14300,17100,38760
"AL","1981-04-07",1981,4,97,0,13500,11500,25000
"AL","1981-04-08",1981,4,98,0,14700,11200,25900
"AL","1981-04-09",1981,4,99,1690,13500,10800,25990
"AL","1981-04-10",1981,4,100,0,13000,10700,23700
"AL","1981-04-11",1981,4,101,2930,13300,10700,26930
"AL","1981-04-12",1981,4,102,0,12800,10600,23400
"AL","1981-04-13",1981,4,103,0,12600,10600,23200
"AL","1981-04-14",1981,4,104,1520,12400,10600,24520
"AL","1981-04-15",1981,4,105,1040,12600,10600,24240
"AL","1981-04-16",1981,4,106,0,12200,10600,22800
"AL","1981-04-17",1981,4,107,0,12100,10700,22800
"AL","1981-04-18",1981,4,108,174,12100,10700,22974
"AL","1981-04-19",1981,4,109,0,12000,10700,22700
"AL","1981-04-20",1981,4,110,7450,12700,11000,31150
"AL","1981-04-21",1981,4,111,0,11900,10600,22500
"AL","1981-04-22",1981,4,112,0,11900,10600,22500
"AL","1981-04-23",1981,4,113,1140,11900,10600,23640
"AL","1981-04-24",1981,4,114,31600,17100,18600,67300
"AL","1981-04-25",1981,4,115,6500,13700,12200,32400
"AL","1981-04-26",1981,4,116,0,12400,10400,22800
"AL","1981-04-27",1981,4,117,1230,12400,10500,24130
"AL","1981-04-28",1981,4,118,0,12200,10500,22700
"AL","1981-04-29",1981,4,119,569,12200,10400,23169
"AL","1981-04-30",1981,4,120,0,12100,10400,22500
"AL","1981-05-01",1981,5,121,0,12000,10400,22400
"AL","1981-05-02",1981,5,122,2280,12300,10400,24980
"AL","1981-05-03",1981,5,123,0,11800,10400,22200
"AL","1981-05-04",1981,5,124,15200,12400,11000,38600
"AL","1981-05-05",1981,5,125,59800,26500,34400,120700
"AL","1981-05-06",1981,5,126,82200,44500,49700,176400
"AL","1981-05-07",1981,5,127,0,18000,20700,38700
"AL","1981-05-08",1981,5,128,0,15100,12400,27500
"AL","1981-05-09",1981,5,129,0,14200,12100,26300
"AL","1981-05-10",1981,5,130,1960,14000,12200,28160
"AL","1981-05-11",1981,5,131,0,13800,12100,25900
"AL","1981-05-12",1981,5,132,0,13700,12100,25800
"AL","1981-05-13",1981,5,133,0,13500,12000,25500
"AL","1981-05-14",1981,5,134,0,13000,11900,24900
"AL","1981-05-15",1981,5,135,0,12500,11700,24200
"AL","1981-05-16",1981,5,136,0,12100,11600,23700
"AL","1981-05-17",1981,5,137,0,11800,11400,23200
"AL","1981-05-18",1981,5,138,0,11700,11300,23000
"AL","1981-05-19",1981,5,139,0,11500,11200,22700
"AL","1981-05-20",1981,5,140,0,11400,11200,22600
"AL","1981-05-21",1981,5,141,0,11300,11200,22500
"AL","1981-05-22",1981,5,142,0,11200,11100,22300
"AL","1981-05-23",1981,5,143,0,11100,11100,22200
"AL","1981-05-24",1981,5,144,8310,11000,10900,30210
"AL","1981-05-25",1981,5,145,72900,23400,17100,113400
"AL","1981-05-26",1981,5,146,4040,13600,10500,28140
"AL","1981-05-27",1981,5,147,5200,13800,10900,29900
"AL","1981-05-28",1981,5,148,0,13100,11000,24100
"AL","1981-05-29",1981,5,149,185,12900,11000,24085
"AL","1981-05-30",1981,5,150,16100,14800,11200,42100
"AL","1981-05-31",1981,5,151,1290,12900,11100,25290
"AL","1981-06-01",1981,6,152,0,12300,11000,23300
"AL","1981-06-02",1981,6,153,0,12100,11000,23100
"AL","1981-06-03",1981,6,154,0,11900,11000,22900
"AL","1981-06-04",1981,6,155,8790,13500,11000,33290
"AL","1981-06-05",1981,6,156,1980,12300,10900,25180
"AL","1981-06-06",1981,6,157,0,11900,10900,22800
"AL","1981-06-07",1981,6,158,0,11700,11000,22700
"AL","1981-06-08",1981,6,159,2580,11300,10900,24780
"AL","1981-06-09",1981,6,160,9300,12700,10800,32800
"AL","1981-06-10",1981,6,161,0,11700,10800,22500
"AL","1981-06-11",1981,6,162,3180,11900,10800,25880
"AL","1981-06-12",1981,6,163,10800,12500,10800,34100
"AL","1981-06-13",1981,6,164,14200,12900,10800,37900
"AL","1981-06-14",1981,6,165,0,11800,10800,22600
"AL","1981-06-15",1981,6,166,169000,147000,71900,387900
"AL","1981-06-16",1981,6,167,93800,76000,67000,236800
"AL","1981-06-17",1981,6,168,2580,26000,29700,58280
"AL","1981-06-18",1981,6,169,0,20500,16700,37200
"AL","1981-06-19",1981,6,170,0,16900,12700,29600
"AL","1981-06-20",1981,6,171,3310,16500,13000,32810
"AL","1981-06-21",1981,6,172,70900,32200,37800,140900
"AL","1981-06-22",1981,6,173,10700,24300,18600,53600
"AL","1981-06-23",1981,6,174,28100,24000,24900,77000
"AL","1981-06-24",1981,6,175,2650,18600,15300,36550
"AL","1981-06-25",1981,6,176,14100,22300,18400,54800
"AL","1981-06-26",1981,6,177,1010,18400,14800,34210
"AL","1981-06-27",1981,6,178,0,17900,14900,32800
"AL","1981-06-28",1981,6,179,0,17600,15000,32600
"AL","1981-06-29",1981,6,180,10700,18700,15100,44500
"AL","1981-06-30",1981,6,181,53200,41700,32500,127400
"AL","1981-07-01",1981,7,182,0,19200,15300,34500
"AL","1981-07-02",1981,7,183,0,18200,15200,33400
"AL","1981-07-03",1981,7,184,0,17800,15300,33100
"AL","1981-07-04",1981,7,185,0,17100,15300,32400
"AL","1981-07-05",1981,7,186,4830,16600,15200,36630
"AL","1981-07-06",1981,7,187,0,16200,15100,31300
"AL","1981-07-07",1981,7,188,0,16000,14900,30900
"AL","1981-07-08",1981,7,189,0,15900,14700,30600
"AL","1981-07-09",1981,7,190,0,15700,14500,30200
"AL","1981-07-10",1981,7,191,30200,20300,14500,65000
"AL","1981-07-11",1981,7,192,0,16200,14200,30400
"AL","1981-07-12",1981,7,193,0,15600,14200,29800
"AL","1981-07-13",1981,7,194,263,15500,14000,29763
"AL","1981-07-14",1981,7,195,4770,16200,13900,34870
"AL","1981-07-15",1981,7,196,817,15500,13800,30117
"AL","1981-07-16",1981,7,197,15600,17200,13700,46500
"AL","1981-07-17",1981,7,198,686,16200,13600,30486
"AL","1981-07-18",1981,7,199,0,15800,13700,29500
"AL","1981-07-19",1981,7,200,1770,16200,13600,31570
"AL","1981-07-20",1981,7,201,0,15500,13600,29100
"AL","1981-07-21",1981,7,202,9100,15700,13500,38300
"AL","1981-07-22",1981,7,203,5620,16100,13400,35120
"AL","1981-07-23",1981,7,204,0,15500,13400,28900
"AL","1981-07-24",1981,7,205,0,15500,13400,28900
"AL","1981-07-25",1981,7,206,0,15400,13400,28800
"AL","1981-07-26",1981,7,207,1520,15200,13400,30120
"AL","1981-07-27",1981,7,208,0,15100,13400,28500
"AL","1981-07-28",1981,7,209,0,15000,13400,28400
"AL","1981-07-29",1981,7,210,2230,15200,13300,30730
"AL","1981-07-30",1981,7,211,0,15200,13300,28500
"AL","1981-07-31",1981,7,212,0,15000,13300,28300
"AL","1981-08-01",1981,8,213,0,15000,13300,28300
"AL","1981-08-02",1981,8,214,10500,14800,13200,38500
"AL","1981-08-03",1981,8,215,5860,16000,13200,35060
"AL","1981-08-04",1981,8,216,0,15200,13200,28400
"AL","1981-08-05",1981,8,217,15000,17300,13200,45500
"AL","1981-08-06",1981,8,218,0,15700,13100,28800
"AL","1981-08-07",1981,8,219,2980,15400,13200,31580
"AL","1981-08-08",1981,8,220,27700,22000,13500,63200
"AL","1981-08-09",1981,8,221,5030,17600,13000,35630
"AL","1981-08-10",1981,8,222,5220,17300,13200,35720
"AL","1981-08-11",1981,8,223,0,16300,13200,29500
"AL","1981-08-12",1981,8,224,1970,16200,13200,31370
"AL","1981-08-13",1981,8,225,0,15600,13100,28700
"AL","1981-08-14",1981,8,226,0,15400,13200,28600
"AL","1981-08-15",1981,8,227,0,15100,13100,28200
"AL","1981-08-16",1981,8,228,0,14700,13100,27800
"AL","1981-08-17",1981,8,229,0,14600,13000,27600
"AL","1981-08-18",1981,8,230,0,14500,13000,27500
"AL","1981-08-19",1981,8,231,0,14300,12900,27200
"AL","1981-08-20",1981,8,232,0,14200,12900,27100
"AL","1981-08-21",1981,8,233,0,14200,12800,27000
"AL","1981-08-22",1981,8,234,0,14100,12800,26900
"AL","1981-08-23",1981,8,235,1210,14000,12800,28010
"AL","1981-08-24",1981,8,236,0,13900,12700,26600
"AL","1981-08-25",1981,8,237,0,13900,12700,26600
"AL","1981-08-26",1981,8,238,2330,13800,12600,28730
"AL","1981-08-27",1981,8,239,10300,13900,12600,36800
"AL","1981-08-28",1981,8,240,725,13800,12500,27025
"AL","1981-08-29",1981,8,241,0,13600,12500,26100
"AL","1981-08-30",1981,8,242,8580,14700,12500,35780
"AL","1981-08-31",1981,8,243,5770,15300,12400,33470
"AL","1981-09-01",1981,9,244,0,14400,12400,26800
"AL","1981-09-02",1981,9,245,659,14100,12500,27259
"AL","1981-09-03",1981,9,246,0,13800,12400,26200
"AL","1981-09-04",1981,9,247,0,13600,12400,26000
"AL","1981-09-05",1981,9,248,0,13500,12400,25900
"AL","1981-09-06",1981,9,249,0,13400,12400,25800
"AL","1981-09-07",1981,9,250,0,13300,12300,25600
"AL","1981-09-08",1981,9,251,15300,14300,12300,41900
"AL","1981-09-09",1981,9,252,8210,15400,12200,35810
"AL","1981-09-10",1981,9,253,0,14100,12200,26300
"AL","1981-09-11",1981,9,254,0,13900,12300,26200
"AL","1981-09-12",1981,9,255,0,13500,12300,25800
"AL","1981-09-13",1981,9,256,0,13300,12200,25500
"AL","1981-09-14",1981,9,257,0,13100,12200,25300
"AL","1981-09-15",1981,9,258,0,13000,12200,25200
"AL","1981-09-16",1981,9,259,439,12800,12100,25339
"AL","1981-09-17",1981,9,260,3040,12800,12000,27840
"AL","1981-09-18",1981,9,261,908,12900,12000,25808
"AL","1981-09-19",1981,9,262,454,12900,12000,25354
"AL","1981-09-20",1981,9,263,0,12800,12000,24800
"AL","1981-09-21",1981,9,264,0,12900,11900,24800
"AL","1981-09-22",1981,9,265,1350,12800,11900,26050
"AL","1981-09-23",1981,9,266,0,12800,11900,24700
"AL","1981-09-24",1981,9,267,0,12700,11900,24600
"AL","1981-09-25",1981,9,268,2130,12800,11800,26730
"AL","1981-09-26",1981,9,269,1650,12700,11800,26150
"AL","1981-09-27",1981,9,270,2540,12900,11800,27240
"AL","1981-09-28",1981,9,271,4480,13300,11700,29480
"AL","1981-09-29",1981,9,272,0,12800,11700,24500
"AL","1981-09-30",1981,9,273,3090,13100,11700,27890
"AL","1981-10-01",1981,10,274,9050,13700,11600,34350
"AL","1981-10-02",1981,10,275,49100,20600,14400,84100
"AL","1981-10-03",1981,10,276,5510,15600,13300,34410
"AL","1981-10-04",1981,10,277,0,14600,11900,26500
"AL","1981-10-05",1981,10,278,17900,17900,17900,53700
"AL","1981-10-06",1981,10,279,2730,15800,14100,32630
"AL","1981-10-07",1981,10,280,18000,19700,18500,56200
"AL","1981-10-08",1981,10,281,0,15600,12700,28300
"AL","1981-10-09",1981,10,282,0,14900,12100,27000
"AL","1981-10-10",1981,10,283,0,14700,12100,26800
"AL","1981-10-11",1981,10,284,4170,14900,12000,31070
"AL","1981-10-12",1981,10,285,369,14500,12000,26869
"AL","1981-10-13",1981,10,286,0,14200,11900,26100
"AL","1981-10-14",1981,10,287,0,14200,11800,26000
"AL","1981-10-15",1981,10,288,26000,19200,17100,62300
"AL","1981-10-16",1981,10,289,6910,17600,15600,40110
"AL","1981-10-17",1981,10,290,0,15000,12500,27500
"AL","1981-10-18",1981,10,291,6700,14600,13500,34800
"AL","1981-10-19",1981,10,292,27100,22200,24600,73900
"AL","1981-10-20",1981,10,293,1810,15600,13900,31310
"AL","1981-10-21",1981,10,294,0,15200,12400,27600
"AL","1981-10-22",1981,10,295,528,14800,12400,27728
"AL","1981-10-23",1981,10,296,705,14600,12300,27605
"AL","1981-10-24",1981,10,297,2360,14500,12400,29260
"AL","1981-10-25",1981,10,298,0,14400,12300,26700
"AL","1981-10-26",1981,10,299,3440,14300,12600,30340
"AL","1981-10-27",1981,10,300,0,14300,12300,26600
"AL","1981-10-28",1981,10,301,0,14400,12200,26600
"AL","1981-10-29",1981,10,302,0,14000,12200,26200
"AL","1981-10-30",1981,10,303,0,13900,12100,26000
"AL","1981-10-31",1981,10,304,0,13900,12000,25900
"AL","1981-11-01",1981,11,305,0,13800,12000,25800
"AL","1981-11-02",1981,11,306,0,13800,11900,25700
"AL","1981-11-03",1981,11,307,0,13700,11900,25600
"AL","1981-11-04",1981,11,308,0,13700,11900,25600
"AL","1981-11-05",1981,11,309,0,13600,11900,25500
"AL","1981-11-06",1981,11,310,547,13600,11900,26047
"AL","1981-11-07",1981,11,311,256,13600,11900,25756
"AL","1981-11-08",1981,11,312,0,13500,11800,25300
"AL","1981-11-09",1981,11,313,0,13400,11800,25200
"AL","1981-11-10",1981,11,314,0,13400,11800,25200
"AL","1981-11-11",1981,11,315,0,13300,11800,25100
"AL","1981-11-12",1981,11,316,0,13300,11700,25000
"AL","1981-11-13",1981,11,317,0,13200,11700,24900
"AL","1981-11-14",1981,11,318,0,13200,11700,24900
"AL","1981-11-15",1981,11,319,0,13100,11700,24800
"AL","1981-11-16",1981,11,320,0,13100,11700,24800
"AL","1981-11-17",1981,11,321,0,13100,11700,24800
"AL","1981-11-18",1981,11,322,0,13000,11600,24600
"AL","1981-11-19",1981,11,323,0,13000,11600,24600
"AL","1981-11-20",1981,11,324,0,12900,11600,24500
"AL","1981-11-21",1981,11,325,11400,12900,11300,35600
"AL","1981-11-22",1981,11,326,0,12900,11300,24200
"AL","1981-11-23",1981,11,327,0,12900,11400,24300
"AL","1981-11-24",1981,11,328,0,12800,11400,24200
"AL","1981-11-25",1981,11,329,0,12800,11400,24200
"AL","1981-11-26",1981,11,330,950,12800,11400,25150
"AL","1981-11-27",1981,11,331,1860,12900,11600,26360
"AL","1981-11-28",1981,11,332,2300,12900,11500,26700
"AL","1981-11-29",1981,11,333,0,12800,11300,24100
"AL","1981-11-30",1981,11,334,0,12700,11300,24000
"AL","1981-12-01",1981,12,335,0,12700,11300,24000
"AL","1981-12-02",1981,12,336,1740,12700,11200,25640
"AL","1981-12-03",1981,12,337,6720,12700,11100,30520
"AL","1981-12-04",1981,12,338,1160,12600,11100,24860
"AL","1981-12-05",1981,12,339,0,12600,11100,23700
"AL","1981-12-06",1981,12,340,0,12600,11200,23800
"AL","1981-12-07",1981,12,341,0,12600,11200,23800
"AL","1981-12-08",1981,12,342,0,12500,11200,23700
"AL","1981-12-09",1981,12,343,1330,12500,11100,24930
"AL","1981-12-10",1981,12,344,2470,12500,11100,26070
"AL","1981-12-11",1981,12,345,0,12500,11100,23600
"AL","1981-12-12",1981,12,346,0,12400,11100,23500
"AL","1981-12-13",1981,12,347,0,12400,11100,23500
"AL","1981-12-14",1981,12,348,129,12400,11100,23629
"AL","1981-12-15",1981,12,349,9350,12400,10900,32650
"AL","1981-12-16",1981,12,350,0,12300,10900,23200
"AL","1981-12-17",1981,12,351,0,12300,11000,23300
"AL","1981-12-18",1981,12,352,281,12300,11000,23581
"AL","1981-12-19",1981,12,353,93.5,12300,11000,23393.5
"AL","1981-12-20",1981,12,354,0,12200,11000,23200
"AL","1981-12-21",1981,12,355,0,12200,11000,23200
"AL","1981-12-22",1981,12,356,3440,12200,10900,26540
"AL","1981-12-23",1981,12,357,0,12200,10900,23100
"AL","1981-12-24",1981,12,358,561,12200,10900,23661
"AL","1981-12-25",1981,12,359,515,12100,10900,23515
"AL","1981-12-26",1981,12,360,0,12100,10900,23000
"AL","1981-12-27",1981,12,361,889,12100,10900,23889
"AL","1981-12-28",1981,12,362,5250,12100,10800,28150
"AL","1981-12-29",1981,12,363,0,12000,10800,22800
"AL","1981-12-30",1981,12,364,0,12000,10800,22800
"AL","1981-12-31",1981,12,365,561,12000,10800,23361
"AL","1982-01-01",1982,1,1,8800,12000,10600,31400
"AL","1982-01-02",1982,1,2,6190,12000,10600,28790
"AL","1982-01-03",1982,1,3,937,11900,10600,23437
"AL","1982-01-04",1982,1,4,14400,11900,10400,36700
"AL","1982-01-05",1982,1,5,0,11900,10400,22300
"AL","1982-01-06",1982,1,6,0,11900,10600,22500
"AL","1982-01-07",1982,1,7,0,11900,10600,22500
"AL","1982-01-08",1982,1,8,0,11800,10600,22400
"AL","1982-01-09",1982,1,9,312,11800,10600,22712
"AL","1982-01-10",1982,1,10,0,11800,10600,22400
"AL","1982-01-11",1982,1,11,937,11800,10600,23337
"AL","1982-01-12",1982,1,12,0,11800,10600,22400
"AL","1982-01-13",1982,1,13,0,11700,10600,22300
"AL","1982-01-14",1982,1,14,0,11700,10600,22300
"AL","1982-01-15",1982,1,15,0,11700,10600,22300
"AL","1982-01-16",1982,1,16,1250,11700,10600,23550
"AL","1982-01-17",1982,1,17,6250,11700,10500,28450
"AL","1982-01-18",1982,1,18,0,11600,10500,22100
"AL","1982-01-19",1982,1,19,0,11600,10500,22100
"AL","1982-01-20",1982,1,20,0,11600,10600,22200
"AL","1982-01-21",1982,1,21,156,11600,10500,22256
"AL","1982-01-22",1982,1,22,645,11600,10500,22745
"AL","1982-01-23",1982,1,23,4000,11500,10500,26000
"AL","1982-01-24",1982,1,24,39000,11500,9800,60300
"AL","1982-01-25",1982,1,25,2890,11500,9800,24190
"AL","1982-01-26",1982,1,26,0,11500,10100,21600
"AL","1982-01-27",1982,1,27,0,11500,10200,21700
"AL","1982-01-28",1982,1,28,0,11500,10200,21700
"AL","1982-01-29",1982,1,29,0,11500,10300,21800
"AL","1982-01-30",1982,1,30,6110,11400,10200,27710
"AL","1982-01-31",1982,1,31,5570,11400,10100,27070
"AL","1982-02-01",1982,2,32,0,11400,10200,21600
"AL","1982-02-02",1982,2,33,0,11400,10300,21700
"AL","1982-02-03",1982,2,34,4190,11400,10200,25790
"AL","1982-02-04",1982,2,35,0,11300,10200,21500
"AL","1982-02-05",1982,2,36,0,11300,10300,21600
"AL","1982-02-06",1982,2,37,0,11300,10300,21600
"AL","1982-02-07",1982,2,38,0,11300,10300,21600
"AL","1982-02-08",1982,2,39,481,11300,10300,22081
"AL","1982-02-09",1982,2,40,0,11200,10300,21500
"AL","1982-02-10",1982,2,41,0,11200,10300,21500
"AL","1982-02-11",1982,2,42,0,11200,10300,21500
"AL","1982-02-12",1982,2,43,0,11200,10300,21500
"AL","1982-02-13",1982,2,44,0,11200,10300,21500
"AL","1982-02-14",1982,2,45,188,11100,10300,21588
"AL","1982-02-15",1982,2,46,517,11100,10300,21917
"AL","1982-02-16",1982,2,47,129,11100,10300,21529
"AL","1982-02-17",1982,2,48,0,11100,10300,21400
"AL","1982-02-18",1982,2,49,0,11100,10300,21400
"AL","1982-02-19",1982,2,50,0,11000,10300,21300
"AL","1982-02-20",1982,2,51,0,11000,10300,21300
"AL","1982-02-21",1982,2,52,0,11000,10300,21300
"AL","1982-02-22",1982,2,53,0,11000,10300,21300
"AL","1982-02-23",1982,2,54,0,11000,10300,21300
"AL","1982-02-24",1982,2,55,0,10900,10300,21200
"AL","1982-02-25",1982,2,56,1060,10900,10200,22160
"AL","1982-02-26",1982,2,57,1700,10900,10200,22800
"AL","1982-02-27",1982,2,58,0,10900,10200,21100
"AL","1982-02-28",1982,2,59,0,10900,10200,21100
"AL","1982-03-01",1982,3,60,0,10900,10200,21100
"AL","1982-03-02",1982,3,61,712,10800,10200,21712
"AL","1982-03-03",1982,3,62,0,10800,10200,21000
"AL","1982-03-04",1982,3,63,0,10800,10100,20900
"AL","1982-03-05",1982,3,64,0,10800,10100,20900
"AL","1982-03-06",1982,3,65,0,10800,10100,20900
"AL","1982-03-07",1982,3,66,0,10800,10100,20900
"AL","1982-03-08",1982,3,67,0,10700,10100,20800
"AL","1982-03-09",1982,3,68,517,10700,10100,21317
"AL","1982-03-10",1982,3,69,4830,10700,9960,25490
"AL","1982-03-11",1982,3,70,949,10700,9970,21619
"AL","1982-03-12",1982,3,71,0,10700,10000,20700
"AL","1982-03-13",1982,3,72,345,10700,10000,21045
"AL","1982-03-14",1982,3,73,18000,10700,9690,38390
"AL","1982-03-15",1982,3,74,0,10600,9730,20330
"AL","1982-03-16",1982,3,75,0,10600,9870,20470
"AL","1982-03-17",1982,3,76,8270,10600,9720,28590
"AL","1982-03-18",1982,3,77,10200,10600,9550,30350
"AL","1982-03-19",1982,3,78,0,10600,9660,20260
"AL","1982-03-20",1982,3,79,0,10600,9780,20380
"AL","1982-03-21",1982,3,80,1030,10600,9790,21420
"AL","1982-03-22",1982,3,81,7150,10500,9680,27330
"AL","1982-03-23",1982,3,82,1660,10500,9710,21870
"AL","1982-03-24",1982,3,83,0,10500,9790,20290
"AL","1982-03-25",1982,3,84,0,10500,9850,20350
"AL","1982-03-26",1982,3,85,0,10500,9870,20370
"AL","1982-03-27",1982,3,86,1980,10500,9820,22300
"AL","1982-03-28",1982,3,87,0,10500,9810,20310
"AL","1982-03-29",1982,3,88,0,10400,9820,20220
"AL","1982-03-30",1982,3,89,0,10400,9870,20270
"AL","1982-03-31",1982,3,90,3380,10400,11500,25280
"AL","1982-04-01",1982,4,91,10400,17700,25500,53600
"AL","1982-04-02",1982,4,92,0,12600,14000,26600
"AL","1982-04-03",1982,4,93,6140,13200,14200,33540
"AL","1982-04-04",1982,4,94,51900,12800,11900,76600
"AL","1982-04-05",1982,4,95,22100,11800,9390,43290
"AL","1982-04-06",1982,4,96,0,11600,9490,21090
"AL","1982-04-07",1982,4,97,0,11500,9640,21140
"AL","1982-04-08",1982,4,98,0,11300,9690,20990
"AL","1982-04-09",1982,4,99,0,11200,9740,20940
"AL","1982-04-10",1982,4,100,0,11200,9780,20980
"AL","1982-04-11",1982,4,101,2070,11100,9790,22960
"AL","1982-04-12",1982,4,102,3960,11000,9750,24710
"AL","1982-04-13",1982,4,103,6200,10900,13400,30500
"AL","1982-04-14",1982,4,104,19800,17000,27400,64200
"AL","1982-04-15",1982,4,105,0,13300,15900,29200
"AL","1982-04-16",1982,4,106,6810,20000,42300,69110
"AL","1982-04-17",1982,4,107,54500,131000,263000,448500
"AL","1982-04-18",1982,4,108,33300,165000,112000,310300
"AL","1982-04-19",1982,4,109,0,18700,11700,30400
"AL","1982-04-20",1982,4,110,25600,29200,21400,76200
"AL","1982-04-21",1982,4,111,16600,17600,14200,48400
"AL","1982-04-22",1982,4,112,0,15800,11500,27300
"AL","1982-04-23",1982,4,113,0,16500,12500,29000
"AL","1982-04-24",1982,4,114,0,19400,12600,32000
"AL","1982-04-25",1982,4,115,0,19700,12900,32600
"AL","1982-04-26",1982,4,116,253,15900,12100,28253
"AL","1982-04-27",1982,4,117,6790,16800,12300,35890
"AL","1982-04-28",1982,4,118,0,15200,12400,27600
"AL","1982-04-29",1982,4,119,0,14900,12700,27600
"AL","1982-04-30",1982,4,120,0,14700,13000,27700
"AL","1982-05-01",1982,5,121,0,14500,13100,27600
"AL","1982-05-02",1982,5,122,0,14300,13300,27600
"AL","1982-05-03",1982,5,123,0,14100,13300,27400
"AL","1982-05-04",1982,5,124,0,14000,13300,27300
"AL","1982-05-05",1982,5,125,2210,13900,13200,29310
"AL","1982-05-06",1982,5,126,26500,16800,18600,61900
"AL","1982-05-07",1982,5,127,35700,21800,26500,84000
"AL","1982-05-08",1982,5,128,42100,33000,31800,106900
"AL","1982-05-09",1982,5,129,0,16000,14600,30600
"AL","1982-05-10",1982,5,130,4800,15300,13700,33800
"AL","1982-05-11",1982,5,131,19200,18200,19700,57100
"AL","1982-05-12",1982,5,132,508,15200,13700,29408
"AL","1982-05-13",1982,5,133,0,14300,13700,28000
"AL","1982-05-14",1982,5,134,36200,22200,23600,82000
"AL","1982-05-15",1982,5,135,3560,15800,14100,33460
"AL","1982-05-16",1982,5,136,0,14500,13600,28100
"AL","1982-05-17",1982,5,137,5680,14600,13600,33880
"AL","1982-05-18",1982,5,138,4410,14100,13500,32010
"AL","1982-05-19",1982,5,139,18500,18700,15100,52300
"AL","1982-05-20",1982,5,140,554,14300,13200,28054
"AL","1982-05-21",1982,5,141,1640,14300,13300,29240
"AL","1982-05-22",1982,5,142,0,13500,13100,26600
"AL","1982-05-23",1982,5,143,0,13500,13000,26500
"AL","1982-05-24",1982,5,144,0,13200,12800,26000
"AL","1982-05-25",1982,5,145,0,13000,12700,25700
"AL","1982-05-26",1982,5,146,0,12700,12600,25300
"AL","1982-05-27",1982,5,147,0,12600,12400,25000
"AL","1982-05-28",1982,5,148,0,12400,12300,24700
"AL","1982-05-29",1982,5,149,0,12300,12300,24600
"AL","1982-05-30",1982,5,150,8100,13400,12100,33600
"AL","1982-05-31",1982,5,151,0,12600,12000,24600
"AL","1982-06-01",1982,6,152,36100,15700,12600,64400
"AL","1982-06-02",1982,6,153,1010,13600,11900,26510
"AL","1982-06-03",1982,6,154,0,13000,12100,25100
"AL","1982-06-04",1982,6,155,0,12900,12100,25000
"AL","1982-06-05",1982,6,156,0,12700,12100,24800
"AL","1982-06-06",1982,6,157,0,12500,12100,24600
"AL","1982-06-07",1982,6,158,0,12200,12100,24300
"AL","1982-06-08",1982,6,159,4970,12900,12000,29870
"AL","1982-06-09",1982,6,160,0,12300,11900,24200
"AL","1982-06-10",1982,6,161,1290,12100,11900,25290
"AL","1982-06-11",1982,6,162,22900,15700,11900,50500
"AL","1982-06-12",1982,6,163,0,13100,11700,24800
"AL","1982-06-13",1982,6,164,0,12700,11900,24600
"AL","1982-06-14",1982,6,165,0,12500,11900,24400
"AL","1982-06-15",1982,6,166,14200,12300,11900,38400
"AL","1982-06-16",1982,6,167,9630,13700,11900,35230
"AL","1982-06-17",1982,6,168,0,12600,11800,24400
"AL","1982-06-18",1982,6,169,5110,13300,11900,30310
"AL","1982-06-19",1982,6,170,0,12600,11800,24400
"AL","1982-06-20",1982,6,171,0,12500,11900,24400
"AL","1982-06-21",1982,6,172,17500,13600,12000,43100
"AL","1982-06-22",1982,6,173,3450,13300,11800,28550
"AL","1982-06-23",1982,6,174,5070,13800,11800,30670
"AL","1982-06-24",1982,6,175,0,12800,11800,24600
"AL","1982-06-25",1982,6,176,0,12600,11800,24400
"AL","1982-06-26",1982,6,177,13500,15100,11800,40400
"AL","1982-06-27",1982,6,178,0,12900,11600,24500
"AL","1982-06-28",1982,6,179,0,12700,11700,24400
"AL","1982-06-29",1982,6,180,0,12300,11700,24000
"AL","1982-06-30",1982,6,181,24900,14300,11900,51100
"AL","1982-07-01",1982,7,182,0,12800,11500,24300
"AL","1982-07-02",1982,7,183,0,12400,11700,24100
"AL","1982-07-03",1982,7,184,0,12200,11700,23900
"AL","1982-07-04",1982,7,185,5480,12200,11700,29380
"AL","1982-07-05",1982,7,186,15800,14000,11700,41500
"AL","1982-07-06",1982,7,187,7850,13400,11700,32950
"AL","1982-07-07",1982,7,188,0,12300,11700,24000
"AL","1982-07-08",1982,7,189,13800,13300,11800,38900
"AL","1982-07-09",1982,7,190,0,12100,11600,23700
"AL","1982-07-10",1982,7,191,14100,13000,11700,38800
"AL","1982-07-11",1982,7,192,41300,18900,13200,73400
"AL","1982-07-12",1982,7,193,37600,21900,20100,79600
"AL","1982-07-13",1982,7,194,3110,14200,11800,29110
"AL","1982-07-14",1982,7,195,161,13600,11900,25661
"AL","1982-07-15",1982,7,196,18300,15400,12500,46200
"AL","1982-07-16",1982,7,197,4550,14000,11900,30450
"AL","1982-07-17",1982,7,198,32400,20100,20900,73400
"AL","1982-07-18",1982,7,199,21600,19100,18100,58800
"AL","1982-07-19",1982,7,200,7880,15800,12600,36280
"AL","1982-07-20",1982,7,201,0,14000,12200,26200
"AL","1982-07-21",1982,7,202,0,13300,12200,25500
"AL","1982-07-22",1982,7,203,4200,13000,12000,29200
"AL","1982-07-23",1982,7,204,3240,13000,11900,28140
"AL","1982-07-24",1982,7,205,0,12500,11800,24300
"AL","1982-07-25",1982,7,206,1280,12400,11700,25380
"AL","1982-07-26",1982,7,207,321,12200,11700,24221
"AL","1982-07-27",1982,7,208,2830,12400,11600,26830
"AL","1982-07-28",1982,7,209,5750,12700,11500,29950
"AL","1982-07-29",1982,7,210,0,12100,11500,23600
"AL","1982-07-30",1982,7,211,4430,12100,11400,27930
"AL","1982-07-31",1982,7,212,32500,16700,11600,60800
"AL","1982-08-01",1982,8,213,0,13000,11200,24200
"AL","1982-08-02",1982,8,214,0,12600,11400,24000
"AL","1982-08-03",1982,8,215,3450,12700,11400,27550
"AL","1982-08-04",1982,8,216,0,12200,11400,23600
"AL","1982-08-05",1982,8,217,1450,12100,11400,24950
"AL","1982-08-06",1982,8,218,0,11700,11400,23100
"AL","1982-08-07",1982,8,219,0,11600,11400,23000
"AL","1982-08-08",1982,8,220,1580,11500,11400,24480
"AL","1982-08-09",1982,8,221,0,11500,11300,22800
"AL","1982-08-10",1982,8,222,2760,11900,11300,25960
"AL","1982-08-11",1982,8,223,483,11600,11200,23283
"AL","1982-08-12",1982,8,224,0,11500,11200,22700
"AL","1982-08-13",1982,8,225,0,11500,11200,22700
"AL","1982-08-14",1982,8,226,0,11300,11200,22500
"AL","1982-08-15",1982,8,227,0,11200,11200,22400
"AL","1982-08-16",1982,8,228,0,11100,11100,22200
"AL","1982-08-17",1982,8,229,0,11100,11100,22200
"AL","1982-08-18",1982,8,230,0,11000,11200,22200
"AL","1982-08-19",1982,8,231,0,11000,11200,22200
"AL","1982-08-20",1982,8,232,3820,11300,11000,26120
"AL","1982-08-21",1982,8,233,242,11100,11000,22342
"AL","1982-08-22",1982,8,234,0,10900,11000,21900
"AL","1982-08-23",1982,8,235,0,11000,10900,21900
"AL","1982-08-24",1982,8,236,19600,12000,10700,42300
"AL","1982-08-25",1982,8,237,1730,12000,10600,24330
"AL","1982-08-26",1982,8,238,12300,13600,10500,36400
"AL","1982-08-27",1982,8,239,34600,16900,11200,62700
"AL","1982-08-28",1982,8,240,52100,27900,28200,108200
"AL","1982-08-29",1982,8,241,0,14300,11400,25700
"AL","1982-08-30",1982,8,242,20000,16300,16600,52900
"AL","1982-08-31",1982,8,243,9860,17400,13900,41160
"AL","1982-09-01",1982,9,244,877,14200,10900,25977
"AL","1982-09-02",1982,9,245,4670,14400,11100,30170
"AL","1982-09-03",1982,9,246,10400,16100,12500,39000
"AL","1982-09-04",1982,9,247,0,13800,11100,24900
"AL","1982-09-05",1982,9,248,0,13400,11100,24500
"AL","1982-09-06",1982,9,249,37000,15400,20300,72700
"AL","1982-09-07",1982,9,250,21000,22200,19900,63100
"AL","1982-09-08",1982,9,251,0,14600,11400,26000
"AL","1982-09-09",1982,9,252,0,14100,11600,25700
"AL","1982-09-10",1982,9,253,0,13600,11600,25200
"AL","1982-09-11",1982,9,254,1980,13200,11500,26680
"AL","1982-09-12",1982,9,255,6790,14000,11500,32290
"AL","1982-09-13",1982,9,256,0,13100,11400,24500
"AL","1982-09-14",1982,9,257,24000,17100,12700,53800
"AL","1982-09-15",1982,9,258,8380,14900,12300,35580
"AL","1982-09-16",1982,9,259,14100,16600,15500,46200
"AL","1982-09-17",1982,9,260,3010,14600,11800,29410
"AL","1982-09-18",1982,9,261,10800,16100,14800,41700
"AL","1982-09-19",1982,9,262,7600,15800,13700,37100
"AL","1982-09-20",1982,9,263,1760,13800,11600,27160
"AL","1982-09-21",1982,9,264,8330,14800,13200,36330
"AL","1982-09-22",1982,9,265,2560,14100,11700,28360
"AL","1982-09-23",1982,9,266,0,13500,11600,25100
"AL","1982-09-24",1982,9,267,2200,13300,11600,27100
"AL","1982-09-25",1982,9,268,21600,18800,18000,58400
"AL","1982-09-26",1982,9,269,825,14400,12400,27625
"AL","1982-09-27",1982,9,270,0,13700,11600,25300
"AL","1982-09-28",1982,9,271,0,13300,11600,24900
"AL","1982-09-29",1982,9,272,0,13200,11600,24800
"AL","1982-09-30",1982,9,273,8300,13000,11500,32800
"AL","1982-10-01",1982,10,274,10900,15900,14700,41500
"AL","1982-10-02",1982,10,275,0,13700,11700,25400
"AL","1982-10-03",1982,10,276,4540,13600,11500,29640
"AL","1982-10-04",1982,10,277,18100,19600,17300,55000
"AL","1982-10-05",1982,10,278,0,14100,12100,26200
"AL","1982-10-06",1982,10,279,0,13700,11500,25200
"AL","1982-10-07",1982,10,280,21400,18400,17600,57400
"AL","1982-10-08",1982,10,281,24600,20600,23200,68400
"AL","1982-10-09",1982,10,282,553,15100,13300,28953
"AL","1982-10-10",1982,10,283,7640,14400,13700,35740
"AL","1982-10-11",1982,10,284,21300,22200,22000,65500
"AL","1982-10-12",1982,10,285,2030,15800,13800,31630
"AL","1982-10-13",1982,10,286,2280,15200,12300,29780
"AL","1982-10-14",1982,10,287,2010,14600,12300,28910
"AL","1982-10-15",1982,10,288,1420,14700,12200,28320
"AL","1982-10-16",1982,10,289,2950,14400,12200,29550
"AL","1982-10-17",1982,10,290,0,14100,12100,26200
"AL","1982-10-18",1982,10,291,4450,14300,12100,30850
"AL","1982-10-19",1982,10,292,3270,14800,12200,30270
"AL","1982-10-20",1982,10,293,4840,14000,12300,31140
"AL","1982-10-21",1982,10,294,74400,37500,42100,154000
"AL","1982-10-22",1982,10,295,11000,17100,17200,45300
"AL","1982-10-23",1982,10,296,0,15800,13600,29400
"AL","1982-10-24",1982,10,297,0,15800,14800,30600
"AL","1982-10-25",1982,10,298,0,18400,15400,33800
"AL","1982-10-26",1982,10,299,0,15700,13100,28800
"AL","1982-10-27",1982,10,300,0,15400,12900,28300
"AL","1982-10-28",1982,10,301,0,15300,12800,28100
"AL","1982-10-29",1982,10,302,553,15100,12700,28353
"AL","1982-10-30",1982,10,303,8780,16200,12800,37780
"AL","1982-10-31",1982,10,304,922,15200,12900,29022
"AL","1982-11-01",1982,11,305,0,14800,12600,27400
"AL","1982-11-02",1982,11,306,1380,14900,12600,28880
"AL","1982-11-03",1982,11,307,1300,14700,12500,28500
"AL","1982-11-04",1982,11,308,2420,14700,12400,29520
"AL","1982-11-05",1982,11,309,16400,14800,12100,43300
"AL","1982-11-06",1982,11,310,8840,14700,12000,35540
"AL","1982-11-07",1982,11,311,0,14600,12200,26800
"AL","1982-11-08",1982,11,312,0,14500,12300,26800
"AL","1982-11-09",1982,11,313,0,15100,13600,28700
"AL","1982-11-10",1982,11,314,0,14700,13200,27900
"AL","1982-11-11",1982,11,315,8760,14700,13000,36460
"AL","1982-11-12",1982,11,316,3540,18000,14500,36040
"AL","1982-11-13",1982,11,317,55000,75400,24000,154400
"AL","1982-11-14",1982,11,318,918,16700,11900,29518
"AL","1982-11-15",1982,11,319,6800,16200,12400,35400
"AL","1982-11-16",1982,11,320,0,16000,12700,28700
"AL","1982-11-17",1982,11,321,0,15800,12900,28700
"AL","1982-11-18",1982,11,322,0,15600,12900,28500
"AL","1982-11-19",1982,11,323,0,15500,13000,28500
"AL","1982-11-20",1982,11,324,2540,18700,18500,39740
"AL","1982-11-21",1982,11,325,7130,16000,47900,71030
"AL","1982-11-22",1982,11,326,7890,18000,19400,45290
"AL","1982-11-23",1982,11,327,716,15700,14600,31016
"AL","1982-11-24",1982,11,328,3690,15400,14200,33290
"AL","1982-11-25",1982,11,329,0,15200,13800,29000
"AL","1982-11-26",1982,11,330,0,15200,13900,29100
"AL","1982-11-27",1982,11,331,0,15200,13800,29000
"AL","1982-11-28",1982,11,332,0,15100,13700,28800
"AL","1982-11-29",1982,11,333,0,15000,13700,28700
"AL","1982-11-30",1982,11,334,0,15000,13500,28500
"AL","1982-12-01",1982,12,335,0,14900,13400,28300
"AL","1982-12-02",1982,12,336,1120,14900,13300,29320
"AL","1982-12-03",1982,12,337,2530,14900,13600,31030
"AL","1982-12-04",1982,12,338,2190,15200,13700,31090
"AL","1982-12-05",1982,12,339,0,14800,13300,28100
"AL","1982-12-06",1982,12,340,281,14700,13300,28281
"AL","1982-12-07",1982,12,341,9280,14700,13100,37080
"AL","1982-12-08",1982,12,342,0,14700,13200,27900
"AL","1982-12-09",1982,12,343,0,14700,13200,27900
"AL","1982-12-10",1982,12,344,0,14700,13200,27900
"AL","1982-12-11",1982,12,345,4680,14600,13100,32380
"AL","1982-12-12",1982,12,346,0,14600,13100,27700
"AL","1982-12-13",1982,12,347,0,14600,13100,27700
"AL","1982-12-14",1982,12,348,0,14500,13100,27600
"AL","1982-12-15",1982,12,349,187,14500,13100,27787
"AL","1982-12-16",1982,12,350,0,14500,13100,27600
"AL","1982-12-17",1982,12,351,0,14500,13100,27600
"AL","1982-12-18",1982,12,352,0,14500,13000,27500
"AL","1982-12-19",1982,12,353,6300,14400,12900,33600
"AL","1982-12-20",1982,12,354,10100,14400,12700,37200
"AL","1982-12-21",1982,12,355,438,14400,12800,27638
"AL","1982-12-22",1982,12,356,0,14400,12900,27300
"AL","1982-12-23",1982,12,357,0,14400,12900,27300
"AL","1982-12-24",1982,12,358,0,14300,12900,27200
"AL","1982-12-25",1982,12,359,7690,14400,14000,36090
"AL","1982-12-26",1982,12,360,37700,23800,30800,92300
"AL","1982-12-27",1982,12,361,1550,15700,14500,31750
"AL","1982-12-28",1982,12,362,0,15300,13500,28800
"AL","1982-12-29",1982,12,363,20400,15300,13100,48800
"AL","1982-12-30",1982,12,364,386,15200,13200,28786
"AL","1982-12-31",1982,12,365,0,15100,13300,28400
"AL","1983-01-01",1983,1,1,538,15000,13300,28838
"AL","1983-01-02",1983,1,2,0,14900,13300,28200
"AL","1983-01-03",1983,1,3,0,14800,13300,28100
"AL","1983-01-04",1983,1,4,0,14700,13300,28000
"AL","1983-01-05",1983,1,5,0,14600,13300,27900
"AL","1983-01-06",1983,1,6,0,14600,13200,27800
"AL","1983-01-07",1983,1,7,6710,14500,13100,34310
"AL","1983-01-08",1983,1,8,22200,14500,12800,49500
"AL","1983-01-09",1983,1,9,0,14400,12900,27300
"AL","1983-01-10",1983,1,10,0,14400,13000,27400
"AL","1983-01-11",1983,1,11,10900,14300,12800,38000
"AL","1983-01-12",1983,1,12,8090,14300,12800,35190
"AL","1983-01-13",1983,1,13,0,14200,12900,27100
"AL","1983-01-14",1983,1,14,0,14200,12900,27100
"AL","1983-01-15",1983,1,15,11700,14200,12800,38700
"AL","1983-01-16",1983,1,16,3050,14200,12800,30050
"AL","1983-01-17",1983,1,17,0,14100,12800,26900
"AL","1983-01-18",1983,1,18,0,14100,12800,26900
"AL","1983-01-19",1983,1,19,0,14100,12800,26900
"AL","1983-01-20",1983,1,20,0,14000,12800,26800
"AL","1983-01-21",1983,1,21,0,14000,12800,26800
"AL","1983-01-22",1983,1,22,0,14000,12800,26800
"AL","1983-01-23",1983,1,23,0,13900,12800,26700
"AL","1983-01-24",1983,1,24,0,13900,12700,26600
"AL","1983-01-25",1983,1,25,215,13900,12700,26815
"AL","1983-01-26",1983,1,26,0,13800,12700,26500
"AL","1983-01-27",1983,1,27,0,13800,12700,26500
"AL","1983-01-28",1983,1,28,0,13800,12600,26400
"AL","1983-01-29",1983,1,29,0,13700,12600,26300
"AL","1983-01-30",1983,1,30,5390,13700,12500,31590
"AL","1983-01-31",1983,1,31,17600,13700,12200,43500
"AL","1983-02-01",1983,2,32,936,13700,12300,26936
"AL","1983-02-02",1983,2,33,0,13600,12400,26000
"AL","1983-02-03",1983,2,34,1500,13600,12400,27500
"AL","1983-02-04",1983,2,35,12500,13600,12200,38300
"AL","1983-02-05",1983,2,36,0,13500,12300,25800
"AL","1983-02-06",1983,2,37,0,13500,12400,25900
"AL","1983-02-07",1983,2,38,0,13500,12400,25900
"AL","1983-02-08",1983,2,39,0,13500,12400,25900
"AL","1983-02-09",1983,2,40,0,13400,12300,25700
"AL","1983-02-10",1983,2,41,0,13400,12400,25800
"AL","1983-02-11",1983,2,42,0,13400,12300,25700
"AL","1983-02-12",1983,2,43,258,13300,12300,25858
"AL","1983-02-13",1983,2,44,0,13300,12300,25600
"AL","1983-02-14",1983,2,45,0,13300,12300,25600
"AL","1983-02-15",1983,2,46,0,13300,12200,25500
"AL","1983-02-16",1983,2,47,0,13200,12200,25400
"AL","1983-02-17",1983,2,48,0,13200,12200,25400
"AL","1983-02-18",1983,2,49,0,13200,12200,25400
"AL","1983-02-19",1983,2,50,0,13200,12200,25400
"AL","1983-02-20",1983,2,51,517,13100,12200,25817
"AL","1983-02-21",1983,2,52,0,13100,12200,25300
"AL","1983-02-22",1983,2,53,0,13100,12100,25200
"AL","1983-02-23",1983,2,54,0,13100,12100,25200
"AL","1983-02-24",1983,2,55,0,13000,12100,25100
"AL","1983-02-25",1983,2,56,129,13000,12100,25229
"AL","1983-02-26",1983,2,57,446,13000,12000,25446
"AL","1983-02-27",1983,2,58,0,13000,12000,25000
"AL","1983-02-28",1983,2,59,0,12900,12000,24900
"AL","1983-03-01",1983,3,60,2920,12900,12000,27820
"AL","1983-03-02",1983,3,61,4300,13200,12100,29600
"AL","1983-03-03",1983,3,62,3740,14500,17800,36040
"AL","1983-03-04",1983,3,63,7120,16500,19500,43120
"AL","1983-03-05",1983,3,64,6210,19900,25800,51910
"AL","1983-03-06",1983,3,65,663,22000,27900,50563
"AL","1983-03-07",1983,3,66,1160,21900,28800,51860
"AL","1983-03-08",1983,3,67,2910,24600,28700,56210
"AL","1983-03-09",1983,3,68,465,18800,14500,33765
"AL","1983-03-10",1983,3,69,21300,16000,13500,50800
"AL","1983-03-11",1983,3,70,2820,15800,13700,32320
"AL","1983-03-12",1983,3,71,0,15600,13900,29500
"AL","1983-03-13",1983,3,72,0,15300,13900,29200
"AL","1983-03-14",1983,3,73,0,15100,13900,29000
"AL","1983-03-15",1983,3,74,0,15000,14600,29600
"AL","1983-03-16",1983,3,75,0,14800,13800,28600
"AL","1983-03-17",1983,3,76,8470,14700,13500,36670
"AL","1983-03-18",1983,3,77,1380,15200,15000,31580
"AL","1983-03-19",1983,3,78,20200,15200,14500,49900
"AL","1983-03-20",1983,3,79,7110,14600,13200,34910
"AL","1983-03-21",1983,3,80,0,14400,13300,27700
"AL","1983-03-22",1983,3,81,0,14300,13300,27600
"AL","1983-03-23",1983,3,82,0,14200,13300,27500
"AL","1983-03-24",1983,3,83,0,14100,13200,27300
"AL","1983-03-25",1983,3,84,0,14100,13200,27300
"AL","1983-03-26",1983,3,85,0,14000,13200,27200
"AL","1983-03-27",1983,3,86,0,13900,13200,27100
"AL","1983-03-28",1983,3,87,5670,13900,13900,33470
"AL","1983-03-29",1983,3,88,0,13800,13200,27000
"AL","1983-03-30",1983,3,89,0,13700,13100,26800
"AL","1983-03-31",1983,3,90,3100,13700,15400,32200
"AL","1983-04-01",1983,4,91,2980,13600,16500,33080
"AL","1983-04-02",1983,4,92,7520,18200,19600,45320
"AL","1983-04-03",1983,4,93,0,16300,13600,29900
"AL","1983-04-04",1983,4,94,0,18800,13900,32700
"AL","1983-04-05",1983,4,95,1020,15100,12900,29020
"AL","1983-04-06",1983,4,96,0,14400,12700,27100
"AL","1983-04-07",1983,4,97,4960,14300,13000,32260
"AL","1983-04-08",1983,4,98,2820,14700,12900,30420
"AL","1983-04-09",1983,4,99,512,14100,12700,27312
"AL","1983-04-10",1983,4,100,0,13800,12700,26500
"AL","1983-04-11",1983,4,101,21600,15100,14100,50800
"AL","1983-04-12",1983,4,102,1790,17200,17200,36190
"AL","1983-04-13",1983,4,103,0,14100,12800,26900
"AL","1983-04-14",1983,4,104,10800,16500,16200,43500
"AL","1983-04-15",1983,4,105,12000,17300,17100,46400
"AL","1983-04-16",1983,4,106,21100,14500,12500,48100
"AL","1983-04-17",1983,4,107,0,14300,12800,27100
"AL","1983-04-18",1983,4,108,0,14200,13100,27300
"AL","1983-04-19",1983,4,109,0,14100,13100,27200
"AL","1983-04-20",1983,4,110,0,14000,13100,27100
"AL","1983-04-21",1983,4,111,0,14400,15400,29800
"AL","1983-04-22",1983,4,112,0,16700,17000,33700
"AL","1983-04-23",1983,4,113,0,14400,13100,27500
"AL","1983-04-24",1983,4,114,0,13900,12800,26700
"AL","1983-04-25",1983,4,115,0,13900,12700,26600
"AL","1983-04-26",1983,4,116,0,13800,12700,26500
"AL","1983-04-27",1983,4,117,0,13700,12500,26200
"AL","1983-04-28",1983,4,118,0,13700,12500,26200
"AL","1983-04-29",1983,4,119,0,13600,12500,26100
"AL","1983-04-30",1983,4,120,5900,14200,12600,32700
"AL","1983-05-01",1983,5,121,0,13500,12400,25900
"AL","1983-05-02",1983,5,122,0,13500,12500,26000
"AL","1983-05-03",1983,5,123,25500,19100,17700,62300
"AL","1983-05-04",1983,5,124,2190,14300,12500,28990
"AL","1983-05-05",1983,5,125,169,13900,12400,26469
"AL","1983-05-06",1983,5,126,0,13800,12400,26200
"AL","1983-05-07",1983,5,127,0,13800,12400,26200
"AL","1983-05-08",1983,5,128,76300,36600,40700,153600
"AL","1983-05-09",1983,5,129,21100,20700,23000,64800
"AL","1983-05-10",1983,5,130,0,15700,13600,29300
"AL","1983-05-11",1983,5,131,0,15500,13500,29000
"AL","1983-05-12",1983,5,132,0,14700,13500,28200
"AL","1983-05-13",1983,5,133,0,14000,13400,27400
"AL","1983-05-14",1983,5,134,28000,17200,14300,59500
"AL","1983-05-15",1983,5,135,2400,15000,13200,30600
"AL","1983-05-16",1983,5,136,0,14300,13300,27600
"AL","1983-05-17",1983,5,137,0,14200,13300,27500
"AL","1983-05-18",1983,5,138,0,13900,13200,27100
"AL","1983-05-19",1983,5,139,0,13800,13200,27000
"AL","1983-05-20",1983,5,140,3180,13500,13000,29680
"AL","1983-05-21",1983,5,141,1220,13400,12900,27520
"AL","1983-05-22",1983,5,142,11000,14600,12900,38500
"AL","1983-05-23",1983,5,143,15300,16200,13600,45100
"AL","1983-05-24",1983,5,144,39800,22800,24100,86700
"AL","1983-05-25",1983,5,145,2800,15300,13700,31800
"AL","1983-05-26",1983,5,146,2160,14700,13100,29960
"AL","1983-05-27",1983,5,147,0,13800,13000,26800
"AL","1983-05-28",1983,5,148,0,13800,13000,26800
"AL","1983-05-29",1983,5,149,0,13500,12900,26400
"AL","1983-05-30",1983,5,150,37100,20200,18800,76100
"AL","1983-05-31",1983,5,151,18700,19500,19400,57600
"AL","1983-06-01",1983,6,152,8550,16700,15700,40950
"AL","1983-06-02",1983,6,153,0,15000,13200,28200
"AL","1983-06-03",1983,6,154,5200,15400,13400,34000
"AL","1983-06-04",1983,6,155,17400,14500,17000,48900
"AL","1983-06-05",1983,6,156,34800,27700,27200,89700
"AL","1983-06-06",1983,6,157,1770,16000,13800,31570
"AL","1983-06-07",1983,6,158,0,15000,13600,28600
"AL","1983-06-08",1983,6,159,0,14800,13600,28400
"AL","1983-06-09",1983,6,160,0,14200,13500,27700
"AL","1983-06-10",1983,6,161,2830,14200,13400,30430
"AL","1983-06-11",1983,6,162,0,13700,13300,27000
"AL","1983-06-12",1983,6,163,0,13300,13100,26400
"AL","1983-06-13",1983,6,164,4050,13100,13000,30150
"AL","1983-06-14",1983,6,165,0,13000,12900,25900
"AL","1983-06-15",1983,6,166,1290,12900,12800,26990
"AL","1983-06-16",1983,6,167,14900,13000,12700,40600
"AL","1983-06-17",1983,6,168,16800,15800,12700,45300
"AL","1983-06-18",1983,6,169,4880,14800,12600,32280
"AL","1983-06-19",1983,6,170,0,13900,12700,26600
"AL","1983-06-20",1983,6,171,0,13600,12700,26300
"AL","1983-06-21",1983,6,172,0,13200,12600,25800
"AL","1983-06-22",1983,6,173,3680,12900,12500,29080
"AL","1983-06-23",1983,6,174,54100,22500,14800,91400
"AL","1983-06-24",1983,6,175,0,14400,12400,26800
"AL","1983-06-25",1983,6,176,0,14100,12700,26800
"AL","1983-06-26",1983,6,177,0,13700,12600,26300
"AL","1983-06-27",1983,6,178,0,13300,12600,25900
"AL","1983-06-28",1983,6,179,368,13100,12500,25968
"AL","1983-06-29",1983,6,180,0,13000,12400,25400
"AL","1983-06-30",1983,6,181,0,12900,12300,25200
"AL","1983-07-01",1983,7,182,2530,12900,12300,27730
"AL","1983-07-02",1983,7,183,2890,13400,12300,28590
"AL","1983-07-03",1983,7,184,0,12800,12300,25100
"AL","1983-07-04",1983,7,185,50600,15300,13400,79300
"AL","1983-07-05",1983,7,186,35700,23000,19800,78500
"AL","1983-07-06",1983,7,187,803,14600,12500,27903
"AL","1983-07-07",1983,7,188,0,14200,12700,26900
"AL","1983-07-08",1983,7,189,0,14100,12800,26900
"AL","1983-07-09",1983,7,190,0,13700,12700,26400
"AL","1983-07-10",1983,7,191,0,13200,12600,25800
"AL","1983-07-11",1983,7,192,0,13100,12500,25600
"AL","1983-07-12",1983,7,193,0,13000,12500,25500
"AL","1983-07-13",1983,7,194,0,12900,12500,25400
"AL","1983-07-14",1983,7,195,0,12800,12400,25200
"AL","1983-07-15",1983,7,196,0,12700,12400,25100
"AL","1983-07-16",1983,7,197,0,12600,12400,25000
"AL","1983-07-17",1983,7,198,0,12500,12300,24800
"AL","1983-07-18",1983,7,199,467,12500,12300,25267
"AL","1983-07-19",1983,7,200,7180,13300,12200,32680
"AL","1983-07-20",1983,7,201,0,12500,12100,24600
"AL","1983-07-21",1983,7,202,3230,12600,12100,27930
"AL","1983-07-22",1983,7,203,10800,12800,12000,35600
"AL","1983-07-23",1983,7,204,643,12300,11900,24843
"AL","1983-07-24",1983,7,205,0,12200,12000,24200
"AL","1983-07-25",1983,7,206,0,12200,12000,24200
"AL","1983-07-26",1983,7,207,0,12100,12000,24100
"AL","1983-07-27",1983,7,208,0,12100,12000,24100
"AL","1983-07-28",1983,7,209,0,12000,11900,23900
"AL","1983-07-29",1983,7,210,14700,13200,11800,39700
"AL","1983-07-30",1983,7,211,0,12300,11700,24000
"AL","1983-07-31",1983,7,212,2680,12000,11800,26480
"AL","1983-08-01",1983,8,213,2770,12400,11700,26870
"AL","1983-08-02",1983,8,214,1450,12200,11700,25350
"AL","1983-08-03",1983,8,215,0,11900,11700,23600
"AL","1983-08-04",1983,8,216,72000,24200,16800,113000
"AL","1983-08-05",1983,8,217,967,14300,11200,26467
"AL","1983-08-06",1983,8,218,0,13700,11600,25300
"AL","1983-08-07",1983,8,219,0,13600,11700,25300
"AL","1983-08-08",1983,8,220,0,13200,11900,25100
"AL","1983-08-09",1983,8,221,0,12600,11800,24400
"AL","1983-08-10",1983,8,222,0,12500,11700,24200
"AL","1983-08-11",1983,8,223,107000,33400,36200,176600
"AL","1983-08-12",1983,8,224,48000,38700,35600,122300
"AL","1983-08-13",1983,8,225,0,18200,14900,33100
"AL","1983-08-14",1983,8,226,0,16300,13100,29400
"AL","1983-08-15",1983,8,227,0,15800,13200,29000
"AL","1983-08-16",1983,8,228,0,15600,13100,28700
"AL","1983-08-17",1983,8,229,0,15200,13000,28200
"AL","1983-08-18",1983,8,230,8750,15400,12900,37050
"AL","1983-08-19",1983,8,231,0,14700,12800,27500
"AL","1983-08-20",1983,8,232,0,14400,12700,27100
"AL","1983-08-21",1983,8,233,242,14300,12600,27142
"AL","1983-08-22",1983,8,234,10500,14500,12500,37500
"AL","1983-08-23",1983,8,235,8220,15700,12400,36320
"AL","1983-08-24",1983,8,236,0,14500,12300,26800
"AL","1983-08-25",1983,8,237,0,14200,12300,26500
"AL","1983-08-26",1983,8,238,877,13900,12300,27077
"AL","1983-08-27",1983,8,239,0,13600,12300,25900
"AL","1983-08-28",1983,8,240,0,13300,12200,25500
"AL","1983-08-29",1983,8,241,0,13100,12200,25300
"AL","1983-08-30",1983,8,242,0,12900,12200,25100
"AL","1983-08-31",1983,8,243,10700,13900,12100,36700
"AL","1983-09-01",1983,9,244,160,13100,12000,25260
"AL","1983-09-02",1983,9,245,0,12900,12000,24900
"AL","1983-09-03",1983,9,246,0,12900,12100,25000
"AL","1983-09-04",1983,9,247,0,12700,12100,24800
"AL","1983-09-05",1983,9,248,2770,12500,12000,27270
"AL","1983-09-06",1983,9,249,17800,13100,12000,42900
"AL","1983-09-07",1983,9,250,30100,19200,12600,61900
"AL","1983-09-08",1983,9,251,5870,15000,11800,32670
"AL","1983-09-09",1983,9,252,0,14100,11900,26000
"AL","1983-09-10",1983,9,253,2460,13900,12000,28360
"AL","1983-09-11",1983,9,254,29900,14800,14300,59000
"AL","1983-09-12",1983,9,255,8470,15400,12900,36770
"AL","1983-09-13",1983,9,256,10900,15400,14400,40700
"AL","1983-09-14",1983,9,257,3740,14800,12200,30740
"AL","1983-09-15",1983,9,258,1470,14300,12100,27870
"AL","1983-09-16",1983,9,259,4390,13900,12200,30490
"AL","1983-09-17",1983,9,260,30600,20800,22900,74300
"AL","1983-09-18",1983,9,261,454,14800,12600,27854
"AL","1983-09-19",1983,9,262,9100,17800,14300,41200
"AL","1983-09-20",1983,9,263,6190,14600,13200,33990
"AL","1983-09-21",1983,9,264,87800,52400,52800,193000
"AL","1983-09-22",1983,9,265,756,20900,22100,43756
"AL","1983-09-23",1983,9,266,0,17400,14300,31700
"AL","1983-09-24",1983,9,267,3390,17000,13800,34190
"AL","1983-09-25",1983,9,268,0,16500,13600,30100
"AL","1983-09-26",1983,9,269,0,16400,13700,30100
"AL","1983-09-27",1983,9,270,0,16000,13600,29600
"AL","1983-09-28",1983,9,271,0,15500,13500,29000
"AL","1983-09-29",1983,9,272,0,15100,13300,28400
"AL","1983-09-30",1983,9,273,3300,14900,13200,31400
"AL","1983-10-01",1983,10,274,1770,14700,13100,29570
"AL","1983-10-02",1983,10,275,0,14500,13000,27500
"AL","1983-10-03",1983,10,276,5360,14600,12800,32760
"AL","1983-10-04",1983,10,277,8700,16000,12700,37400
"AL","1983-10-05",1983,10,278,3590,15800,12800,32190
"AL","1983-10-06",1983,10,279,2300,15100,12800,30200
"AL","1983-10-07",1983,10,280,1830,15000,12700,29530
"AL","1983-10-08",1983,10,281,14300,15400,13400,43100
"AL","1983-10-09",1983,10,282,34500,27300,23900,85700
"AL","1983-10-10",1983,10,283,0,16400,13900,30300
"AL","1983-10-11",1983,10,284,0,15800,13000,28800
"AL","1983-10-12",1983,10,285,26500,20300,22100,68900
"AL","1983-10-13",1983,10,286,47500,35900,36400,119800
"AL","1983-10-14",1983,10,287,9280,20400,18700,48380
"AL","1983-10-15",1983,10,288,6040,20500,18400,44940
"AL","1983-10-16",1983,10,289,4210,20200,16800,41210
"AL","1983-10-17",1983,10,290,8980,21200,17700,47880
"AL","1983-10-18",1983,10,291,151,18100,15000,33251
"AL","1983-10-19",1983,10,292,804,17400,14500,32704
"AL","1983-10-20",1983,10,293,2930,17400,14600,34930
"AL","1983-10-21",1983,10,294,302,17100,14300,31702
"AL","1983-10-22",1983,10,295,0,16900,14200,31100
"AL","1983-10-23",1983,10,296,0,16800,14100,30900
"AL","1983-10-24",1983,10,297,0,16600,13900,30500
"AL","1983-10-25",1983,10,298,0,16500,13800,30300
"AL","1983-10-26",1983,10,299,0,16500,13700,30200
"AL","1983-10-27",1983,10,300,134,16400,13700,30234
"AL","1983-10-28",1983,10,301,0,16300,13700,30000
"AL","1983-10-29",1983,10,302,0,16200,13600,29800
"AL","1983-10-30",1983,10,303,0,16200,13600,29800
"AL","1983-10-31",1983,10,304,0,16100,13500,29600
"AL","1983-11-01",1983,11,305,0,16100,13500,29600
"AL","1983-11-02",1983,11,306,0,16000,13500,29500
"AL","1983-11-03",1983,11,307,407,16000,13500,29907
"AL","1983-11-04",1983,11,308,0,15900,13400,29300
"AL","1983-11-05",1983,11,309,0,15900,13400,29300
"AL","1983-11-06",1983,11,310,0,15800,13400,29200
"AL","1983-11-07",1983,11,311,0,15800,13400,29200
"AL","1983-11-08",1983,11,312,0,15800,13400,29200
"AL","1983-11-09",1983,11,313,128,15800,13400,29328
"AL","1983-11-10",1983,11,314,18100,17300,14500,49900
"AL","1983-11-11",1983,11,315,17400,16400,13600,47400
"AL","1983-11-12",1983,11,316,500,16000,13500,30000
"AL","1983-11-13",1983,11,317,0,15900,13600,29500
"AL","1983-11-14",1983,11,318,1830,15900,13700,31430
"AL","1983-11-15",1983,11,319,4590,15900,13700,34190
"AL","1983-11-16",1983,11,320,7970,15800,13500,37270
"AL","1983-11-17",1983,11,321,2630,16200,14000,32830
"AL","1983-11-18",1983,11,322,0,15900,13700,29600
"AL","1983-11-19",1983,11,323,1500,15800,13700,31000
"AL","1983-11-20",1983,11,324,3490,16900,16000,36390
"AL","1983-11-21",1983,11,325,22200,31100,33700,87000
"AL","1983-11-22",1983,11,326,5510,20600,18400,44510
"AL","1983-11-23",1983,11,327,0,17500,15000,32500
"AL","1983-11-24",1983,11,328,56100,17800,15900,89800
"AL","1983-11-25",1983,11,329,22400,19000,18100,59500
"AL","1983-11-26",1983,11,330,1150,17400,14500,33050
"AL","1983-11-27",1983,11,331,0,17100,14400,31500
"AL","1983-11-28",1983,11,332,0,16900,14500,31400
"AL","1983-11-29",1983,11,333,19100,16800,14200,50100
"AL","1983-11-30",1983,11,334,11500,16600,14100,42200
"AL","1983-12-01",1983,12,335,3900,16500,14300,34700
"AL","1983-12-02",1983,12,336,773,16400,14400,31573
"AL","1983-12-03",1983,12,337,0,16300,14400,30700
"AL","1983-12-04",1983,12,338,0,16300,14400,30700
"AL","1983-12-05",1983,12,339,0,16200,14400,30600
"AL","1983-12-06",1983,12,340,0,16200,14400,30600
"AL","1983-12-07",1983,12,341,0,16100,14300,30400
"AL","1983-12-08",1983,12,342,316,16100,14200,30616
"AL","1983-12-09",1983,12,343,0,16000,14200,30200
"AL","1983-12-10",1983,12,344,0,15900,14200,30100
"AL","1983-12-11",1983,12,345,784,15900,14100,30784
"AL","1983-12-12",1983,12,346,5910,15800,14000,35710
"AL","1983-12-13",1983,12,347,6200,15800,13900,35900
"AL","1983-12-14",1983,12,348,3240,15700,13900,32840
"AL","1983-12-15",1983,12,349,702,15700,13900,30302
"AL","1983-12-16",1983,12,350,11600,15600,13700,40900
"AL","1983-12-17",1983,12,351,925,15600,13700,30225
"AL","1983-12-18",1983,12,352,0,15600,13800,29400
"AL","1983-12-19",1983,12,353,0,15500,13800,29300
"AL","1983-12-20",1983,12,354,0,15500,13800,29300
"AL","1983-12-21",1983,12,355,0,15400,13700,29100
"AL","1983-12-22",1983,12,356,2260,15400,13700,31360
"AL","1983-12-23",1983,12,357,129,15300,13700,29129
"AL","1983-12-24",1983,12,358,0,15300,13700,29000
"AL","1983-12-25",1983,12,359,0,15200,13600,28800
"AL","1983-12-26",1983,12,360,0,15200,13600,28800
"AL","1983-12-27",1983,12,361,819,15200,13600,29619
"AL","1983-12-28",1983,12,362,468,15100,13500,29068
"AL","1983-12-29",1983,12,363,0,15100,13500,28600
"AL","1983-12-30",1983,12,364,0,15100,13500,28600
"AL","1983-12-31",1983,12,365,0,15000,13500,28500
"AL","1984-01-01",1984,1,1,0,15000,13500,28500
"AL","1984-01-02",1984,1,2,0,14900,13400,28300
"AL","1984-01-03",1984,1,3,0,14900,13400,28300
"AL","1984-01-04",1984,1,4,0,14900,13400,28300
"AL","1984-01-05",1984,1,5,0,14800,13400,28200
"AL","1984-01-06",1984,1,6,1270,14800,13300,29370
"AL","1984-01-07",1984,1,7,430,14800,13300,28530
"AL","1984-01-08",1984,1,8,0,14700,13300,28000
"AL","1984-01-09",1984,1,9,215,14700,13200,28115
"AL","1984-01-10",1984,1,10,468,14700,13200,28368
"AL","1984-01-11",1984,1,11,312,14600,13100,28012
"AL","1984-01-12",1984,1,12,0,14600,13100,27700
"AL","1984-01-13",1984,1,13,5700,14600,13000,33300
"AL","1984-01-14",1984,1,14,1520,14500,13000,29020
"AL","1984-01-15",1984,1,15,1150,14500,13000,28650
"AL","1984-01-16",1984,1,16,0,14500,13000,27500
"AL","1984-01-17",1984,1,17,3070,14400,12900,30370
"AL","1984-01-18",1984,1,18,0,14400,12900,27300
"AL","1984-01-19",1984,1,19,0,14400,12900,27300
"AL","1984-01-20",1984,1,20,0,14300,12900,27200
"AL","1984-01-21",1984,1,21,0,14300,12900,27200
"AL","1984-01-22",1984,1,22,0,14300,12900,27200
"AL","1984-01-23",1984,1,23,0,14200,12900,27100
"AL","1984-01-24",1984,1,24,0,14200,12900,27100
"AL","1984-01-25",1984,1,25,215,14200,12800,27215
"AL","1984-01-26",1984,1,26,215,14100,12800,27115
"AL","1984-01-27",1984,1,27,1230,14100,12800,28130
"AL","1984-01-28",1984,1,28,0,14100,12800,26900
"AL","1984-01-29",1984,1,29,3940,14000,12700,30640
"AL","1984-01-30",1984,1,30,645,14000,12700,27345
"AL","1984-01-31",1984,1,31,0,14000,12700,26700
"AL","1984-02-01",1984,2,32,0,13900,12700,26600
"AL","1984-02-02",1984,2,33,0,13900,12600,26500
"AL","1984-02-03",1984,2,34,0,13900,12600,26500
"AL","1984-02-04",1984,2,35,129,13900,12600,26629
"AL","1984-02-05",1984,2,36,5810,13800,12500,32110
"AL","1984-02-06",1984,2,37,927,13800,12500,27227
"AL","1984-02-07",1984,2,38,129,13800,12500,26429
"AL","1984-02-08",1984,2,39,0,13700,12500,26200
"AL","1984-02-09",1984,2,40,0,13700,12500,26200
"AL","1984-02-10",1984,2,41,0,13700,12500,26200
"AL","1984-02-11",1984,2,42,0,13700,12500,26200
"AL","1984-02-12",1984,2,43,0,13600,12400,26000
"AL","1984-02-13",1984,2,44,10900,13600,12300,36800
"AL","1984-02-14",1984,2,45,7400,13600,12200,33200
"AL","1984-02-15",1984,2,46,0,14000,12300,26300
"AL","1984-02-16",1984,2,47,0,14500,13600,28100
"AL","1984-02-17",1984,2,48,0,14900,14800,29700
"AL","1984-02-18",1984,2,49,0,14700,14500,29200
"AL","1984-02-19",1984,2,50,0,14600,14000,28600
"AL","1984-02-20",1984,2,51,11400,14900,14500,40800
"AL","1984-02-21",1984,2,52,0,14000,12400,26400
"AL","1984-02-22",1984,2,53,0,13900,12400,26300
"AL","1984-02-23",1984,2,54,0,13800,12400,26200
"AL","1984-02-24",1984,2,55,0,13700,14500,28200
"AL","1984-02-25",1984,2,56,0,13600,13000,26600
"AL","1984-02-26",1984,2,57,0,13600,12500,26100
"AL","1984-02-27",1984,2,58,0,13500,12400,25900
"AL","1984-02-28",1984,2,59,0,13500,12400,25900
"AL","1984-02-29",1984,2,60,0,13400,12300,25700
"AL","1984-03-01",1984,3,61,504,13400,12300,26204
"AL","1984-03-02",1984,3,62,0,13300,12300,25600
"AL","1984-03-03",1984,3,63,0,13300,12200,25500
"AL","1984-03-04",1984,3,64,0,13300,12200,25500
"AL","1984-03-05",1984,3,65,0,13200,12200,25400
"AL","1984-03-06",1984,3,66,12200,13200,12000,37400
"AL","1984-03-07",1984,3,67,2610,13200,12000,27810
"AL","1984-03-08",1984,3,68,0,13100,12000,25100
"AL","1984-03-09",1984,3,69,0,13100,12000,25100
"AL","1984-03-10",1984,3,70,0,13100,12000,25100
"AL","1984-03-11",1984,3,71,345,13000,12000,25345
"AL","1984-03-12",1984,3,72,1190,13000,12000,26190
"AL","1984-03-13",1984,3,73,0,13000,12000,25000
"AL","1984-03-14",1984,3,74,30100,13000,11500,54600
"AL","1984-03-15",1984,3,75,0,12900,11600,24500
"AL","1984-03-16",1984,3,76,23100,12900,11500,47500
"AL","1984-03-17",1984,3,77,0,12900,11600,24500
"AL","1984-03-18",1984,3,78,0,12900,11800,24700
"AL","1984-03-19",1984,3,79,0,12800,11800,24600
"AL","1984-03-20",1984,3,80,0,12800,11900,24700
"AL","1984-03-21",1984,3,81,5910,12800,11800,30510
"AL","1984-03-22",1984,3,82,9190,12800,11700,33690
"AL","1984-03-23",1984,3,83,6030,12700,11600,30330
"AL","1984-03-24",1984,3,84,0,12700,11700,24400
"AL","1984-03-25",1984,3,85,0,12700,11800,24500
"AL","1984-03-26",1984,3,86,0,12700,11900,24600
"AL","1984-03-27",1984,3,87,0,12700,11800,24500
"AL","1984-03-28",1984,3,88,0,12600,11900,24500
"AL","1984-03-29",1984,3,89,0,12600,11900,24500
"AL","1984-03-30",1984,3,90,0,12600,11900,24500
"AL","1984-03-31",1984,3,91,0,12600,11900,24500
"AL","1984-04-01",1984,4,92,0,12500,11900,24400
"AL","1984-04-02",1984,4,93,0,12500,11800,24300
"AL","1984-04-03",1984,4,94,0,12500,13100,25600
"AL","1984-04-04",1984,4,95,0,13700,16600,30300
"AL","1984-04-05",1984,4,96,0,14600,16700,31300
"AL","1984-04-06",1984,4,97,0,15700,17900,33600
"AL","1984-04-07",1984,4,98,0,15900,17600,33500
"AL","1984-04-08",1984,4,99,0,15600,16900,32500
"AL","1984-04-09",1984,4,100,0,17200,19500,36700
"AL","1984-04-10",1984,4,101,0,18200,21100,39300
"AL","1984-04-11",1984,4,102,0,18700,22000,40700
"AL","1984-04-12",1984,4,103,0,19300,22900,42200
"AL","1984-04-13",1984,4,104,0,20400,23900,44300
"AL","1984-04-14",1984,4,105,5350,23900,18800,48050
"AL","1984-04-15",1984,4,106,6960,17800,15400,40160
"AL","1984-04-16",1984,4,107,0,15400,13500,28900
"AL","1984-04-17",1984,4,108,0,15200,13400,28600
"AL","1984-04-18",1984,4,109,0,14900,13300,28200
"AL","1984-04-19",1984,4,110,0,14700,13100,27800
"AL","1984-04-20",1984,4,111,0,14600,13000,27600
"AL","1984-04-21",1984,4,112,0,14500,12900,27400
"AL","1984-04-22",1984,4,113,0,14300,12900,27200
"AL","1984-04-23",1984,4,114,0,14200,12800,27000
"AL","1984-04-24",1984,4,115,0,14100,12700,26800
"AL","1984-04-25",1984,4,116,0,14000,12700,26700
"AL","1984-04-26",1984,4,117,0,14000,12600,26600
"AL","1984-04-27",1984,4,118,5440,14400,12800,32640
"AL","1984-04-28",1984,4,119,19000,15300,14600,48900
"AL","1984-04-29",1984,4,120,14500,19100,16600,50200
"AL","1984-04-30",1984,4,121,0,14300,12500,26800
"AL","1984-05-01",1984,5,122,94700,22000,22600,139300
"AL","1984-05-02",1984,5,123,8500,16100,14700,39300
"AL","1984-05-03",1984,5,124,0,16800,17300,34100
"AL","1984-05-04",1984,5,125,0,18600,20500,39100
"AL","1984-05-05",1984,5,126,0,20000,23400,43400
"AL","1984-05-06",1984,5,127,1480,22300,21400,45180
"AL","1984-05-07",1984,5,128,4580,16900,15000,36480
"AL","1984-05-08",1984,5,129,28700,21000,24400,74100
"AL","1984-05-09",1984,5,130,1980,16200,14700,32880
"AL","1984-05-10",1984,5,131,12600,18900,18100,49600
"AL","1984-05-11",1984,5,132,0,15600,14200,29800
"AL","1984-05-12",1984,5,133,3560,15400,14300,33260
"AL","1984-05-13",1984,5,134,0,14800,14100,28900
"AL","1984-05-14",1984,5,135,20800,18400,18500,57700
"AL","1984-05-15",1984,5,136,508,15500,14000,30008
"AL","1984-05-16",1984,5,137,0,14800,13900,28700
"AL","1984-05-17",1984,5,138,0,14300,13800,28100
"AL","1984-05-18",1984,5,139,1920,13900,13600,29420
"AL","1984-05-19",1984,5,140,0,13700,13500,27200
"AL","1984-05-20",1984,5,141,0,13600,13400,27000
"AL","1984-05-21",1984,5,142,0,13300,13200,26500
"AL","1984-05-22",1984,5,143,0,13100,13100,26200
"AL","1984-05-23",1984,5,144,30100,15000,13500,58600
"AL","1984-05-24",1984,5,145,0,13700,12900,26600
"AL","1984-05-25",1984,5,146,3070,13500,13000,29570
"AL","1984-05-26",1984,5,147,1270,13400,13000,27670
"AL","1984-05-27",1984,5,148,0,13000,12900,25900
"AL","1984-05-28",1984,5,149,0,13000,12800,25800
"AL","1984-05-29",1984,5,150,0,12900,12800,25700
"AL","1984-05-30",1984,5,151,0,12800,12700,25500
"AL","1984-05-31",1984,5,152,0,12700,12700,25400
"AL","1984-06-01",1984,6,153,0,12600,12600,25200
"AL","1984-06-02",1984,6,154,0,12400,12600,25000
"AL","1984-06-03",1984,6,155,3800,12600,12500,28900
"AL","1984-06-04",1984,6,156,0,12200,12500,24700
"AL","1984-06-05",1984,6,157,5340,12200,12400,29940
"AL","1984-06-06",1984,6,158,18300,14600,12300,45200
"AL","1984-06-07",1984,6,159,1770,13500,12200,27470
"AL","1984-06-08",1984,6,160,19800,14200,12500,46500
"AL","1984-06-09",1984,6,161,47500,22100,16600,86200
"AL","1984-06-10",1984,6,162,0,14500,12400,26900
"AL","1984-06-11",1984,6,163,6760,14400,12800,33960
"AL","1984-06-12",1984,6,164,2760,14100,12800,29660
"AL","1984-06-13",1984,6,165,33500,21200,20600,75300
"AL","1984-06-14",1984,6,166,4930,16400,13200,34530
"AL","1984-06-15",1984,6,167,0,14500,13000,27500
"AL","1984-06-16",1984,6,168,0,14100,13000,27100
"AL","1984-06-17",1984,6,169,0,13700,12900,26600
"AL","1984-06-18",1984,6,170,4670,14000,12800,31470
"AL","1984-06-19",1984,6,171,0,13300,12700,26000
"AL","1984-06-20",1984,6,172,0,13000,12600,25600
"AL","1984-06-21",1984,6,173,0,12900,12500,25400
"AL","1984-06-22",1984,6,174,0,12800,12400,25200
"AL","1984-06-23",1984,6,175,0,12700,12300,25000
"AL","1984-06-24",1984,6,176,0,12600,12300,24900
"AL","1984-06-25",1984,6,177,0,12600,12200,24800
"AL","1984-06-26",1984,6,178,0,12500,12200,24700
"AL","1984-06-27",1984,6,179,3660,12500,12100,28260
"AL","1984-06-28",1984,6,180,38200,16900,12300,67400
"AL","1984-06-29",1984,6,181,0,13600,11800,25400
"AL","1984-06-30",1984,6,182,0,13200,12100,25300
"AL","1984-07-01",1984,7,183,0,13000,12100,25100
"AL","1984-07-02",1984,7,184,0,12700,12100,24800
"AL","1984-07-03",1984,7,185,0,12400,12200,24600
"AL","1984-07-04",1984,7,186,4080,12400,12200,28680
"AL","1984-07-05",1984,7,187,10100,14100,12100,36300
"AL","1984-07-06",1984,7,188,1280,12900,12000,26180
"AL","1984-07-07",1984,7,189,12200,14200,12000,38400
"AL","1984-07-08",1984,7,190,0,13000,11900,24900
"AL","1984-07-09",1984,7,191,0,12700,12100,24800
"AL","1984-07-10",1984,7,192,0,12500,12100,24600
"AL","1984-07-11",1984,7,193,6540,12600,12000,31140
"AL","1984-07-12",1984,7,194,11000,13900,12000,36900
"AL","1984-07-13",1984,7,195,643,12800,12000,25443
"AL","1984-07-14",1984,7,196,817,12200,12000,25017
"AL","1984-07-15",1984,7,197,525,12000,12000,24525
"AL","1984-07-16",1984,7,198,1930,12200,12000,26130
"AL","1984-07-17",1984,7,199,0,11900,12000,23900
"AL","1984-07-18",1984,7,200,16800,14000,11800,42600
"AL","1984-07-19",1984,7,201,4320,13300,11700,29320
"AL","1984-07-20",1984,7,202,0,12600,11800,24400
"AL","1984-07-21",1984,7,203,16800,14700,11800,43300
"AL","1984-07-22",1984,7,204,0,12700,11700,24400
"AL","1984-07-23",1984,7,205,263,12400,11800,24463
"AL","1984-07-24",1984,7,206,161,12000,11800,23961
"AL","1984-07-25",1984,7,207,0,11800,11800,23600
"AL","1984-07-26",1984,7,208,0,11700,11800,23500
"AL","1984-07-27",1984,7,209,0,11600,11800,23400
"AL","1984-07-28",1984,7,210,0,11600,11700,23300
"AL","1984-07-29",1984,7,211,0,11600,11700,23300
"AL","1984-07-30",1984,7,212,0,11500,11700,23200
"AL","1984-07-31",1984,7,213,0,11500,11600,23100
"AL","1984-08-01",1984,8,214,0,11400,11600,23000
"AL","1984-08-02",1984,8,215,23500,12400,11400,47300
"AL","1984-08-03",1984,8,216,14200,12400,11300,37900
"AL","1984-08-04",1984,8,217,24200,17600,11600,53400
"AL","1984-08-05",1984,8,218,0,12800,11200,24000
"AL","1984-08-06",1984,8,219,19700,12500,12000,44200
"AL","1984-08-07",1984,8,220,17300,15100,12700,45100
"AL","1984-08-08",1984,8,221,1050,12800,11500,25350
"AL","1984-08-09",1984,8,222,64800,33200,33700,131700
"AL","1984-08-10",1984,8,223,592,15100,11900,27592
"AL","1984-08-11",1984,8,224,0,14100,11700,25800
"AL","1984-08-12",1984,8,225,0,14000,11800,25800
"AL","1984-08-13",1984,8,226,0,13600,11700,25300
"AL","1984-08-14",1984,8,227,0,13300,11600,24900
"AL","1984-08-15",1984,8,228,10200,13000,11600,34800
"AL","1984-08-16",1984,8,229,25100,17500,12500,55100
"AL","1984-08-17",1984,8,230,967,14000,11500,26467
"AL","1984-08-18",1984,8,231,0,13300,11600,24900
"AL","1984-08-19",1984,8,232,5530,13100,11700,30330
"AL","1984-08-20",1984,8,233,0,12700,11600,24300
"AL","1984-08-21",1984,8,234,0,12600,11600,24200
"AL","1984-08-22",1984,8,235,13200,12800,11700,37700
"AL","1984-08-23",1984,8,236,13900,14400,11800,40100
"AL","1984-08-24",1984,8,237,1210,13300,11500,26010
"AL","1984-08-25",1984,8,238,0,12800,11600,24400
"AL","1984-08-26",1984,8,239,0,12700,11600,24300
"AL","1984-08-27",1984,8,240,0,12400,11600,24000
"AL","1984-08-28",1984,8,241,42200,19000,15200,76400
"AL","1984-08-29",1984,8,242,0,13400,11400,24800
"AL","1984-08-30",1984,8,243,1400,13100,11500,26000
"AL","1984-08-31",1984,8,244,4540,13800,11500,29840
"AL","1984-09-01",1984,9,245,0,12900,11400,24300
"AL","1984-09-02",1984,9,246,3960,12800,11500,28260
"AL","1984-09-03",1984,9,247,59400,27100,27300,113800
"AL","1984-09-04",1984,9,248,9300,19100,15400,43800
"AL","1984-09-05",1984,9,249,6370,15900,12900,35170
"AL","1984-09-06",1984,9,250,2750,15300,12000,30050
"AL","1984-09-07",1984,9,251,0,14500,11900,26400
"AL","1984-09-08",1984,9,252,330,14300,11900,26530
"AL","1984-09-09",1984,9,253,11200,14900,12200,38300
"AL","1984-09-10",1984,9,254,2790,14300,11800,28890
"AL","1984-09-11",1984,9,255,330,13600,11800,25730
"AL","1984-09-12",1984,9,256,0,13400,11800,25200
"AL","1984-09-13",1984,9,257,33400,17300,18300,69000
"AL","1984-09-14",1984,9,258,13600,19900,17200,50700
"AL","1984-09-15",1984,9,259,439,14500,11800,26739
"AL","1984-09-16",1984,9,260,1360,14100,11800,27260
"AL","1984-09-17",1984,9,261,0,13700,11800,25500
"AL","1984-09-18",1984,9,262,0,13500,11800,25300
"AL","1984-09-19",1984,9,263,0,13300,11800,25100
"AL","1984-09-20",1984,9,264,0,13000,11700,24700
"AL","1984-09-21",1984,9,265,0,12800,11700,24500
"AL","1984-09-22",1984,9,266,0,12600,11600,24200
"AL","1984-09-23",1984,9,267,0,12500,11600,24100
"AL","1984-09-24",1984,9,268,4800,12900,11400,29100
"AL","1984-09-25",1984,9,269,46200,19200,18400,83800
"AL","1984-09-26",1984,9,270,18700,20700,20700,60100
"AL","1984-09-27",1984,9,271,1530,15400,13100,30030
"AL","1984-09-28",1984,9,272,0,14600,11900,26500
"AL","1984-09-29",1984,9,273,0,14400,11900,26300
"AL","1984-09-30",1984,9,274,0,14000,11900,25900
"AL","1984-10-01",1984,10,275,0,13800,11800,25600
"AL","1984-10-02",1984,10,276,0,13600,11800,25400
"AL","1984-10-03",1984,10,277,0,13300,11700,25000
"AL","1984-10-04",1984,10,278,0,13000,11600,24600
"AL","1984-10-05",1984,10,279,0,12800,11500,24300
"AL","1984-10-06",1984,10,280,1660,12800,11500,25960
"AL","1984-10-07",1984,10,281,0,12800,11500,24300
"AL","1984-10-08",1984,10,282,11300,13000,11800,36100
"AL","1984-10-09",1984,10,283,9300,15100,12400,36800
"AL","1984-10-10",1984,10,284,553,13700,11700,25953
"AL","1984-10-11",1984,10,285,0,13400,11500,24900
"AL","1984-10-12",1984,10,286,0,13400,11500,24900
"AL","1984-10-13",1984,10,287,2260,13800,11400,27460
"AL","1984-10-14",1984,10,288,0,13300,11300,24600
"AL","1984-10-15",1984,10,289,0,13300,11300,24600
"AL","1984-10-16",1984,10,290,0,13300,11400,24700
"AL","1984-10-17",1984,10,291,6470,14300,11400,32170
"AL","1984-10-18",1984,10,292,24800,19800,17500,62100
"AL","1984-10-19",1984,10,293,402,14200,12200,26802
"AL","1984-10-20",1984,10,294,11100,17100,15000,43200
"AL","1984-10-21",1984,10,295,2550,15400,13000,30950
"AL","1984-10-22",1984,10,296,0,14200,11400,25600
"AL","1984-10-23",1984,10,297,938,14100,11500,26538
"AL","1984-10-24",1984,10,298,0,14000,11400,25400
"AL","1984-10-25",1984,10,299,0,13900,11400,25300
"AL","1984-10-26",1984,10,300,2980,14000,11400,28380
"AL","1984-10-27",1984,10,301,4930,14900,11300,31130
"AL","1984-10-28",1984,10,302,9550,15500,13300,38350
"AL","1984-10-29",1984,10,303,27300,24500,24400,76200
"AL","1984-10-30",1984,10,304,0,15300,12800,28100
"AL","1984-10-31",1984,10,305,5860,15800,13500,35160
"AL","1984-11-01",1984,11,306,4230,15000,13600,32830
"AL","1984-11-02",1984,11,307,23500,16200,14100,53800
"AL","1984-11-03",1984,11,308,0,14800,12000,26800
"AL","1984-11-04",1984,11,309,0,14600,12000,26600
"AL","1984-11-05",1984,11,310,372,16800,18400,35572
"AL","1984-11-06",1984,11,311,0,14500,12200,26700
"AL","1984-11-07",1984,11,312,0,14300,11900,26200
"AL","1984-11-08",1984,11,313,0,14300,11900,26200
"AL","1984-11-09",1984,11,314,1620,14300,11800,27720
"AL","1984-11-10",1984,11,315,0,14000,11700,25700
"AL","1984-11-11",1984,11,316,0,14000,11700,25700
"AL","1984-11-12",1984,11,317,0,13900,11700,25600
"AL","1984-11-13",1984,11,318,0,13900,11700,25600
"AL","1984-11-14",1984,11,319,0,13800,11700,25500
"AL","1984-11-15",1984,11,320,0,13800,11600,25400
"AL","1984-11-16",1984,11,321,957,13800,11600,26357
"AL","1984-11-17",1984,11,322,230,13700,11600,25530
"AL","1984-11-18",1984,11,323,0,13600,11600,25200
"AL","1984-11-19",1984,11,324,0,13600,11600,25200
"AL","1984-11-20",1984,11,325,0,13500,11600,25100
"AL","1984-11-21",1984,11,326,689,13500,11600,25789
"AL","1984-11-22",1984,11,327,0,13500,11600,25100
"AL","1984-11-23",1984,11,328,0,13500,11600,25100
"AL","1984-11-24",1984,11,329,0,13400,11600,25000
"AL","1984-11-25",1984,11,330,0,13400,11600,25000
"AL","1984-11-26",1984,11,331,0,13400,11600,25000
"AL","1984-11-27",1984,11,332,0,13300,11600,24900
"AL","1984-11-28",1984,11,333,6900,14000,11800,32700
"AL","1984-11-29",1984,11,334,8510,15600,12500,36610
"AL","1984-11-30",1984,11,335,230,13700,11600,25530
"AL","1984-12-01",1984,12,336,500,13400,11400,25300
"AL","1984-12-02",1984,12,337,258,13400,11400,25058
"AL","1984-12-03",1984,12,338,13700,13400,11200,38300
"AL","1984-12-04",1984,12,339,9530,13400,11200,34130
"AL","1984-12-05",1984,12,340,0,13300,11300,24600
"AL","1984-12-06",1984,12,341,561,13300,11400,25261
"AL","1984-12-07",1984,12,342,2360,13300,11400,27060
"AL","1984-12-08",1984,12,343,0,13300,11400,24700
"AL","1984-12-09",1984,12,344,0,13200,11400,24600
"AL","1984-12-10",1984,12,345,0,13200,11500,24700
"AL","1984-12-11",1984,12,346,0,13200,11500,24700
"AL","1984-12-12",1984,12,347,0,13200,11500,24700
"AL","1984-12-13",1984,12,348,0,13100,11500,24600
"AL","1984-12-14",1984,12,349,0,13100,11500,24600
"AL","1984-12-15",1984,12,350,2150,13100,11500,26750
"AL","1984-12-16",1984,12,351,5780,13100,11300,30180
"AL","1984-12-17",1984,12,352,10500,13300,11700,35500
"AL","1984-12-18",1984,12,353,2490,15200,13600,31290
"AL","1984-12-19",1984,12,354,2020,13400,11600,27020
"AL","1984-12-20",1984,12,355,0,13200,11500,24700
"AL","1984-12-21",1984,12,356,0,13200,11400,24600
"AL","1984-12-22",1984,12,357,7390,13200,11300,31890
"AL","1984-12-23",1984,12,358,16000,13100,11100,40200
"AL","1984-12-24",1984,12,359,0,13100,11200,24300
"AL","1984-12-25",1984,12,360,0,13100,11400,24500
"AL","1984-12-26",1984,12,361,0,13000,11400,24400
"AL","1984-12-27",1984,12,362,0,13000,11400,24400
"AL","1984-12-28",1984,12,363,0,13000,11400,24400
"AL","1984-12-29",1984,12,364,2550,12900,11400,26850
"AL","1984-12-30",1984,12,365,2330,12900,11300,26530
"AL","1984-12-31",1984,12,366,0,12900,11300,24200
"AL","1985-01-01",1985,1,1,3590,12800,11300,27690
"AL","1985-01-02",1985,1,2,0,12800,11300,24100
"AL","1985-01-03",1985,1,3,0,12800,11300,24100
"AL","1985-01-04",1985,1,4,0,12800,11300,24100
"AL","1985-01-05",1985,1,5,0,12700,11300,24000
"AL","1985-01-06",1985,1,6,0,12700,11300,24000
"AL","1985-01-07",1985,1,7,0,12700,11300,24000
"AL","1985-01-08",1985,1,8,222,12700,11300,24222
"AL","1985-01-09",1985,1,9,0,12700,11300,24000
"AL","1985-01-10",1985,1,10,0,12600,11300,23900
"AL","1985-01-11",1985,1,11,730,12600,11300,24630
"AL","1985-01-12",1985,1,12,1800,12600,11300,25700
"AL","1985-01-13",1985,1,13,0,12600,11300,23900
"AL","1985-01-14",1985,1,14,0,12500,11200,23700
"AL","1985-01-15",1985,1,15,3890,12500,11200,27590
"AL","1985-01-16",1985,1,16,430,12500,11200,24130
"AL","1985-01-17",1985,1,17,0,12500,11200,23700
"AL","1985-01-18",1985,1,18,0,12500,11200,23700
"AL","1985-01-19",1985,1,19,430,12400,11200,24030
"AL","1985-01-20",1985,1,20,0,12400,11200,23600
"AL","1985-01-21",1985,1,21,0,12400,11100,23500
"AL","1985-01-22",1985,1,22,0,12400,11100,23500
"AL","1985-01-23",1985,1,23,3160,12400,11100,26660
"AL","1985-01-24",1985,1,24,0,12400,11100,23500
"AL","1985-01-25",1985,1,25,215,12300,11100,23615
"AL","1985-01-26",1985,1,26,0,12300,11100,23400
"AL","1985-01-27",1985,1,27,0,12300,11100,23400
"AL","1985-01-28",1985,1,28,468,12300,11100,23868
"AL","1985-01-29",1985,1,29,215,12200,11000,23415
"AL","1985-01-30",1985,1,30,0,12200,11000,23200
"AL","1985-01-31",1985,1,31,0,12200,11000,23200
"AL","1985-02-01",1985,2,32,0,12200,11000,23200
"AL","1985-02-02",1985,2,33,0,12200,11000,23200
"AL","1985-02-03",1985,2,34,0,12100,11000,23100
"AL","1985-02-04",1985,2,35,0,12100,11000,23100
"AL","1985-02-05",1985,2,36,0,12100,11000,23100
"AL","1985-02-06",1985,2,37,727,12100,11000,23827
"AL","1985-02-07",1985,2,38,2830,12100,10900,25830
"AL","1985-02-08",1985,2,39,517,12100,10900,23517
"AL","1985-02-09",1985,2,40,0,12000,10900,22900
"AL","1985-02-10",1985,2,41,0,12000,10900,22900
"AL","1985-02-11",1985,2,42,3450,12000,10800,26250
"AL","1985-02-12",1985,2,43,6960,12000,10700,29660
"AL","1985-02-13",1985,2,44,0,12000,10700,22700
"AL","1985-02-14",1985,2,45,0,12000,10700,22700
"AL","1985-02-15",1985,2,46,0,11900,10700,22600
"AL","1985-02-16",1985,2,47,0,11900,10800,22700
"AL","1985-02-17",1985,2,48,281,11900,10700,22881
"AL","1985-02-18",1985,2,49,598,11900,10700,23198
"AL","1985-02-19",1985,2,50,844,11900,10700,23444
"AL","1985-02-20",1985,2,51,1340,11800,10700,23840
"AL","1985-02-21",1985,2,52,129,11800,10700,22629
"AL","1985-02-22",1985,2,53,9730,11800,10500,32030
"AL","1985-02-23",1985,2,54,517,11800,10500,22817
"AL","1985-02-24",1985,2,55,0,11800,10600,22400
"AL","1985-02-25",1985,2,56,3860,12000,10600,26460
"AL","1985-02-26",1985,2,57,0,11800,10600,22400
"AL","1985-02-27",1985,2,58,2080,12300,10700,25080
"AL","1985-02-28",1985,2,59,0,11900,10600,22500
"AL","1985-03-01",1985,3,60,0,11800,10600,22400
"AL","1985-03-02",1985,3,61,0,11700,10600,22300
"AL","1985-03-03",1985,3,62,0,11700,10600,22300
"AL","1985-03-04",1985,3,63,6370,11700,10500,28570
"AL","1985-03-05",1985,3,64,29500,11700,9970,51170
"AL","1985-03-06",1985,3,65,12700,11700,9830,34230
"AL","1985-03-07",1985,3,66,0,11600,10000,21600
"AL","1985-03-08",1985,3,67,0,11600,10200,21800
"AL","1985-03-09",1985,3,68,0,11600,10300,21900
"AL","1985-03-10",1985,3,69,0,11600,10400,22000
"AL","1985-03-11",1985,3,70,0,11600,10400,22000
"AL","1985-03-12",1985,3,71,0,11500,10500,22000
"AL","1985-03-13",1985,3,72,30600,11500,9900,52000
"AL","1985-03-14",1985,3,73,3640,11500,9900,25040
"AL","1985-03-15",1985,3,74,0,11500,11000,22500
"AL","1985-03-16",1985,3,75,0,11500,10300,21800
"AL","1985-03-17",1985,3,76,0,11400,10300,21700
"AL","1985-03-18",1985,3,77,0,11400,11400,22800
"AL","1985-03-19",1985,3,78,0,11400,10500,21900
"AL","1985-03-20",1985,3,79,0,11500,12500,24000
"AL","1985-03-21",1985,3,80,0,12900,13500,26400
"AL","1985-03-22",1985,3,81,0,11900,12100,24000
"AL","1985-03-23",1985,3,82,0,12700,14400,27100
"AL","1985-03-24",1985,3,83,0,14500,17000,31500
"AL","1985-03-25",1985,3,84,1060,15800,19800,36660
"AL","1985-03-26",1985,3,85,0,13600,13800,27400
"AL","1985-03-27",1985,3,86,651,16300,20900,37851
"AL","1985-03-28",1985,3,87,5420,22200,29600,57220
"AL","1985-03-29",1985,3,88,3620,19900,15300,38820
"AL","1985-03-30",1985,3,89,9080,18400,14500,41980
"AL","1985-03-31",1985,3,90,0,14200,11400,25600
"AL","1985-04-01",1985,4,91,28400,14000,11100,53500
"AL","1985-04-02",1985,4,92,30400,13800,10700,54900
"AL","1985-04-03",1985,4,93,0,13600,11000,24600
"AL","1985-04-04",1985,4,94,7170,13400,11800,32370
"AL","1985-04-05",1985,4,95,0,13400,13400,26800
"AL","1985-04-06",1985,4,96,0,14200,13900,28100
"AL","1985-04-07",1985,4,97,256,14900,15200,30356
"AL","1985-04-08",1985,4,98,0,14200,13700,27900
"AL","1985-04-09",1985,4,99,5050,13600,11900,30550
"AL","1985-04-10",1985,4,100,0,13200,11500,24700
"AL","1985-04-11",1985,4,101,0,13100,12700,25800
"AL","1985-04-12",1985,4,102,0,15700,17100,32800
"AL","1985-04-13",1985,4,103,4680,19500,17200,41380
"AL","1985-04-14",1985,4,104,43800,24600,30600,99000
"AL","1985-04-15",1985,4,105,1220,15000,13300,29520
"AL","1985-04-16",1985,4,106,0,14300,11900,26200
"AL","1985-04-17",1985,4,107,0,14100,12000,26100
"AL","1985-04-18",1985,4,108,24200,16500,15300,56000
"AL","1985-04-19",1985,4,109,0,15700,14300,30000
"AL","1985-04-20",1985,4,110,9340,14600,14700,38640
"AL","1985-04-21",1985,4,111,0,14100,12000,26100
"AL","1985-04-22",1985,4,112,4820,14300,12000,31120
"AL","1985-04-23",1985,4,113,2660,13600,11900,28160
"AL","1985-04-24",1985,4,114,14700,16000,12600,43300
"AL","1985-04-25",1985,4,115,21100,20400,18300,59800
"AL","1985-04-26",1985,4,116,2200,15200,12100,29500
"AL","1985-04-27",1985,4,117,0,14100,11800,25900
"AL","1985-04-28",1985,4,118,885,14000,11800,26685
"AL","1985-04-29",1985,4,119,1480,14000,11800,27280
"AL","1985-04-30",1985,4,120,0,13700,11700,25400
"AL","1985-05-01",1985,5,121,0,13600,11700,25300
"AL","1985-05-02",1985,5,122,763,13600,11700,26063
"AL","1985-05-03",1985,5,123,0,13500,11700,25200
"AL","1985-05-04",1985,5,124,0,13400,11700,25100
"AL","1985-05-05",1985,5,125,2950,13400,11800,28150
"AL","1985-05-06",1985,5,126,4550,14100,11700,30350
"AL","1985-05-07",1985,5,127,11800,14300,12000,38100
"AL","1985-05-08",1985,5,128,3790,14200,11600,29590
"AL","1985-05-09",1985,5,129,0,13000,11600,24600
"AL","1985-05-10",1985,5,130,0,12600,11500,24100
"AL","1985-05-11",1985,5,131,69300,21800,31400,122500
"AL","1985-05-12",1985,5,132,11600,15700,14600,41900
"AL","1985-05-13",1985,5,133,3930,13900,12000,29830
"AL","1985-05-14",1985,5,134,4040,14000,12100,30140
"AL","1985-05-15",1985,5,135,3530,13400,12200,29130
"AL","1985-05-16",1985,5,136,21800,18900,17400,58100
"AL","1985-05-17",1985,5,137,4460,14300,12400,31160
"AL","1985-05-18",1985,5,138,1640,13700,12200,27540
"AL","1985-05-19",1985,5,139,6030,14400,12300,32730
"AL","1985-05-20",1985,5,140,2580,13300,12200,28080
"AL","1985-05-21",1985,5,141,254,13000,12200,25454
"AL","1985-05-22",1985,5,142,0,12400,12000,24400
"AL","1985-05-23",1985,5,143,0,12300,11900,24200
"AL","1985-05-24",1985,5,144,0,12200,11800,24000
"AL","1985-05-25",1985,5,145,2580,12000,11800,26380
"AL","1985-05-26",1985,5,146,9320,11900,11700,32920
"AL","1985-05-27",1985,5,147,73500,29000,29000,131500
"AL","1985-05-28",1985,5,148,0,14200,12200,26400
"AL","1985-05-29",1985,5,149,0,13900,12100,26000
"AL","1985-05-30",1985,5,150,1660,13800,12200,27660
"AL","1985-05-31",1985,5,151,70100,35800,37700,143600
"AL","1985-06-01",1985,6,152,31500,18300,25700,75500
"AL","1985-06-02",1985,6,153,11400,19400,17200,48000
"AL","1985-06-03",1985,6,154,9570,17400,15700,42670
"AL","1985-06-04",1985,6,155,0,15100,13500,28600
"AL","1985-06-05",1985,6,156,0,14900,13600,28500
"AL","1985-06-06",1985,6,157,0,14400,13600,28000
"AL","1985-06-07",1985,6,158,0,14100,13400,27500
"AL","1985-06-08",1985,6,159,2440,13900,13300,29640
"AL","1985-06-09",1985,6,160,11200,15200,13300,39700
"AL","1985-06-10",1985,6,161,23100,19600,13900,56600
"AL","1985-06-11",1985,6,162,0,14200,12900,27100
"AL","1985-06-12",1985,6,163,0,14000,13000,27000
"AL","1985-06-13",1985,6,164,0,13700,12900,26600
"AL","1985-06-14",1985,6,165,0,13500,12800,26300
"AL","1985-06-15",1985,6,166,0,13300,12700,26000
"AL","1985-06-16",1985,6,167,13400,14800,12600,40800
"AL","1985-06-17",1985,6,168,5360,15000,12500,32860
"AL","1985-06-18",1985,6,169,16300,16000,12900,45200
"AL","1985-06-19",1985,6,170,19200,19200,13400,51800
"AL","1985-06-20",1985,6,171,0,14600,12600,27200
"AL","1985-06-21",1985,6,172,0,14100,12700,26800
"AL","1985-06-22",1985,6,173,16000,14000,13100,43100
"AL","1985-06-23",1985,6,174,44600,28800,25800,99200
"AL","1985-06-24",1985,6,175,1270,15800,13600,30670
"AL","1985-06-25",1985,6,176,0,14900,13000,27900
"AL","1985-06-26",1985,6,177,0,14600,13000,27600
"AL","1985-06-27",1985,6,178,48600,14100,24600,87300
"AL","1985-06-28",1985,6,179,16200,16000,17900,50100
"AL","1985-06-29",1985,6,180,0,14300,13300,27600
"AL","1985-06-30",1985,6,181,0,13600,13400,27000
"AL","1985-07-01",1985,7,182,0,13400,13200,26600
"AL","1985-07-02",1985,7,183,0,13200,13200,26400
"AL","1985-07-03",1985,7,184,15800,14800,13200,43800
"AL","1985-07-04",1985,7,185,0,13500,13000,26500
"AL","1985-07-05",1985,7,186,34900,16300,14700,65900
"AL","1985-07-06",1985,7,187,42700,25500,27100,95300
"AL","1985-07-07",1985,7,188,5310,16200,14300,35810
"AL","1985-07-08",1985,7,189,350,15000,13500,28850
"AL","1985-07-09",1985,7,190,0,14700,13500,28200
"AL","1985-07-10",1985,7,191,3270,14000,13400,30670
"AL","1985-07-11",1985,7,192,8120,14500,13400,36020
"AL","1985-07-12",1985,7,193,1720,13800,13200,28720
"AL","1985-07-13",1985,7,194,0,13500,13000,26500
"AL","1985-07-14",1985,7,195,0,13400,13000,26400
"AL","1985-07-15",1985,7,196,0,13200,12900,26100
"AL","1985-07-16",1985,7,197,0,13100,12900,26000
"AL","1985-07-17",1985,7,198,0,13000,12700,25700
"AL","1985-07-18",1985,7,199,0,12900,12700,25600
"AL","1985-07-19",1985,7,200,21700,14600,12600,48900
"AL","1985-07-20",1985,7,201,2880,14000,12500,29380
"AL","1985-07-21",1985,7,202,0,13200,12500,25700
"AL","1985-07-22",1985,7,203,0,13000,12600,25600
"AL","1985-07-23",1985,7,204,0,12700,12500,25200
"AL","1985-07-24",1985,7,205,0,12600,12500,25100
"AL","1985-07-25",1985,7,206,6530,12600,12400,31530
"AL","1985-07-26",1985,7,207,21700,15600,12400,49700
"AL","1985-07-27",1985,7,208,0,13500,12200,25700
"AL","1985-07-28",1985,7,209,0,13200,12400,25600
"AL","1985-07-29",1985,7,210,1180,12700,12300,26180
"AL","1985-07-30",1985,7,211,0,12500,12300,24800
"AL","1985-07-31",1985,7,212,583,12400,12300,25283
"AL","1985-08-01",1985,8,213,4380,13000,12200,29580
"AL","1985-08-02",1985,8,214,0,12500,12200,24700
"AL","1985-08-03",1985,8,215,0,12400,12200,24600
"AL","1985-08-04",1985,8,216,0,12300,12200,24500
"AL","1985-08-05",1985,8,217,0,12200,12200,24400
"AL","1985-08-06",1985,8,218,13600,12200,12100,37900
"AL","1985-08-07",1985,8,219,3360,12700,12100,28160
"AL","1985-08-08",1985,8,220,14600,14800,12100,41500
"AL","1985-08-09",1985,8,221,877,13000,12000,25877
"AL","1985-08-10",1985,8,222,9650,12800,12200,34650
"AL","1985-08-11",1985,8,223,89000,39200,30900,159100
"AL","1985-08-12",1985,8,224,0,15400,12600,28000
"AL","1985-08-13",1985,8,225,7020,14900,12700,34620
"AL","1985-08-14",1985,8,226,28700,23600,22600,74900
"AL","1985-08-15",1985,8,227,0,15900,12900,28800
"AL","1985-08-16",1985,8,228,0,15500,12800,28300
"AL","1985-08-17",1985,8,229,0,15100,12800,27900
"AL","1985-08-18",1985,8,230,5790,14700,12800,33290
"AL","1985-08-19",1985,8,231,29400,20800,17700,67900
"AL","1985-08-20",1985,8,232,175,15400,12700,28275
"AL","1985-08-21",1985,8,233,0,15100,12800,27900
"AL","1985-08-22",1985,8,234,0,14700,12800,27500
"AL","1985-08-23",1985,8,235,702,14400,12700,27802
"AL","1985-08-24",1985,8,236,52100,21800,26500,100400
"AL","1985-08-25",1985,8,237,12300,19600,17800,49700
"AL","1985-08-26",1985,8,238,1540,15800,13300,30640
"AL","1985-08-27",1985,8,239,0,15100,13200,28300
"AL","1985-08-28",1985,8,240,0,14800,13200,28000
"AL","1985-08-29",1985,8,241,987,14400,13100,28487
"AL","1985-08-30",1985,8,242,4480,14100,13000,31580
"AL","1985-08-31",1985,8,243,0,13900,12900,26800
"AL","1985-09-01",1985,9,244,0,13800,12800,26600
"AL","1985-09-02",1985,9,245,0,13700,12800,26500
"AL","1985-09-03",1985,9,246,1210,13500,12700,27410
"AL","1985-09-04",1985,9,247,54800,22000,20600,97400
"AL","1985-09-05",1985,9,248,10300,17600,16000,43900
"AL","1985-09-06",1985,9,249,0,15100,12900,28000
"AL","1985-09-07",1985,9,250,0,14800,13000,27800
"AL","1985-09-08",1985,9,251,330,14300,12900,27530
"AL","1985-09-09",1985,9,252,32200,19500,18500,70200
"AL","1985-09-10",1985,9,253,481,15100,12900,28481
"AL","1985-09-11",1985,9,254,852,14500,12900,28252
"AL","1985-09-12",1985,9,255,0,14200,12800,27000
"AL","1985-09-13",1985,9,256,0,14200,12800,27000
"AL","1985-09-14",1985,9,257,0,13900,12700,26600
"AL","1985-09-15",1985,9,258,0,13800,12700,26500
"AL","1985-09-16",1985,9,259,0,13600,12600,26200
"AL","1985-09-17",1985,9,260,0,13500,12500,26000
"AL","1985-09-18",1985,9,261,893,13400,12500,26793
"AL","1985-09-19",1985,9,262,0,13300,12400,25700
"AL","1985-09-20",1985,9,263,0,13200,12400,25600
"AL","1985-09-21",1985,9,264,7380,13900,12300,33580
"AL","1985-09-22",1985,9,265,0,13300,12200,25500
"AL","1985-09-23",1985,9,266,10100,14600,12200,36900
"AL","1985-09-24",1985,9,267,34000,17300,14100,65400
"AL","1985-09-25",1985,9,268,39600,32200,27600,99400
"AL","1985-09-26",1985,9,269,837,16400,14600,31837
"AL","1985-09-27",1985,9,270,2210,16400,13000,31610
"AL","1985-09-28",1985,9,271,0,15700,12800,28500
"AL","1985-09-29",1985,9,272,110,15600,12900,28610
"AL","1985-09-30",1985,9,273,20400,18600,18500,57500
"AL","1985-10-01",1985,10,274,47300,31200,35600,114100
"AL","1985-10-02",1985,10,275,10300,20900,19800,51000
"AL","1985-10-03",1985,10,276,3970,18700,16600,39270
"AL","1985-10-04",1985,10,277,0,16800,13900,30700
"AL","1985-10-05",1985,10,278,46100,23800,31500,101400
"AL","1985-10-06",1985,10,279,60900,48000,47100,156000
"AL","1985-10-07",1985,10,280,1890,22900,22400,47190
"AL","1985-10-08",1985,10,281,1240,19100,16000,36340
"AL","1985-10-09",1985,10,282,22800,25600,24700,73100
"AL","1985-10-10",1985,10,283,0,19100,16500,35600
"AL","1985-10-11",1985,10,284,991,18800,16000,35791
"AL","1985-10-12",1985,10,285,0,18500,15900,34400
"AL","1985-10-13",1985,10,286,20500,23600,22700,66800
"AL","1985-10-14",1985,10,287,2680,19900,18200,40780
"AL","1985-10-15",1985,10,288,0,18400,16000,34400
"AL","1985-10-16",1985,10,289,0,18100,15900,34000
"AL","1985-10-17",1985,10,290,0,18000,15800,33800
"AL","1985-10-18",1985,10,291,804,17800,15700,34304
"AL","1985-10-19",1985,10,292,1680,17800,15600,35080
"AL","1985-10-20",1985,10,293,0,17500,15400,32900
"AL","1985-10-21",1985,10,294,0,17400,15400,32800
"AL","1985-10-22",1985,10,295,0,17300,15300,32600
"AL","1985-10-23",1985,10,296,0,17200,15200,32400
"AL","1985-10-24",1985,10,297,2410,17100,15300,34810
"AL","1985-10-25",1985,10,298,2160,17400,15100,34660
"AL","1985-10-26",1985,10,299,134,16900,15100,32134
"AL","1985-10-27",1985,10,300,184,16900,15100,32184
"AL","1985-10-28",1985,10,301,0,16900,15100,32000
"AL","1985-10-29",1985,10,302,0,16900,15000,31900
"AL","1985-10-30",1985,10,303,0,16900,15000,31900
"AL","1985-10-31",1985,10,304,1060,16900,14900,32860
"AL","1985-11-01",1985,11,305,0,16900,14900,31800
"AL","1985-11-02",1985,11,306,40200,25700,27700,93600
"AL","1985-11-03",1985,11,307,24500,28700,28100,81300
"AL","1985-11-04",1985,11,308,2050,19600,17700,39350
"AL","1985-11-05",1985,11,309,1530,18600,15700,35830
"AL","1985-11-06",1985,11,310,0,18200,15500,33700
"AL","1985-11-07",1985,11,311,3460,18400,15800,37660
"AL","1985-11-08",1985,11,312,0,18200,15400,33600
"AL","1985-11-09",1985,11,313,0,17800,15400,33200
"AL","1985-11-10",1985,11,314,0,17700,15300,33000
"AL","1985-11-11",1985,11,315,0,17700,15200,32900
"AL","1985-11-12",1985,11,316,0,17600,15200,32800
"AL","1985-11-13",1985,11,317,0,17500,15200,32700
"AL","1985-11-14",1985,11,318,0,17500,15200,32700
"AL","1985-11-15",1985,11,319,0,17400,15100,32500
"AL","1985-11-16",1985,11,320,0,17400,15100,32500
"AL","1985-11-17",1985,11,321,8190,17300,14900,40390
"AL","1985-11-18",1985,11,322,16300,17500,14800,48600
"AL","1985-11-19",1985,11,323,1670,17600,15700,34970
"AL","1985-11-20",1985,11,324,4380,22300,23300,49980
"AL","1985-11-21",1985,11,325,31100,18200,15500,64800
"AL","1985-11-22",1985,11,326,0,17800,15200,33000
"AL","1985-11-23",1985,11,327,12800,17700,15200,45700
"AL","1985-11-24",1985,11,328,2270,17600,15300,35170
"AL","1985-11-25",1985,11,329,3340,17500,15300,36140
"AL","1985-11-26",1985,11,330,1670,17400,15400,34470
"AL","1985-11-27",1985,11,331,8510,17300,15200,41010
"AL","1985-11-28",1985,11,332,0,17200,15300,32500
"AL","1985-11-29",1985,11,333,4860,17200,15200,37260
"AL","1985-11-30",1985,11,334,5440,17100,15200,37740
"AL","1985-12-01",1985,12,335,16900,17000,14900,48800
"AL","1985-12-02",1985,12,336,11400,17000,14800,43200
"AL","1985-12-03",1985,12,337,8110,16900,14800,39810
"AL","1985-12-04",1985,12,338,0,16900,15000,31900
"AL","1985-12-05",1985,12,339,1660,16800,15000,33460
"AL","1985-12-06",1985,12,340,2590,16700,15000,34290
"AL","1985-12-07",1985,12,341,1030,16700,15000,32730
"AL","1985-12-08",1985,12,342,0,16600,15000,31600
"AL","1985-12-09",1985,12,343,0,16600,15000,31600
"AL","1985-12-10",1985,12,344,644,16500,14900,32044
"AL","1985-12-11",1985,12,345,3640,16500,14800,34940
"AL","1985-12-12",1985,12,346,0,16500,14800,31300
"AL","1985-12-13",1985,12,347,0,16400,14800,31200
"AL","1985-12-14",1985,12,348,0,16400,14800,31200
"AL","1985-12-15",1985,12,349,0,16300,14700,31000
"AL","1985-12-16",1985,12,350,644,16300,14700,31644
"AL","1985-12-17",1985,12,351,0,16200,14700,30900
"AL","1985-12-18",1985,12,352,281,16200,14600,31081
"AL","1985-12-19",1985,12,353,0,16100,14600,30700
"AL","1985-12-20",1985,12,354,0,16100,14600,30700
"AL","1985-12-21",1985,12,355,0,16000,14500,30500
"AL","1985-12-22",1985,12,356,187,16000,14500,30687
"AL","1985-12-23",1985,12,357,3490,15900,14400,33790
"AL","1985-12-24",1985,12,358,267,15900,14400,30567
"AL","1985-12-25",1985,12,359,2940,15800,14300,33040
"AL","1985-12-26",1985,12,360,0,15800,14300,30100
"AL","1985-12-27",1985,12,361,827,15700,14300,30827
"AL","1985-12-28",1985,12,362,971,15700,14300,30971
"AL","1985-12-29",1985,12,363,0,15700,14200,29900
"AL","1985-12-30",1985,12,364,129,15600,14200,29929
"AL","1985-12-31",1985,12,365,0,15600,14200,29800
"AL","1986-01-01",1986,1,1,0,15500,14200,29700
"AL","1986-01-02",1986,1,2,0,15500,14100,29600
"AL","1986-01-03",1986,1,3,0,15400,14100,29500
"AL","1986-01-04",1986,1,4,0,15400,14100,29500
"AL","1986-01-05",1986,1,5,8220,15400,13900,37520
"AL","1986-01-06",1986,1,6,0,15300,13900,29200
"AL","1986-01-07",1986,1,7,0,15300,13900,29200
"AL","1986-01-08",1986,1,8,0,15200,13900,29100
"AL","1986-01-09",1986,1,9,0,15200,13900,29100
"AL","1986-01-10",1986,1,10,0,15200,13900,29100
"AL","1986-01-11",1986,1,11,0,15100,13900,29000
"AL","1986-01-12",1986,1,12,0,15100,13800,28900
"AL","1986-01-13",1986,1,13,3380,15000,13800,32180
"AL","1986-01-14",1986,1,14,860,15000,13700,29560
"AL","1986-01-15",1986,1,15,1740,15000,13700,30440
"AL","1986-01-16",1986,1,16,0,14900,13700,28600
"AL","1986-01-17",1986,1,17,0,14900,13700,28600
"AL","1986-01-18",1986,1,18,0,14800,13700,28500
"AL","1986-01-19",1986,1,19,7420,14800,13500,35720
"AL","1986-01-20",1986,1,20,215,14800,13500,28515
"AL","1986-01-21",1986,1,21,0,14700,13500,28200
"AL","1986-01-22",1986,1,22,0,14700,13500,28200
"AL","1986-01-23",1986,1,23,13600,14600,13300,41500
"AL","1986-01-24",1986,1,24,0,14600,13400,28000
"AL","1986-01-25",1986,1,25,312,14600,13400,28312
"AL","1986-01-26",1986,1,26,9240,14500,13300,37040
"AL","1986-01-27",1986,1,27,645,14500,13300,28445
"AL","1986-01-28",1986,1,28,1050,14500,13300,28850
"AL","1986-01-29",1986,1,29,0,14400,13300,27700
"AL","1986-01-30",1986,1,30,1050,14400,13300,28750
"AL","1986-01-31",1986,1,31,0,14400,13300,27700
"AL","1986-02-01",1986,2,32,0,14300,13300,27600
"AL","1986-02-02",1986,2,33,8570,14300,13200,36070
"AL","1986-02-03",1986,2,34,0,14300,13200,27500
"AL","1986-02-04",1986,2,35,0,14200,13200,27400
"AL","1986-02-05",1986,2,36,0,14200,13200,27400
"AL","1986-02-06",1986,2,37,0,14200,13200,27400
"AL","1986-02-07",1986,2,38,0,14100,13200,27300
"AL","1986-02-08",1986,2,39,0,14100,13100,27200
"AL","1986-02-09",1986,2,40,0,14100,13100,27200
"AL","1986-02-10",1986,2,41,0,14000,13100,27100
"AL","1986-02-11",1986,2,42,0,14000,13000,27000
"AL","1986-02-12",1986,2,43,0,14000,13000,27000
"AL","1986-02-13",1986,2,44,0,13900,13000,26900
"AL","1986-02-14",1986,2,45,0,13900,13000,26900
"AL","1986-02-15",1986,2,46,1330,13900,12900,28130
"AL","1986-02-16",1986,2,47,0,13800,12900,26700
"AL","1986-02-17",1986,2,48,0,13800,12900,26700
"AL","1986-02-18",1986,2,49,0,13800,12900,26700
"AL","1986-02-19",1986,2,50,0,13800,12800,26600
"AL","1986-02-20",1986,2,51,0,13700,12800,26500
"AL","1986-02-21",1986,2,52,10900,13700,12600,37200
"AL","1986-02-22",1986,2,53,0,13700,12600,26300
"AL","1986-02-23",1986,2,54,1130,13700,12700,27530
"AL","1986-02-24",1986,2,55,2430,13600,12600,28630
"AL","1986-02-25",1986,2,56,0,13600,12600,26200
"AL","1986-02-26",1986,2,57,0,13600,12700,26300
"AL","1986-02-27",1986,2,58,4410,13500,12600,30510
"AL","1986-02-28",1986,2,59,0,13500,12600,26100
"AL","1986-03-01",1986,3,60,0,13500,12600,26100
"AL","1986-03-02",1986,3,61,0,13400,12600,26000
"AL","1986-03-03",1986,3,62,0,13400,12600,26000
"AL","1986-03-04",1986,3,63,0,13400,12600,26000
"AL","1986-03-05",1986,3,64,345,13400,12600,26345
"AL","1986-03-06",1986,3,65,1960,13300,12500,27760
"AL","1986-03-07",1986,3,66,6380,13300,12400,32080
"AL","1986-03-08",1986,3,67,1190,13300,12400,26890
"AL","1986-03-09",1986,3,68,0,13300,12400,25700
"AL","1986-03-10",1986,3,69,172,13200,12400,25772
"AL","1986-03-11",1986,3,70,19500,13200,12100,44800
"AL","1986-03-12",1986,3,71,2010,13200,12100,27310
"AL","1986-03-13",1986,3,72,0,13200,12300,25500
"AL","1986-03-14",1986,3,73,2070,13100,12300,27470
"AL","1986-03-15",1986,3,74,12000,13100,12100,37200
"AL","1986-03-16",1986,3,75,474,13100,12100,25674
"AL","1986-03-17",1986,3,76,0,13100,12200,25300
"AL","1986-03-18",1986,3,77,0,13000,12200,25200
"AL","1986-03-19",1986,3,78,15400,13000,12000,40400
"AL","1986-03-20",1986,3,79,34900,13000,11500,59400
"AL","1986-03-21",1986,3,80,0,13000,11700,24700
"AL","1986-03-22",1986,3,81,0,13000,12000,25000
"AL","1986-03-23",1986,3,82,0,12900,12100,25000
"AL","1986-03-24",1986,3,83,0,12900,12100,25000
"AL","1986-03-25",1986,3,84,0,12900,12100,25000
"AL","1986-03-26",1986,3,85,0,12900,12100,25000
"AL","1986-03-27",1986,3,86,0,12800,12200,25000
"AL","1986-03-28",1986,3,87,0,12800,12200,25000
"AL","1986-03-29",1986,3,88,0,12800,12200,25000
"AL","1986-03-30",1986,3,89,0,12800,17100,29900
"AL","1986-03-31",1986,3,90,0,16400,24200,40600
"AL","1986-04-01",1986,4,91,0,17900,23700,41600
"AL","1986-04-02",1986,4,92,5810,169000,196000,370810
"AL","1986-04-03",1986,4,93,0,18400,15900,34300
"AL","1986-04-04",1986,4,94,632,22400,28600,51632
"AL","1986-04-05",1986,4,95,3970,22800,28500,55270
"AL","1986-04-06",1986,4,96,10800,27700,22700,61200
"AL","1986-04-07",1986,4,97,11300,27900,20800,60000
"AL","1986-04-08",1986,4,98,0,17400,14300,31700
"AL","1986-04-09",1986,4,99,1260,16900,14500,32660
"AL","1986-04-10",1986,4,100,0,16700,14500,31200
"AL","1986-04-11",1986,4,101,0,16500,14500,31000
"AL","1986-04-12",1986,4,102,0,16400,14500,30900
"AL","1986-04-13",1986,4,103,0,16100,14500,30600
"AL","1986-04-14",1986,4,104,0,15900,14500,30400
"AL","1986-04-15",1986,4,105,1140,15700,14400,31240
"AL","1986-04-16",1986,4,106,16400,18400,16400,51200
"AL","1986-04-17",1986,4,107,512,15700,14300,30512
"AL","1986-04-18",1986,4,108,0,15400,14200,29600
"AL","1986-04-19",1986,4,109,0,15300,14100,29400
"AL","1986-04-20",1986,4,110,1790,15200,13900,30890
"AL","1986-04-21",1986,4,111,2560,15500,13800,31860
"AL","1986-04-22",1986,4,112,732,14900,13700,29332
"AL","1986-04-23",1986,4,113,0,14800,13600,28400
"AL","1986-04-24",1986,4,114,0,14700,13600,28300
"AL","1986-04-25",1986,4,115,0,14600,13600,28200
"AL","1986-04-26",1986,4,116,0,14600,13600,28200
"AL","1986-04-27",1986,4,117,21600,19200,17200,58000
"AL","1986-04-28",1986,4,118,10500,18000,16100,44600
"AL","1986-04-29",1986,4,119,1770,15000,13500,30270
"AL","1986-04-30",1986,4,120,16500,17600,16300,50400
"AL","1986-05-01",1986,5,121,6400,15300,14400,36100
"AL","1986-05-02",1986,5,122,415,14900,13500,28815
"AL","1986-05-03",1986,5,123,254,14800,13400,28454
"AL","1986-05-04",1986,5,124,0,14700,13200,27900
"AL","1986-05-05",1986,5,125,0,14600,13200,27800
"AL","1986-05-06",1986,5,126,0,14500,13200,27700
"AL","1986-05-07",1986,5,127,0,14500,13200,27700
"AL","1986-05-08",1986,5,128,0,14400,13200,27600
"AL","1986-05-09",1986,5,129,0,13800,13200,27000
"AL","1986-05-10",1986,5,130,0,13500,13100,26600
"AL","1986-05-11",1986,5,131,254,13300,13000,26554
"AL","1986-05-12",1986,5,132,1660,13000,12900,27560
"AL","1986-05-13",1986,5,133,3470,13100,12800,29370
"AL","1986-05-14",1986,5,134,2770,12800,12700,28270
"AL","1986-05-15",1986,5,135,5310,13300,12600,31210
"AL","1986-05-16",1986,5,136,0,12800,12500,25300
"AL","1986-05-17",1986,5,137,0,12700,12500,25200
"AL","1986-05-18",1986,5,138,0,12500,12400,24900
"AL","1986-05-19",1986,5,139,0,12300,12300,24600
"AL","1986-05-20",1986,5,140,0,12300,12300,24600
"AL","1986-05-21",1986,5,141,0,12300,12200,24500
"AL","1986-05-22",1986,5,142,0,12100,12200,24300
"AL","1986-05-23",1986,5,143,0,12000,12100,24100
"AL","1986-05-24",1986,5,144,1960,12100,12000,26060
"AL","1986-05-25",1986,5,145,0,12000,12000,24000
"AL","1986-05-26",1986,5,146,2890,12400,11900,27190
"AL","1986-05-27",1986,5,147,0,12100,11900,24000
"AL","1986-05-28",1986,5,148,0,12100,11900,24000
"AL","1986-05-29",1986,5,149,0,11900,12000,23900
"AL","1986-05-30",1986,5,150,0,11800,11900,23700
"AL","1986-05-31",1986,5,151,0,11800,11900,23700
"AL","1986-06-01",1986,6,152,0,11700,11900,23600
"AL","1986-06-02",1986,6,153,0,11700,11900,23600
"AL","1986-06-03",1986,6,154,0,11700,11700,23400
"AL","1986-06-04",1986,6,155,0,11700,11600,23300
"AL","1986-06-05",1986,6,156,184,11600,11600,23384
"AL","1986-06-06",1986,6,157,0,11600,11600,23200
"AL","1986-06-07",1986,6,158,0,11500,11500,23000
"AL","1986-06-08",1986,6,159,3860,11500,11500,26860
"AL","1986-06-09",1986,6,160,6910,12500,11400,30810
"AL","1986-06-10",1986,6,161,0,11800,11300,23100
"AL","1986-06-11",1986,6,162,1660,11700,11300,24660
"AL","1986-06-12",1986,6,163,20900,13000,11200,45100
"AL","1986-06-13",1986,6,164,29000,17400,11000,57400
"AL","1986-06-14",1986,6,165,0,13000,10900,23900
"AL","1986-06-15",1986,6,166,0,12800,11200,24000
"AL","1986-06-16",1986,6,167,0,12400,11300,23700
"AL","1986-06-17",1986,6,168,0,12100,11400,23500
"AL","1986-06-18",1986,6,169,0,11800,11400,23200
"AL","1986-06-19",1986,6,170,0,11700,11400,23100
"AL","1986-06-20",1986,6,171,81600,19200,22700,123500
"AL","1986-06-21",1986,6,172,1270,13300,11300,25870
"AL","1986-06-22",1986,6,173,17300,15000,14300,46600
"AL","1986-06-23",1986,6,174,15900,13900,15300,45100
"AL","1986-06-24",1986,6,175,7500,13000,12300,32800
"AL","1986-06-25",1986,6,176,17200,17400,16200,50800
"AL","1986-06-26",1986,6,177,4230,13500,12100,29830
"AL","1986-06-27",1986,6,178,5130,13900,12200,31230
"AL","1986-06-28",1986,6,179,55700,28100,33600,117400
"AL","1986-06-29",1986,6,180,0,14400,12300,26700
"AL","1986-06-30",1986,6,181,0,14000,12600,26600
"AL","1986-07-01",1986,7,182,0,13500,12500,26000
"AL","1986-07-02",1986,7,183,0,13100,12500,25600
"AL","1986-07-03",1986,7,184,0,12800,12400,25200
"AL","1986-07-04",1986,7,185,0,12500,12400,24900
"AL","1986-07-05",1986,7,186,15900,13700,12300,41900
"AL","1986-07-06",1986,7,187,20700,16800,12300,49800
"AL","1986-07-07",1986,7,188,5310,14100,12200,31610
"AL","1986-07-08",1986,7,189,0,13000,12200,25200
"AL","1986-07-09",1986,7,190,0,12600,12200,24800
"AL","1986-07-10",1986,7,191,0,12200,12100,24300
"AL","1986-07-11",1986,7,192,0,12100,12100,24200
"AL","1986-07-12",1986,7,193,8520,12000,12000,32520
"AL","1986-07-13",1986,7,194,33800,16100,12400,62300
"AL","1986-07-14",1986,7,195,29500,21800,13700,65000
"AL","1986-07-15",1986,7,196,161,13900,11800,25861
"AL","1986-07-16",1986,7,197,1050,13500,12000,26550
"AL","1986-07-17",1986,7,198,7360,14400,12000,33760
"AL","1986-07-18",1986,7,199,0,13200,11900,25100
"AL","1986-07-19",1986,7,200,0,12800,11900,24700
"AL","1986-07-20",1986,7,201,57200,22200,20300,99700
"AL","1986-07-21",1986,7,202,4620,14900,12000,31520
"AL","1986-07-22",1986,7,203,0,13700,12000,25700
"AL","1986-07-23",1986,7,204,0,13200,12000,25200
"AL","1986-07-24",1986,7,205,0,12900,11900,24800
"AL","1986-07-25",1986,7,206,0,12500,11900,24400
"AL","1986-07-26",1986,7,207,28500,15800,12000,56300
"AL","1986-07-27",1986,7,208,0,13200,11600,24800
"AL","1986-07-28",1986,7,209,9970,13000,11800,34770
"AL","1986-07-29",1986,7,210,3770,13300,11800,28870
"AL","1986-07-30",1986,7,211,0,12500,11700,24200
"AL","1986-07-31",1986,7,212,933,12300,11700,24933
"AL","1986-08-01",1986,8,213,0,12000,11700,23700
"AL","1986-08-02",1986,8,214,3160,11900,11600,26660
"AL","1986-08-03",1986,8,215,45300,20100,12500,77900
"AL","1986-08-04",1986,8,216,4080,14100,11300,29480
"AL","1986-08-05",1986,8,217,0,13500,11600,25100
"AL","1986-08-06",1986,8,218,40500,16500,20200,77200
"AL","1986-08-07",1986,8,219,1690,13800,11800,27290
"AL","1986-08-08",1986,8,220,8070,13200,12000,33270
"AL","1986-08-09",1986,8,221,23200,17700,18900,59800
"AL","1986-08-10",1986,8,222,1050,13700,12100,26850
"AL","1986-08-11",1986,8,223,17900,19200,16700,53800
"AL","1986-08-12",1986,8,224,1560,14300,11900,27760
"AL","1986-08-13",1986,8,225,0,13600,12000,25600
"AL","1986-08-14",1986,8,226,0,13400,12000,25400
"AL","1986-08-15",1986,8,227,11600,14300,12000,37900
"AL","1986-08-16",1986,8,228,3030,14400,11900,29330
"AL","1986-08-17",1986,8,229,877,13300,11900,26077
"AL","1986-08-18",1986,8,230,15400,15300,12000,42700
"AL","1986-08-19",1986,8,231,0,13300,11800,25100
"AL","1986-08-20",1986,8,232,0,13000,11800,24800
"AL","1986-08-21",1986,8,233,1230,12700,11800,25730
"AL","1986-08-22",1986,8,234,1820,12600,11700,26120
"AL","1986-08-23",1986,8,235,6840,12300,11700,30840
"AL","1986-08-24",1986,8,236,31800,21500,15600,68900
"AL","1986-08-25",1986,8,237,0,13800,11400,25200
"AL","1986-08-26",1986,8,238,5820,14000,11600,31420
"AL","1986-08-27",1986,8,239,526,13400,11600,25526
"AL","1986-08-28",1986,8,240,834,13200,11600,25634
"AL","1986-08-29",1986,8,241,0,12900,11500,24400
"AL","1986-08-30",1986,8,242,0,12800,11500,24300
"AL","1986-08-31",1986,8,243,0,12700,11500,24200
"AL","1986-09-01",1986,9,244,1650,12500,11400,25550
"AL","1986-09-02",1986,9,245,0,12300,11400,23700
"AL","1986-09-03",1986,9,246,10300,12100,11500,33900
"AL","1986-09-04",1986,9,247,3320,12000,11400,26720
"AL","1986-09-05",1986,9,248,33600,17600,13200,64400
"AL","1986-09-06",1986,9,249,879,13300,11200,25379
"AL","1986-09-07",1986,9,250,0,12900,11300,24200
"AL","1986-09-08",1986,9,251,0,12900,11400,24300
"AL","1986-09-09",1986,9,252,0,12700,11400,24100
"AL","1986-09-10",1986,9,253,0,12500,11300,23800
"AL","1986-09-11",1986,9,254,18000,14900,11600,44500
"AL","1986-09-12",1986,9,255,19500,17900,14200,51600
"AL","1986-09-13",1986,9,256,4440,13900,11500,29840
"AL","1986-09-14",1986,9,257,5240,14100,11700,31040
"AL","1986-09-15",1986,9,258,989,13400,11300,25689
"AL","1986-09-16",1986,9,259,32700,22200,22400,77300
"AL","1986-09-17",1986,9,260,2870,15300,11900,30070
"AL","1986-09-18",1986,9,261,3080,14200,11600,28880
"AL","1986-09-19",1986,9,262,7380,15700,13200,36280
"AL","1986-09-20",1986,9,263,2710,14000,11700,28410
"AL","1986-09-21",1986,9,264,4330,14300,11900,30530
"AL","1986-09-22",1986,9,265,4700,14500,12000,31200
"AL","1986-09-23",1986,9,266,38300,25200,27500,91000
"AL","1986-09-24",1986,9,267,0,14900,12400,27300
"AL","1986-09-25",1986,9,268,0,14300,11800,26100
"AL","1986-09-26",1986,9,269,21500,17800,17400,56700
"AL","1986-09-27",1986,9,270,3440,17200,14200,34840
"AL","1986-09-28",1986,9,271,14100,21100,18900,54100
"AL","1986-09-29",1986,9,272,0,15500,12800,28300
"AL","1986-09-30",1986,9,273,7830,16300,13900,38030
"AL","1986-10-01",1986,10,274,0,15200,12500,27700
"AL","1986-10-02",1986,10,275,0,14700,12300,27000
"AL","1986-10-03",1986,10,276,0,14200,12200,26400
"AL","1986-10-04",1986,10,277,7570,14400,12100,34070
"AL","1986-10-05",1986,10,278,268,14300,12100,26668
"AL","1986-10-06",1986,10,279,938,13800,12100,26838
"AL","1986-10-07",1986,10,280,0,13800,12000,25800
"AL","1986-10-08",1986,10,281,369,13800,11900,26069
"AL","1986-10-09",1986,10,282,4780,15200,11800,31780
"AL","1986-10-10",1986,10,283,0,14200,11800,26000
"AL","1986-10-11",1986,10,284,0,13900,11700,25600
"AL","1986-10-12",1986,10,285,13100,15000,13200,41300
"AL","1986-10-13",1986,10,286,74000,39600,45600,159200
"AL","1986-10-14",1986,10,287,2080,18000,19700,39780
"AL","1986-10-15",1986,10,288,13000,17200,15300,45500
"AL","1986-10-16",1986,10,289,3330,17400,17500,38230
"AL","1986-10-17",1986,10,290,2840,16400,13600,32840
"AL","1986-10-18",1986,10,291,0,15800,13000,28800
"AL","1986-10-19",1986,10,292,0,15600,13000,28600
"AL","1986-10-20",1986,10,293,0,15500,12900,28400
"AL","1986-10-21",1986,10,294,0,15300,12800,28100
"AL","1986-10-22",1986,10,295,0,15200,12700,27900
"AL","1986-10-23",1986,10,296,0,15100,12600,27700
"AL","1986-10-24",1986,10,297,5450,16600,12600,34650
"AL","1986-10-25",1986,10,298,0,15200,12600,27800
"AL","1986-10-26",1986,10,299,0,14800,12500,27300
"AL","1986-10-27",1986,10,300,0,14800,12500,27300
"AL","1986-10-28",1986,10,301,0,14700,12500,27200
"AL","1986-10-29",1986,10,302,0,14700,12400,27100
"AL","1986-10-30",1986,10,303,369,14700,12400,27469
"AL","1986-10-31",1986,10,304,0,14600,12300,26900
"AL","1986-11-01",1986,11,305,7070,14600,12600,34270
"AL","1986-11-02",1986,11,306,5210,16000,12600,33810
"AL","1986-11-03",1986,11,307,0,14700,12500,27200
"AL","1986-11-04",1986,11,308,5520,14700,12400,32620
"AL","1986-11-05",1986,11,309,0,14600,12500,27100
"AL","1986-11-06",1986,11,310,167,14400,13000,27567
"AL","1986-11-07",1986,11,311,0,14300,12300,26600
"AL","1986-11-08",1986,11,312,0,14300,12200,26500
"AL","1986-11-09",1986,11,313,13400,16400,13600,43400
"AL","1986-11-10",1986,11,314,1020,14700,12500,28220
"AL","1986-11-11",1986,11,315,333,14400,12200,26933
"AL","1986-11-12",1986,11,316,375,14400,12300,27075
"AL","1986-11-13",1986,11,317,0,14400,12400,26800
"AL","1986-11-14",1986,11,318,0,14400,12400,26800
"AL","1986-11-15",1986,11,319,0,14300,12400,26700
"AL","1986-11-16",1986,11,320,4590,14300,12300,31190
"AL","1986-11-17",1986,11,321,3780,14300,12300,30380
"AL","1986-11-18",1986,11,322,0,14200,12400,26600
"AL","1986-11-19",1986,11,323,0,14200,12400,26600
"AL","1986-11-20",1986,11,324,0,14200,12400,26600
"AL","1986-11-21",1986,11,325,19300,14200,12100,45600
"AL","1986-11-22",1986,11,326,0,14100,12200,26300
"AL","1986-11-23",1986,11,327,0,14100,12300,26400
"AL","1986-11-24",1986,11,328,7010,14300,12200,33510
"AL","1986-11-25",1986,11,329,689,14200,12200,27089
"AL","1986-11-26",1986,11,330,0,14100,12300,26400
"AL","1986-11-27",1986,11,331,0,14400,12800,27200
"AL","1986-11-28",1986,11,332,0,14200,12500,26700
"AL","1986-11-29",1986,11,333,0,14300,13200,27500
"AL","1986-11-30",1986,11,334,0,14200,12400,26600
"AL","1986-12-01",1986,12,335,0,14100,12400,26500
"AL","1986-12-02",1986,12,336,0,14100,12300,26400
"AL","1986-12-03",1986,12,337,1400,14100,12300,27800
"AL","1986-12-04",1986,12,338,7140,14000,12200,33340
"AL","1986-12-05",1986,12,339,1590,14000,12200,27790
"AL","1986-12-06",1986,12,340,0,14000,12200,26200
"AL","1986-12-07",1986,12,341,0,14000,12200,26200
"AL","1986-12-08",1986,12,342,0,13900,12200,26100
"AL","1986-12-09",1986,12,343,0,13900,12200,26100
"AL","1986-12-10",1986,12,344,1240,13900,12200,27340
"AL","1986-12-11",1986,12,345,0,13900,12200,26100
"AL","1986-12-12",1986,12,346,2740,13800,12100,28640
"AL","1986-12-13",1986,12,347,386,13800,12100,26286
"AL","1986-12-14",1986,12,348,0,13800,12100,25900
"AL","1986-12-15",1986,12,349,129,13700,12100,25929
"AL","1986-12-16",1986,12,350,0,13700,12100,25800
"AL","1986-12-17",1986,12,351,0,13700,12100,25800
"AL","1986-12-18",1986,12,352,0,13700,12100,25800
"AL","1986-12-19",1986,12,353,0,13600,12100,25700
"AL","1986-12-20",1986,12,354,0,13600,12100,25700
"AL","1986-12-21",1986,12,355,0,13600,12000,25600
"AL","1986-12-22",1986,12,356,0,13600,12000,25600
"AL","1986-12-23",1986,12,357,0,13500,12000,25500
"AL","1986-12-24",1986,12,358,0,13500,12000,25500
"AL","1986-12-25",1986,12,359,0,13500,12000,25500
"AL","1986-12-26",1986,12,360,0,13400,12000,25400
"AL","1986-12-27",1986,12,361,0,13400,12000,25400
"AL","1986-12-28",1986,12,362,0,13400,12000,25400
"AL","1986-12-29",1986,12,363,0,13400,11900,25300
"AL","1986-12-30",1986,12,364,0,13300,11900,25200
"AL","1986-12-31",1986,12,365,0,13300,11900,25200
"AL","1987-01-01",1987,1,1,0,13300,11900,25200
"AL","1987-01-02",1987,1,2,0,13300,11900,25200
"AL","1987-01-03",1987,1,3,0,13200,11900,25100
"AL","1987-01-04",1987,1,4,0,13200,11900,25100
"AL","1987-01-05",1987,1,5,0,13200,11900,25100
"AL","1987-01-06",1987,1,6,0,13200,11800,25000
"AL","1987-01-07",1987,1,7,0,13100,11800,24900
"AL","1987-01-08",1987,1,8,5160,13100,11700,29960
"AL","1987-01-09",1987,1,9,0,13100,11700,24800
"AL","1987-01-10",1987,1,10,0,13100,11700,24800
"AL","1987-01-11",1987,1,11,0,13000,11700,24700
"AL","1987-01-12",1987,1,12,0,13000,11700,24700
"AL","1987-01-13",1987,1,13,0,13000,11700,24700
"AL","1987-01-14",1987,1,14,0,13000,11700,24700
"AL","1987-01-15",1987,1,15,0,12900,11700,24600
"AL","1987-01-16",1987,1,16,468,13200,11700,25368
"AL","1987-01-17",1987,1,17,0,13000,11600,24600
"AL","1987-01-18",1987,1,18,0,12900,11600,24500
"AL","1987-01-19",1987,1,19,1900,12900,11500,26300
"AL","1987-01-20",1987,1,20,0,12800,11500,24300
"AL","1987-01-21",1987,1,21,12500,12800,11300,36600
"AL","1987-01-22",1987,1,22,0,12800,11300,24100
"AL","1987-01-23",1987,1,23,4530,12800,11300,28630
"AL","1987-01-24",1987,1,24,0,12800,11300,24100
"AL","1987-01-25",1987,1,25,0,12700,11300,24000
"AL","1987-01-26",1987,1,26,0,12700,11400,24100
"AL","1987-01-27",1987,1,27,0,12700,11400,24100
"AL","1987-01-28",1987,1,28,0,12600,11400,24000
"AL","1987-01-29",1987,1,29,527,12600,11400,24527
"AL","1987-01-30",1987,1,30,3440,12600,11300,27340
"AL","1987-01-31",1987,1,31,25600,12600,10800,49000
"AL","1987-02-01",1987,2,32,0,12600,10900,23500
"AL","1987-02-02",1987,2,33,0,12500,11100,23600
"AL","1987-02-03",1987,2,34,0,12500,11100,23600
"AL","1987-02-04",1987,2,35,0,12500,11200,23700
"AL","1987-02-05",1987,2,36,0,12500,11200,23700
"AL","1987-02-06",1987,2,37,0,12400,11200,23600
"AL","1987-02-07",1987,2,38,0,12400,11200,23600
"AL","1987-02-08",1987,2,39,0,12400,11200,23600
"AL","1987-02-09",1987,2,40,1890,12400,11200,25490
"AL","1987-02-10",1987,2,41,0,12300,11200,23500
"AL","1987-02-11",1987,2,42,0,12300,11200,23500
"AL","1987-02-12",1987,2,43,0,12300,11200,23500
"AL","1987-02-13",1987,2,44,0,12300,11200,23500
"AL","1987-02-14",1987,2,45,0,12200,11200,23400
"AL","1987-02-15",1987,2,46,0,12200,11200,23400
"AL","1987-02-16",1987,2,47,0,12200,11200,23400
"AL","1987-02-17",1987,2,48,0,12200,11100,23300
"AL","1987-02-18",1987,2,49,0,12100,11100,23200
"AL","1987-02-19",1987,2,50,0,12100,11100,23200
"AL","1987-02-20",1987,2,51,0,12100,11100,23200
"AL","1987-02-21",1987,2,52,0,12100,11100,23200
"AL","1987-02-22",1987,2,53,0,12000,11100,23100
"AL","1987-02-23",1987,2,54,3720,12000,11000,26720
"AL","1987-02-24",1987,2,55,646,12000,11600,24246
"AL","1987-02-25",1987,2,56,0,12000,11100,23100
"AL","1987-02-26",1987,2,57,0,11900,11000,22900
"AL","1987-02-27",1987,2,58,0,11900,11000,22900
"AL","1987-02-28",1987,2,59,0,11900,11000,22900
"AL","1987-03-01",1987,3,60,0,11900,11000,22900
"AL","1987-03-02",1987,3,61,20600,11900,10900,43400
"AL","1987-03-03",1987,3,62,6470,11800,10600,28870
"AL","1987-03-04",1987,3,63,0,11800,10700,22500
"AL","1987-03-05",1987,3,64,0,11800,10800,22600
"AL","1987-03-06",1987,3,65,0,11800,10800,22600
"AL","1987-03-07",1987,3,66,0,11800,13700,25500
"AL","1987-03-08",1987,3,67,0,14800,19100,33900
"AL","1987-03-09",1987,3,68,0,17500,20600,38100
"AL","1987-03-10",1987,3,69,0,13100,12000,25100
"AL","1987-03-11",1987,3,70,0,12700,11300,24000
"AL","1987-03-12",1987,3,71,0,12600,11300,23900
"AL","1987-03-13",1987,3,72,0,12500,11200,23700
"AL","1987-03-14",1987,3,73,0,12300,11200,23500
"AL","1987-03-15",1987,3,74,474,12300,11200,23974
"AL","1987-03-16",1987,3,75,0,12200,11200,23400
"AL","1987-03-17",1987,3,76,0,12100,11100,23200
"AL","1987-03-18",1987,3,77,0,12100,11300,23400
"AL","1987-03-19",1987,3,78,0,12900,11800,24700
"AL","1987-03-20",1987,3,79,0,12500,11200,23700
"AL","1987-03-21",1987,3,80,0,11900,10800,22700
"AL","1987-03-22",1987,3,81,0,11800,10800,22600
"AL","1987-03-23",1987,3,82,0,11800,10800,22600
"AL","1987-03-24",1987,3,83,0,11700,10800,22500
"AL","1987-03-25",1987,3,84,0,11700,10800,22500
"AL","1987-03-26",1987,3,85,465,11700,10800,22965
"AL","1987-03-27",1987,3,86,3800,12000,10800,26600
"AL","1987-03-28",1987,3,87,474,11600,10700,22774
"AL","1987-03-29",1987,3,88,0,11500,10700,22200
"AL","1987-03-30",1987,3,89,5020,12100,10600,27720
"AL","1987-03-31",1987,3,90,5050,11500,10500,27050
"AL","1987-04-01",1987,4,91,0,11400,10500,21900
"AL","1987-04-02",1987,4,92,24600,11400,10100,46100
"AL","1987-04-03",1987,4,93,3190,11400,10100,24690
"AL","1987-04-04",1987,4,94,0,11400,10300,21700
"AL","1987-04-05",1987,4,95,0,11400,10400,21800
"AL","1987-04-06",1987,4,96,0,11600,10800,22400
"AL","1987-04-07",1987,4,97,0,12900,14000,26900
"AL","1987-04-08",1987,4,98,0,13900,13200,27100
"AL","1987-04-09",1987,4,99,0,11800,10600,22400
"AL","1987-04-10",1987,4,100,0,11700,10500,22200
"AL","1987-04-11",1987,4,101,0,11700,10500,22200
"AL","1987-04-12",1987,4,102,2360,11700,10400,24460
"AL","1987-04-13",1987,4,103,0,11500,10300,21800
"AL","1987-04-14",1987,4,104,0,11500,10300,21800
"AL","1987-04-15",1987,4,105,3290,11700,10400,25390
"AL","1987-04-16",1987,4,106,2820,11700,10300,24820
"AL","1987-04-17",1987,4,107,0,11300,10400,21700
"AL","1987-04-18",1987,4,108,0,11300,10400,21700
"AL","1987-04-19",1987,4,109,0,11300,10400,21700
"AL","1987-04-20",1987,4,110,0,11200,10500,21700
"AL","1987-04-21",1987,4,111,0,11200,10500,21700
"AL","1987-04-22",1987,4,112,981,11200,10500,22681
"AL","1987-04-23",1987,4,113,0,11200,10500,21700
"AL","1987-04-24",1987,4,114,427,11200,10500,22127
"AL","1987-04-25",1987,4,115,0,11100,10500,21600
"AL","1987-04-26",1987,4,116,19100,13700,12400,45200
"AL","1987-04-27",1987,4,117,0,11700,10300,22000
"AL","1987-04-28",1987,4,118,3050,11800,10300,25150
"AL","1987-04-29",1987,4,119,0,11300,10200,21500
"AL","1987-04-30",1987,4,120,0,11200,10200,21400
"AL","1987-05-01",1987,5,121,0,11200,10200,21400
"AL","1987-05-02",1987,5,122,1150,11200,10200,22550
"AL","1987-05-03",1987,5,123,0,11200,10200,21400
"AL","1987-05-04",1987,5,124,0,11100,10300,21400
"AL","1987-05-05",1987,5,125,0,11100,10300,21400
"AL","1987-05-06",1987,5,126,0,11100,10400,21500
"AL","1987-05-07",1987,5,127,0,11100,10400,21500
"AL","1987-05-08",1987,5,128,0,11000,10400,21400
"AL","1987-05-09",1987,5,129,0,10400,10500,20900
"AL","1987-05-10",1987,5,130,0,9950,10400,20350
"AL","1987-05-11",1987,5,131,2580,9710,10300,22590
"AL","1987-05-12",1987,5,132,2470,9770,10100,22340
"AL","1987-05-13",1987,5,133,0,9570,10000,19570
"AL","1987-05-14",1987,5,134,923,9530,9970,20423
"AL","1987-05-15",1987,5,135,763,9510,9900,20173
"AL","1987-05-16",1987,5,136,0,9460,9880,19340
"AL","1987-05-17",1987,5,137,2470,9440,9850,21760
"AL","1987-05-18",1987,5,138,0,9400,9830,19230
"AL","1987-05-19",1987,5,139,10600,9660,9700,29960
"AL","1987-05-20",1987,5,140,47700,14800,9590,72090
"AL","1987-05-21",1987,5,141,1320,11400,9130,21850
"AL","1987-05-22",1987,5,142,1290,10700,9440,21430
"AL","1987-05-23",1987,5,143,9420,11800,9560,30780
"AL","1987-05-24",1987,5,144,1330,10500,9460,21290
"AL","1987-05-25",1987,5,145,0,10300,9510,19810
"AL","1987-05-26",1987,5,146,0,10300,9560,19860
"AL","1987-05-27",1987,5,147,12000,11500,9530,33030
"AL","1987-05-28",1987,5,148,16800,11000,9780,37580
"AL","1987-05-29",1987,5,149,26100,15100,12000,53200
"AL","1987-05-30",1987,5,150,13300,11700,11500,36500
"AL","1987-05-31",1987,5,151,59000,24200,32500,115700
"AL","1987-06-01",1987,6,152,11600,12000,12900,36500
"AL","1987-06-02",1987,6,153,2390,11700,9870,23960
"AL","1987-06-03",1987,6,154,34400,15800,19800,70000
"AL","1987-06-04",1987,6,155,1360,11900,10200,23460
"AL","1987-06-05",1987,6,156,0,11300,10200,21500
"AL","1987-06-06",1987,6,157,8260,11700,10300,30260
"AL","1987-06-07",1987,6,158,0,11000,10200,21200
"AL","1987-06-08",1987,6,159,0,10700,10200,20900
"AL","1987-06-09",1987,6,160,0,10400,10100,20500
"AL","1987-06-10",1987,6,161,0,10200,10100,20300
"AL","1987-06-11",1987,6,162,0,10000,10000,20000
"AL","1987-06-12",1987,6,163,28700,14100,10100,52900
"AL","1987-06-13",1987,6,164,507,11600,9770,21877
"AL","1987-06-14",1987,6,165,0,10800,9920,20720
"AL","1987-06-15",1987,6,166,0,10400,9970,20370
"AL","1987-06-16",1987,6,167,0,10000,10000,20000
"AL","1987-06-17",1987,6,168,0,9880,10000,19880
"AL","1987-06-18",1987,6,169,0,9810,9950,19760
"AL","1987-06-19",1987,6,170,368,9750,9890,20008
"AL","1987-06-20",1987,6,171,0,9700,9850,19550
"AL","1987-06-21",1987,6,172,0,9650,9830,19480
"AL","1987-06-22",1987,6,173,5640,9920,9740,25300
"AL","1987-06-23",1987,6,174,4740,10200,9660,24600
"AL","1987-06-24",1987,6,175,0,9650,9660,19310
"AL","1987-06-25",1987,6,176,0,9520,9700,19220
"AL","1987-06-26",1987,6,177,3680,9480,9630,22790
"AL","1987-06-27",1987,6,178,9900,10500,9510,29910
"AL","1987-06-28",1987,6,179,6770,10700,9390,26860
"AL","1987-06-29",1987,6,180,0,9950,9410,19360
"AL","1987-06-30",1987,6,181,9830,10900,9370,30100
"AL","1987-07-01",1987,7,182,0,9910,9350,19260
"AL","1987-07-02",1987,7,183,0,9740,9550,19290
"AL","1987-07-03",1987,7,184,19400,10700,9440,39540
"AL","1987-07-04",1987,7,185,8210,10800,9310,28320
"AL","1987-07-05",1987,7,186,0,9840,9420,19260
"AL","1987-07-06",1987,7,187,0,9660,9550,19210
"AL","1987-07-07",1987,7,188,14000,9400,9530,32930
"AL","1987-07-08",1987,7,189,4690,9530,9510,23730
"AL","1987-07-09",1987,7,190,7490,9510,9570,26570
"AL","1987-07-10",1987,7,191,24300,11100,9520,44920
"AL","1987-07-11",1987,7,192,15400,12500,9660,37560
"AL","1987-07-12",1987,7,193,19300,12400,9980,41680
"AL","1987-07-13",1987,7,194,16900,14700,9820,41420
"AL","1987-07-14",1987,7,195,1850,11000,9490,22340
"AL","1987-07-15",1987,7,196,0,10500,9600,20100
"AL","1987-07-16",1987,7,197,0,10200,9670,19870
"AL","1987-07-17",1987,7,198,0,10000,9690,19690
"AL","1987-07-18",1987,7,199,0,9780,9740,19520
"AL","1987-07-19",1987,7,200,0,9640,9760,19400
"AL","1987-07-20",1987,7,201,17400,10300,9670,37370
"AL","1987-07-21",1987,7,202,3150,9520,9620,22290
"AL","1987-07-22",1987,7,203,23300,12300,9610,45210
"AL","1987-07-23",1987,7,204,0,10100,9490,19590
"AL","1987-07-24",1987,7,205,0,9750,9670,19420
"AL","1987-07-25",1987,7,206,34900,14300,9980,59180
"AL","1987-07-26",1987,7,207,161,10500,9340,20001
"AL","1987-07-27",1987,7,208,0,10100,9560,19660
"AL","1987-07-28",1987,7,209,0,9830,9690,19520
"AL","1987-07-29",1987,7,210,394,9600,9650,19644
"AL","1987-07-30",1987,7,211,0,9510,9650,19160
"AL","1987-07-31",1987,7,212,0,9460,9660,19120
"AL","1987-08-01",1987,8,213,467,9410,9660,19537
"AL","1987-08-02",1987,8,214,13700,10600,9510,33810
"AL","1987-08-03",1987,8,215,15800,10600,9350,35750
"AL","1987-08-04",1987,8,216,0,9740,9370,19110
"AL","1987-08-05",1987,8,217,0,9530,9500,19030
"AL","1987-08-06",1987,8,218,0,9330,9550,18880
"AL","1987-08-07",1987,8,219,395,9260,9550,19205
"AL","1987-08-08",1987,8,220,3010,9360,9510,21880
"AL","1987-08-09",1987,8,221,0,9190,9520,18710
"AL","1987-08-10",1987,8,222,11500,9790,9420,30710
"AL","1987-08-11",1987,8,223,2660,9650,9350,21660
"AL","1987-08-12",1987,8,224,0,9260,9410,18670
"AL","1987-08-13",1987,8,225,4040,9200,9410,22650
"AL","1987-08-14",1987,8,226,33900,9900,9400,53200
"AL","1987-08-15",1987,8,227,6760,9950,9160,25870
"AL","1987-08-16",1987,8,228,11700,10500,9540,31740
"AL","1987-08-17",1987,8,229,3730,9930,9380,23040
"AL","1987-08-18",1987,8,230,11400,10600,9540,31540
"AL","1987-08-19",1987,8,231,2300,9690,9420,21410
"AL","1987-08-20",1987,8,232,11900,11000,9540,32440
"AL","1987-08-21",1987,8,233,0,9830,9410,19240
"AL","1987-08-22",1987,8,234,0,9660,9520,19180
"AL","1987-08-23",1987,8,235,11000,10700,9500,31200
"AL","1987-08-24",1987,8,236,0,9750,9400,19150
"AL","1987-08-25",1987,8,237,0,9630,9470,19100
"AL","1987-08-26",1987,8,238,0,9440,9470,18910
"AL","1987-08-27",1987,8,239,0,9300,9470,18770
"AL","1987-08-28",1987,8,240,0,9160,9450,18610
"AL","1987-08-29",1987,8,241,0,9050,9420,18470
"AL","1987-08-30",1987,8,242,0,8960,9400,18360
"AL","1987-08-31",1987,8,243,16100,10900,9300,36300
"AL","1987-09-01",1987,9,244,4040,9670,9180,22890
"AL","1987-09-02",1987,9,245,769,9550,9250,19569
"AL","1987-09-03",1987,9,246,893,9390,9270,19553
"AL","1987-09-04",1987,9,247,0,9260,9290,18550
"AL","1987-09-05",1987,9,248,0,9210,9330,18540
"AL","1987-09-06",1987,9,249,0,9090,9360,18450
"AL","1987-09-07",1987,9,250,16900,9420,9300,35620
"AL","1987-09-08",1987,9,251,0,8990,9200,18190
"AL","1987-09-09",1987,9,252,2090,9000,9270,20360
"AL","1987-09-10",1987,9,253,0,8890,9280,18170
"AL","1987-09-11",1987,9,254,549,8840,9290,18679
"AL","1987-09-12",1987,9,255,8080,9210,9240,26530
"AL","1987-09-13",1987,9,256,1760,9120,9190,20070
"AL","1987-09-14",1987,9,257,5030,9290,9200,23520
"AL","1987-09-15",1987,9,258,0,9010,9170,18180
"AL","1987-09-16",1987,9,259,0,9030,9220,18250
"AL","1987-09-17",1987,9,260,0,8950,9240,18190
"AL","1987-09-18",1987,9,261,12600,9920,9180,31700
"AL","1987-09-19",1987,9,262,7660,9880,9090,26630
"AL","1987-09-20",1987,9,263,6910,10100,9100,26110
"AL","1987-09-21",1987,9,264,371,9500,9100,18971
"AL","1987-09-22",1987,9,265,3860,9450,9160,22470
"AL","1987-09-23",1987,9,266,124,9250,9160,18534
"AL","1987-09-24",1987,9,267,0,9100,9180,18280
"AL","1987-09-25",1987,9,268,0,9090,9190,18280
"AL","1987-09-26",1987,9,269,0,8980,9150,18130
"AL","1987-09-27",1987,9,270,0,8940,9140,18080
"AL","1987-09-28",1987,9,271,0,8890,9140,18030
"AL","1987-09-29",1987,9,272,0,8800,9140,17940
"AL","1987-09-30",1987,9,273,769,8700,9100,18569
"AL","1987-10-01",1987,10,274,865,8680,9040,18585
"AL","1987-10-02",1987,10,275,0,8660,8990,17650
"AL","1987-10-03",1987,10,276,37600,12200,9410,59210
"AL","1987-10-04",1987,10,277,0,9910,8590,18500
"AL","1987-10-05",1987,10,278,0,9700,8800,18500
"AL","1987-10-06",1987,10,279,1590,9630,8860,20080
"AL","1987-10-07",1987,10,280,13500,10900,9100,33500
"AL","1987-10-08",1987,10,281,8710,10500,8900,28110
"AL","1987-10-09",1987,10,282,0,10700,8880,19580
"AL","1987-10-10",1987,10,283,268,10100,8860,19228
"AL","1987-10-11",1987,10,284,639,10100,8860,19599
"AL","1987-10-12",1987,10,285,0,10000,8850,18850
"AL","1987-10-13",1987,10,286,0,10000,8850,18850
"AL","1987-10-14",1987,10,287,0,9980,8850,18830
"AL","1987-10-15",1987,10,288,0,9950,8840,18790
"AL","1987-10-16",1987,10,289,15400,10700,9160,35260
"AL","1987-10-17",1987,10,290,53700,24500,29100,107300
"AL","1987-10-18",1987,10,291,4640,13300,12800,30740
"AL","1987-10-19",1987,10,292,396,11700,9530,21626
"AL","1987-10-20",1987,10,293,0,11300,8800,20100
"AL","1987-10-21",1987,10,294,1940,11300,8870,22110
"AL","1987-10-22",1987,10,295,12900,12300,10100,35300
"AL","1987-10-23",1987,10,296,4940,11600,12100,28640
"AL","1987-10-24",1987,10,297,10900,11600,9340,31840
"AL","1987-10-25",1987,10,298,970,12500,12600,26070
"AL","1987-10-26",1987,10,299,0,11900,9210,21110
"AL","1987-10-27",1987,10,300,3730,11500,9280,24510
"AL","1987-10-28",1987,10,301,8420,12600,11500,32520
"AL","1987-10-29",1987,10,302,639,12000,9600,22239
"AL","1987-10-30",1987,10,303,0,11100,9070,20170
"AL","1987-10-31",1987,10,304,0,11100,9110,20210
"AL","1987-11-01",1987,11,305,0,11000,9120,20120
"AL","1987-11-02",1987,11,306,0,10900,9140,20040
"AL","1987-11-03",1987,11,307,1120,10900,9120,21140
"AL","1987-11-04",1987,11,308,7400,11700,9070,28170
"AL","1987-11-05",1987,11,309,6070,12700,9190,27960
"AL","1987-11-06",1987,11,310,0,11100,9090,20190
"AL","1987-11-07",1987,11,311,0,10800,9100,19900
"AL","1987-11-08",1987,11,312,0,10800,9100,19900
"AL","1987-11-09",1987,11,313,0,10700,9100,19800
"AL","1987-11-10",1987,11,314,0,10700,9060,19760
"AL","1987-11-11",1987,11,315,0,10600,9060,19660
"AL","1987-11-12",1987,11,316,0,10600,9080,19680
"AL","1987-11-13",1987,11,317,0,10600,9110,19710
"AL","1987-11-14",1987,11,318,0,10500,9150,19650
"AL","1987-11-15",1987,11,319,0,10500,9170,19670
"AL","1987-11-16",1987,11,320,0,10400,9190,19590
"AL","1987-11-17",1987,11,321,4580,10700,9280,24560
"AL","1987-11-18",1987,11,322,28300,13200,14400,55900
"AL","1987-11-19",1987,11,323,22900,13300,11900,48100
"AL","1987-11-20",1987,11,324,689,11200,8990,20879
"AL","1987-11-21",1987,11,325,0,11000,8990,19990
"AL","1987-11-22",1987,11,326,0,10900,9040,19940
"AL","1987-11-23",1987,11,327,0,10800,9090,19890
"AL","1987-11-24",1987,11,328,8590,10700,8980,28270
"AL","1987-11-25",1987,11,329,6860,10700,9040,26600
"AL","1987-11-26",1987,11,330,0,10700,9020,19720
"AL","1987-11-27",1987,11,331,0,10600,9090,19690
"AL","1987-11-28",1987,11,332,0,10500,9140,19640
"AL","1987-11-29",1987,11,333,0,10500,9170,19670
"AL","1987-11-30",1987,11,334,27300,16200,20600,64100
"AL","1987-12-01",1987,12,335,10400,11900,10800,33100
"AL","1987-12-02",1987,12,336,1970,11300,9130,22400
"AL","1987-12-03",1987,12,337,316,11100,9040,20456
"AL","1987-12-04",1987,12,338,0,11000,9080,20080
"AL","1987-12-05",1987,12,339,339,10900,9140,20379
"AL","1987-12-06",1987,12,340,0,10900,9180,20080
"AL","1987-12-07",1987,12,341,0,10800,9220,20020
"AL","1987-12-08",1987,12,342,0,10700,9250,19950
"AL","1987-12-09",1987,12,343,0,10700,9280,19980
"AL","1987-12-10",1987,12,344,25400,14100,18800,58300
"AL","1987-12-11",1987,12,345,4030,11500,10100,25630
"AL","1987-12-12",1987,12,346,2240,11200,9720,23160
"AL","1987-12-13",1987,12,347,6110,12400,11300,29810
"AL","1987-12-14",1987,12,348,258,11200,9450,20908
"AL","1987-12-15",1987,12,349,0,11000,9300,20300
"AL","1987-12-16",1987,12,350,1850,10900,9280,22030
"AL","1987-12-17",1987,12,351,5500,10900,9220,25620
"AL","1987-12-18",1987,12,352,0,10800,9270,20070
"AL","1987-12-19",1987,12,353,1630,10700,9300,21630
"AL","1987-12-20",1987,12,354,5440,10700,9250,25390
"AL","1987-12-21",1987,12,355,11200,10600,9080,30880
"AL","1987-12-22",1987,12,356,0,10600,9170,19770
"AL","1987-12-23",1987,12,357,0,10600,9270,19870
"AL","1987-12-24",1987,12,358,0,10500,9320,19820
"AL","1987-12-25",1987,12,359,1500,10500,9320,21320
"AL","1987-12-26",1987,12,360,4620,10500,9250,24370
"AL","1987-12-27",1987,12,361,0,10500,9300,19800
"AL","1987-12-28",1987,12,362,0,10400,9340,19740
"AL","1987-12-29",1987,12,363,0,10400,9350,19750
"AL","1987-12-30",1987,12,364,0,10400,9370,19770
"AL","1987-12-31",1987,12,365,0,10400,9380,19780
"AL","1988-01-01",1988,1,1,3840,10400,9320,23560
"AL","1988-01-02",1988,1,2,645,10300,9300,20245
"AL","1988-01-03",1988,1,3,0,10300,9340,19640
"AL","1988-01-04",1988,1,4,0,10300,9350,19650
"AL","1988-01-05",1988,1,5,0,10300,9360,19660
"AL","1988-01-06",1988,1,6,0,10300,9360,19660
"AL","1988-01-07",1988,1,7,0,10200,9350,19550
"AL","1988-01-08",1988,1,8,0,10200,9350,19550
"AL","1988-01-09",1988,1,9,0,10200,9350,19550
"AL","1988-01-10",1988,1,10,0,10200,9350,19550
"AL","1988-01-11",1988,1,11,0,10200,9340,19540
"AL","1988-01-12",1988,1,12,1930,10200,9290,21420
"AL","1988-01-13",1988,1,13,2710,10200,9250,22160
"AL","1988-01-14",1988,1,14,8850,10100,9100,28050
"AL","1988-01-15",1988,1,15,0,10100,9140,19240
"AL","1988-01-16",1988,1,16,430,10100,9180,19710
"AL","1988-01-17",1988,1,17,0,10100,9210,19310
"AL","1988-01-18",1988,1,18,0,10100,9230,19330
"AL","1988-01-19",1988,1,19,0,10100,9250,19350
"AL","1988-01-20",1988,1,20,0,10100,9250,19350
"AL","1988-01-21",1988,1,21,13800,10100,9000,32900
"AL","1988-01-22",1988,1,22,2800,10000,8970,21770
"AL","1988-01-23",1988,1,23,312,10000,9070,19382
"AL","1988-01-24",1988,1,24,2620,10000,9060,21680
"AL","1988-01-25",1988,1,25,645,10000,9080,19725
"AL","1988-01-26",1988,1,26,430,10000,9100,19530
"AL","1988-01-27",1988,1,27,1230,10000,9090,20320
"AL","1988-01-28",1988,1,28,0,9980,9100,19080
"AL","1988-01-29",1988,1,29,0,9970,9120,19090
"AL","1988-01-30",1988,1,30,0,9960,9140,19100
"AL","1988-01-31",1988,1,31,0,9950,9160,19110
"AL","1988-02-01",1988,2,32,1180,9940,9150,20270
"AL","1988-02-02",1988,2,33,0,9930,9150,19080
"AL","1988-02-03",1988,2,34,0,9910,9150,19060
"AL","1988-02-04",1988,2,35,0,9900,9150,19050
"AL","1988-02-05",1988,2,36,0,9890,9150,19040
"AL","1988-02-06",1988,2,37,0,9880,9150,19030
"AL","1988-02-07",1988,2,38,0,9870,9130,19000
"AL","1988-02-08",1988,2,39,4460,9860,9050,23370
"AL","1988-02-09",1988,2,40,0,9850,9060,18910
"AL","1988-02-10",1988,2,41,0,9840,9080,18920
"AL","1988-02-11",1988,2,42,0,9830,9090,18920
"AL","1988-02-12",1988,2,43,0,9820,9100,18920
"AL","1988-02-13",1988,2,44,0,9820,9080,18900
"AL","1988-02-14",1988,2,45,0,9810,9080,18890
"AL","1988-02-15",1988,2,46,0,9800,9080,18880
"AL","1988-02-16",1988,2,47,317,9790,9080,19187
"AL","1988-02-17",1988,2,48,0,9780,9080,18860
"AL","1988-02-18",1988,2,49,0,9770,9080,18850
"AL","1988-02-19",1988,2,50,0,9760,9080,18840
"AL","1988-02-20",1988,2,51,0,9750,9080,18830
"AL","1988-02-21",1988,2,52,2430,9740,9020,21190
"AL","1988-02-22",1988,2,53,0,9730,9020,18750
"AL","1988-02-23",1988,2,54,0,9720,9040,18760
"AL","1988-02-24",1988,2,55,528,9710,9030,19268
"AL","1988-02-25",1988,2,56,0,9700,9020,18720
"AL","1988-02-26",1988,2,57,0,9690,9020,18710
"AL","1988-02-27",1988,2,58,0,9680,9020,18700
"AL","1988-02-28",1988,2,59,0,9680,9020,18700
"AL","1988-02-29",1988,2,60,188,9670,9020,18878
"AL","1988-03-01",1988,3,61,1180,9660,9000,19840
"AL","1988-03-02",1988,3,62,0,9650,9010,18660
"AL","1988-03-03",1988,3,63,0,9640,9020,18660
"AL","1988-03-04",1988,3,64,0,9630,9010,18640
"AL","1988-03-05",1988,3,65,0,9620,9000,18620
"AL","1988-03-06",1988,3,66,0,9610,9020,18630
"AL","1988-03-07",1988,3,67,0,9600,9030,18630
"AL","1988-03-08",1988,3,68,172,9590,9040,18802
"AL","1988-03-09",1988,3,69,16300,9580,9810,35690
"AL","1988-03-10",1988,3,70,712,10300,13900,24912
"AL","1988-03-11",1988,3,71,0,10200,11600,21800
"AL","1988-03-12",1988,3,72,0,11100,12800,23900
"AL","1988-03-13",1988,3,73,2690,11100,11200,24990
"AL","1988-03-14",1988,3,74,12200,10100,9120,31420
"AL","1988-03-15",1988,3,75,1510,9970,8900,20380
"AL","1988-03-16",1988,3,76,1770,9910,8920,20600
"AL","1988-03-17",1988,3,77,0,9860,8980,18840
"AL","1988-03-18",1988,3,78,0,9820,9020,18840
"AL","1988-03-19",1988,3,79,0,9780,9050,18830
"AL","1988-03-20",1988,3,80,0,9750,9060,18810
"AL","1988-03-21",1988,3,81,0,9720,9050,18770
"AL","1988-03-22",1988,3,82,0,9690,9040,18730
"AL","1988-03-23",1988,3,83,0,9660,9070,18730
"AL","1988-03-24",1988,3,84,0,9630,9090,18720
"AL","1988-03-25",1988,3,85,345,9610,9250,19205
"AL","1988-03-26",1988,3,86,36600,9800,53100,99500
"AL","1988-03-27",1988,3,87,3250,12800,16000,32050
"AL","1988-03-28",1988,3,88,0,10300,9520,19820
"AL","1988-03-29",1988,3,89,0,10000,9180,19180
"AL","1988-03-30",1988,3,90,10400,10300,12300,33000
"AL","1988-03-31",1988,3,91,0,10400,11400,21800
"AL","1988-04-01",1988,4,92,0,11000,11800,22800
"AL","1988-04-02",1988,4,93,0,10900,11200,22100
"AL","1988-04-03",1988,4,94,0,12200,12600,24800
"AL","1988-04-04",1988,4,95,14800,58000,24300,97100
"AL","1988-04-05",1988,4,96,0,16600,11100,27700
"AL","1988-04-06",1988,4,97,0,17400,10600,28000
"AL","1988-04-07",1988,4,98,11700,20300,13200,45200
"AL","1988-04-08",1988,4,99,0,13100,9370,22470
"AL","1988-04-09",1988,4,100,0,12600,9350,21950
"AL","1988-04-10",1988,4,101,0,12400,9360,21760
"AL","1988-04-11",1988,4,102,1420,12400,9320,23140
"AL","1988-04-12",1988,4,103,0,11900,9330,21230
"AL","1988-04-13",1988,4,104,0,11700,9370,21070
"AL","1988-04-14",1988,4,105,0,11600,9370,20970
"AL","1988-04-15",1988,4,106,0,11500,9390,20890
"AL","1988-04-16",1988,4,107,1700,11500,9400,22600
"AL","1988-04-17",1988,4,108,0,11200,9430,20630
"AL","1988-04-18",1988,4,109,854,11200,9480,21534
"AL","1988-04-19",1988,4,110,0,11100,9510,20610
"AL","1988-04-20",1988,4,111,0,11000,9530,20530
"AL","1988-04-21",1988,4,112,0,10900,9560,20460
"AL","1988-04-22",1988,4,113,0,10900,9570,20470
"AL","1988-04-23",1988,4,114,0,10800,9580,20380
"AL","1988-04-24",1988,4,115,6930,11700,9810,28440
"AL","1988-04-25",1988,4,116,0,10800,9480,20280
"AL","1988-04-26",1988,4,117,0,10700,9490,20190
"AL","1988-04-27",1988,4,118,0,10600,9510,20110
"AL","1988-04-28",1988,4,119,3100,11000,9540,23640
"AL","1988-04-29",1988,4,120,0,10600,9480,20080
"AL","1988-04-30",1988,4,121,0,10500,9520,20020
"AL","1988-05-01",1988,5,122,0,10400,9550,19950
"AL","1988-05-02",1988,5,123,0,10400,9620,20020
"AL","1988-05-03",1988,5,124,0,10400,9680,20080
"AL","1988-05-04",1988,5,125,0,10400,9720,20120
"AL","1988-05-05",1988,5,126,0,10400,9750,20150
"AL","1988-05-06",1988,5,127,0,10300,9780,20080
"AL","1988-05-07",1988,5,128,0,10300,9810,20110
"AL","1988-05-08",1988,5,129,0,9600,9820,19420
"AL","1988-05-09",1988,5,130,0,9240,9690,18930
"AL","1988-05-10",1988,5,131,32400,13000,10400,55800
"AL","1988-05-11",1988,5,132,8450,11000,9720,29170
"AL","1988-05-12",1988,5,133,831,10300,9340,20471
"AL","1988-05-13",1988,5,134,2980,10100,9370,22450
"AL","1988-05-14",1988,5,135,11000,10700,9340,31040
"AL","1988-05-15",1988,5,136,0,9700,9220,18920
"AL","1988-05-16",1988,5,137,2220,9580,9240,21040
"AL","1988-05-17",1988,5,138,0,9390,9260,18650
"AL","1988-05-18",1988,5,139,0,9140,9240,18380
"AL","1988-05-19",1988,5,140,0,9060,9220,18280
"AL","1988-05-20",1988,5,141,0,9010,9240,18250
"AL","1988-05-21",1988,5,142,0,8970,9230,18200
"AL","1988-05-22",1988,5,143,4060,9260,9140,22460
"AL","1988-05-23",1988,5,144,22700,10900,8910,42510
"AL","1988-05-24",1988,5,145,3050,9860,8750,21660
"AL","1988-05-25",1988,5,146,0,9250,8910,18160
"AL","1988-05-26",1988,5,147,0,8940,8980,17920
"AL","1988-05-27",1988,5,148,0,8870,9010,17880
"AL","1988-05-28",1988,5,149,623,8860,9010,18493
"AL","1988-05-29",1988,5,150,0,8830,9040,17870
"AL","1988-05-30",1988,5,151,0,8800,9030,17830
"AL","1988-05-31",1988,5,152,0,8780,9030,17810
"AL","1988-06-01",1988,6,153,0,8760,9030,17790
"AL","1988-06-02",1988,6,154,1840,8740,9050,19630
"AL","1988-06-03",1988,6,155,10100,9420,9000,28520
"AL","1988-06-04",1988,6,156,10500,9850,8780,29130
"AL","1988-06-05",1988,6,157,0,9060,8790,17850
"AL","1988-06-06",1988,6,158,0,8770,8920,17690
"AL","1988-06-07",1988,6,159,0,8690,8980,17670
"AL","1988-06-08",1988,6,160,0,8660,9050,17710
"AL","1988-06-09",1988,6,161,2900,8650,9050,20600
"AL","1988-06-10",1988,6,162,1010,8690,8960,18660
"AL","1988-06-11",1988,6,163,0,8590,8980,17570
"AL","1988-06-12",1988,6,164,0,8690,9040,17730
"AL","1988-06-13",1988,6,165,0,8550,9090,17640
"AL","1988-06-14",1988,6,166,760,8630,9100,18490
"AL","1988-06-15",1988,6,167,0,8510,9070,17580
"AL","1988-06-16",1988,6,168,6010,8910,8990,23910
"AL","1988-06-17",1988,6,169,3410,8810,8880,21100
"AL","1988-06-18",1988,6,170,0,8470,8860,17330
"AL","1988-06-19",1988,6,171,0,8580,8910,17490
"AL","1988-06-20",1988,6,172,38500,12100,8600,59200
"AL","1988-06-21",1988,6,173,0,9460,8330,17790
"AL","1988-06-22",1988,6,174,1840,8920,8570,19330
"AL","1988-06-23",1988,6,175,368,8670,8630,17668
"AL","1988-06-24",1988,6,176,0,8610,8660,17270
"AL","1988-06-25",1988,6,177,0,8560,8690,17250
"AL","1988-06-26",1988,6,178,0,8640,8710,17350
"AL","1988-06-27",1988,6,179,0,8490,8720,17210
"AL","1988-06-28",1988,6,180,0,8580,8720,17300
"AL","1988-06-29",1988,6,181,24700,9420,8520,42640
"AL","1988-06-30",1988,6,182,20900,12300,8220,41420
"AL","1988-07-01",1988,7,183,0,9450,8190,17640
"AL","1988-07-02",1988,7,184,0,9200,8530,17730
"AL","1988-07-03",1988,7,185,0,8730,8750,17480
"AL","1988-07-04",1988,7,186,0,8640,8890,17530
"AL","1988-07-05",1988,7,187,0,8570,9010,17580
"AL","1988-07-06",1988,7,188,0,8620,9130,17750
"AL","1988-07-07",1988,7,189,0,8480,9230,17710
"AL","1988-07-08",1988,7,190,0,8520,9180,17700
"AL","1988-07-09",1988,7,191,0,8410,9220,17630
"AL","1988-07-10",1988,7,192,28000,13400,8910,50310
"AL","1988-07-11",1988,7,193,3860,9870,8630,22360
"AL","1988-07-12",1988,7,194,0,9240,8760,18000
"AL","1988-07-13",1988,7,195,394,9010,8800,18204
"AL","1988-07-14",1988,7,196,4070,8810,8770,21650
"AL","1988-07-15",1988,7,197,2890,9030,8850,20770
"AL","1988-07-16",1988,7,198,8010,9450,8770,26230
"AL","1988-07-17",1988,7,199,21100,10300,8540,39940
"AL","1988-07-18",1988,7,200,0,9000,8560,17560
"AL","1988-07-19",1988,7,201,0,8540,8700,17240
"AL","1988-07-20",1988,7,202,0,8470,8740,17210
"AL","1988-07-21",1988,7,203,263,8550,8740,17553
"AL","1988-07-22",1988,7,204,4540,8970,8670,22180
"AL","1988-07-23",1988,7,205,9520,9430,8660,27610
"AL","1988-07-24",1988,7,206,0,8380,8680,17060
"AL","1988-07-25",1988,7,207,5980,8460,8660,23100
"AL","1988-07-26",1988,7,208,6290,9530,8560,24380
"AL","1988-07-27",1988,7,209,0,8580,8600,17180
"AL","1988-07-28",1988,7,210,0,8280,8760,17040
"AL","1988-07-29",1988,7,211,0,8320,8880,17200
"AL","1988-07-30",1988,7,212,5020,8210,8850,22080
"AL","1988-07-31",1988,7,213,9930,9430,8770,28130
"AL","1988-08-01",1988,8,214,2650,8300,8660,19610
"AL","1988-08-02",1988,8,215,7860,8790,8580,25230
"AL","1988-08-03",1988,8,216,104000,26000,26400,156400
"AL","1988-08-04",1988,8,217,17200,12700,11500,41400
"AL","1988-08-05",1988,8,218,27400,14700,15200,57300
"AL","1988-08-06",1988,8,219,15900,13000,12400,41300
"AL","1988-08-07",1988,8,220,571,11000,8210,19781
"AL","1988-08-08",1988,8,221,0,10600,8560,19160
"AL","1988-08-09",1988,8,222,2410,10200,8590,21200
"AL","1988-08-10",1988,8,223,1300,9890,8560,19750
"AL","1988-08-11",1988,8,224,0,9580,8620,18200
"AL","1988-08-12",1988,8,225,0,9400,8780,18180
"AL","1988-08-13",1988,8,226,14500,10500,8740,33740
"AL","1988-08-14",1988,8,227,7950,10100,8600,26650
"AL","1988-08-15",1988,8,228,27400,12300,8580,48280
"AL","1988-08-16",1988,8,229,0,9920,8480,18400
"AL","1988-08-17",1988,8,230,0,9640,8720,18360
"AL","1988-08-18",1988,8,231,25900,12200,9110,47210
"AL","1988-08-19",1988,8,232,10600,10600,8620,29820
"AL","1988-08-20",1988,8,233,0,9760,8650,18410
"AL","1988-08-21",1988,8,234,0,9600,8770,18370
"AL","1988-08-22",1988,8,235,0,9330,8800,18130
"AL","1988-08-23",1988,8,236,0,9130,8800,17930
"AL","1988-08-24",1988,8,237,57500,16100,11500,85100
"AL","1988-08-25",1988,8,238,0,10400,8320,18720
"AL","1988-08-26",1988,8,239,0,10300,8630,18930
"AL","1988-08-27",1988,8,240,7280,10600,8680,26560
"AL","1988-08-28",1988,8,241,7980,10900,8720,27600
"AL","1988-08-29",1988,8,242,6310,10900,8750,25960
"AL","1988-08-30",1988,8,243,250,10200,8730,19180
"AL","1988-08-31",1988,8,244,0,9870,8790,18660
"AL","1988-09-01",1988,9,245,0,9740,8830,18570
"AL","1988-09-02",1988,9,246,5260,9730,8830,23820
"AL","1988-09-03",1988,9,247,303,9590,8800,18693
"AL","1988-09-04",1988,9,248,42700,16100,14600,73400
"AL","1988-09-05",1988,9,249,23100,17700,17200,58000
"AL","1988-09-06",1988,9,250,1200,11600,8420,21220
"AL","1988-09-07",1988,9,251,0,10900,8610,19510
"AL","1988-09-08",1988,9,252,0,10600,8720,19320
"AL","1988-09-09",1988,9,253,0,10400,8770,19170
"AL","1988-09-10",1988,9,254,0,10100,8790,18890
"AL","1988-09-11",1988,9,255,0,9900,8810,18710
"AL","1988-09-12",1988,9,256,0,9720,8820,18540
"AL","1988-09-13",1988,9,257,549,9560,8840,18949
"AL","1988-09-14",1988,9,258,3190,9500,8800,21490
"AL","1988-09-15",1988,9,259,0,9310,8800,18110
"AL","1988-09-16",1988,9,260,0,9310,8820,18130
"AL","1988-09-17",1988,9,261,8020,9220,8780,26020
"AL","1988-09-18",1988,9,262,18500,11600,8820,38920
"AL","1988-09-19",1988,9,263,220,9900,8660,18780
"AL","1988-09-20",1988,9,264,14600,10100,9030,33730
"AL","1988-09-21",1988,9,265,20100,13500,9220,42820
"AL","1988-09-22",1988,9,266,3350,10800,8610,22760
"AL","1988-09-23",1988,9,267,1840,10700,8710,21250
"AL","1988-09-24",1988,9,268,454,10300,8740,19494
"AL","1988-09-25",1988,9,269,0,10000,8760,18760
"AL","1988-09-26",1988,9,270,1100,9950,8780,19830
"AL","1988-09-27",1988,9,271,2900,9920,8760,21580
"AL","1988-09-28",1988,9,272,0,9710,8760,18470
"AL","1988-09-29",1988,9,273,1100,9500,8750,19350
"AL","1988-09-30",1988,9,274,6720,10400,8640,25760
"AL","1988-10-01",1988,10,275,303,10100,8650,19053
"AL","1988-10-02",1988,10,276,302,9860,8710,18872
"AL","1988-10-03",1988,10,277,0,9460,8660,18120
"AL","1988-10-04",1988,10,278,3350,9270,8630,21250
"AL","1988-10-05",1988,10,279,4630,9730,8590,22950
"AL","1988-10-06",1988,10,280,1080,9620,8550,19250
"AL","1988-10-07",1988,10,281,0,9460,8560,18020
"AL","1988-10-08",1988,10,282,0,9520,8560,18080
"AL","1988-10-09",1988,10,283,0,9560,8580,18140
"AL","1988-10-10",1988,10,284,0,9590,8600,18190
"AL","1988-10-11",1988,10,285,1630,9660,8610,19900
"AL","1988-10-12",1988,10,286,1190,9840,8600,19630
"AL","1988-10-13",1988,10,287,0,9650,8580,18230
"AL","1988-10-14",1988,10,288,0,9660,8590,18250
"AL","1988-10-15",1988,10,289,0,9660,8600,18260
"AL","1988-10-16",1988,10,290,0,9660,8630,18290
"AL","1988-10-17",1988,10,291,6300,9710,8710,24720
"AL","1988-10-18",1988,10,292,5530,10600,8680,24810
"AL","1988-10-19",1988,10,293,5400,10600,8670,24670
"AL","1988-10-20",1988,10,294,4120,10700,8630,23450
"AL","1988-10-21",1988,10,295,1410,9930,8470,19810
"AL","1988-10-22",1988,10,296,9770,11300,8680,29750
"AL","1988-10-23",1988,10,297,5690,11000,8770,25460
"AL","1988-10-24",1988,10,298,7870,12200,10000,30070
"AL","1988-10-25",1988,10,299,26000,18100,11400,55500
"AL","1988-10-26",1988,10,300,2540,12000,9980,24520
"AL","1988-10-27",1988,10,301,0,11100,8380,19480
"AL","1988-10-28",1988,10,302,12300,11000,8230,31530
"AL","1988-10-29",1988,10,303,8250,11000,8070,27320
"AL","1988-10-30",1988,10,304,0,10800,8190,18990
"AL","1988-10-31",1988,10,305,0,10700,8300,19000
"AL","1988-11-01",1988,11,306,4140,10800,8740,23680
"AL","1988-11-02",1988,11,307,4880,12200,10000,27080
"AL","1988-11-03",1988,11,308,0,10900,8530,19430
"AL","1988-11-04",1988,11,309,0,11200,10200,21400
"AL","1988-11-05",1988,11,310,10400,13700,14000,38100
"AL","1988-11-06",1988,11,311,34300,24300,14000,72600
"AL","1988-11-07",1988,11,312,5110,12600,8540,26250
"AL","1988-11-08",1988,11,313,712,12800,8440,21952
"AL","1988-11-09",1988,11,314,4730,12700,9760,27190
"AL","1988-11-10",1988,11,315,0,12800,10800,23600
"AL","1988-11-11",1988,11,316,563,11800,14800,27163
"AL","1988-11-12",1988,11,317,1650,11800,11300,24750
"AL","1988-11-13",1988,11,318,0,11500,9820,21320
"AL","1988-11-14",1988,11,319,9720,11600,9900,31220
"AL","1988-11-15",1988,11,320,5000,12200,11700,28900
"AL","1988-11-16",1988,11,321,18300,12600,15000,45900
"AL","1988-11-17",1988,11,322,53500,27100,42500,123100
"AL","1988-11-18",1988,11,323,1610,14300,17300,33210
"AL","1988-11-19",1988,11,324,0,12700,10400,23100
"AL","1988-11-20",1988,11,325,2650,12600,9920,25170
"AL","1988-11-21",1988,11,326,0,12600,10000,22600
"AL","1988-11-22",1988,11,327,0,12200,10100,22300
"AL","1988-11-23",1988,11,328,0,12100,10000,22100
"AL","1988-11-24",1988,11,329,0,12000,9960,21960
"AL","1988-11-25",1988,11,330,0,11800,9910,21710
"AL","1988-11-26",1988,11,331,0,11800,9850,21650
"AL","1988-11-27",1988,11,332,6840,12600,9810,29250
"AL","1988-11-28",1988,11,333,16400,14500,9810,40710
"AL","1988-11-29",1988,11,334,16300,12300,9370,37970
"AL","1988-11-30",1988,11,335,0,11900,9430,21330
"AL","1988-12-01",1988,12,336,0,11800,9550,21350
"AL","1988-12-02",1988,12,337,219,11700,9580,21499
"AL","1988-12-03",1988,12,338,0,11600,9590,21190
"AL","1988-12-04",1988,12,339,0,11600,9610,21210
"AL","1988-12-05",1988,12,340,0,11500,9620,21120
"AL","1988-12-06",1988,12,341,0,11500,9630,21130
"AL","1988-12-07",1988,12,342,0,11400,9640,21040
"AL","1988-12-08",1988,12,343,85.5,14500,11000,25585.5
"AL","1988-12-09",1988,12,344,0,11800,9640,21440
"AL","1988-12-10",1988,12,345,0,11500,9630,21130
"AL","1988-12-11",1988,12,346,0,11400,9630,21030
"AL","1988-12-12",1988,12,347,0,11400,9630,21030
"AL","1988-12-13",1988,12,348,0,11400,9630,21030
"AL","1988-12-14",1988,12,349,7190,11300,9490,27980
"AL","1988-12-15",1988,12,350,11700,11300,9300,32300
"AL","1988-12-16",1988,12,351,304,11200,9360,20864
"AL","1988-12-17",1988,12,352,0,11200,9460,20660
"AL","1988-12-18",1988,12,353,1130,11200,9470,21800
"AL","1988-12-19",1988,12,354,2460,11100,9460,23020
"AL","1988-12-20",1988,12,355,0,11100,9490,20590
"AL","1988-12-21",1988,12,356,17100,11100,9220,37420
"AL","1988-12-22",1988,12,357,2200,11100,9240,22540
"AL","1988-12-23",1988,12,358,0,11100,9370,20470
"AL","1988-12-24",1988,12,359,6140,11100,9310,26550
"AL","1988-12-25",1988,12,360,0,11000,9360,20360
"AL","1988-12-26",1988,12,361,85.5,11000,9420,20505.5
"AL","1988-12-27",1988,12,362,0,11000,9450,20450
"AL","1988-12-28",1988,12,363,11500,11000,9270,31770
"AL","1988-12-29",1988,12,364,0,11000,9310,20310
"AL","1988-12-30",1988,12,365,0,11000,9400,20400
"AL","1988-12-31",1988,12,366,0,11000,9440,20440
"AL","1989-01-01",1989,1,1,0,11000,9460,20460
"AL","1989-01-02",1989,1,2,0,11000,9490,20490
"AL","1989-01-03",1989,1,3,1560,10900,9480,21940
"AL","1989-01-04",1989,1,4,5060,10900,9400,25360
"AL","1989-01-05",1989,1,5,1750,10900,9400,22050
"AL","1989-01-06",1989,1,6,143,10900,9440,20483
"AL","1989-01-07",1989,1,7,0,10900,9480,20380
"AL","1989-01-08",1989,1,8,545,10900,9490,20935
"AL","1989-01-09",1989,1,9,19800,10900,9150,39850
"AL","1989-01-10",1989,1,10,856,10800,9180,20836
"AL","1989-01-11",1989,1,11,506,10800,9300,20606
"AL","1989-01-12",1989,1,12,0,10800,9350,20150
"AL","1989-01-13",1989,1,13,1050,10800,9370,21220
"AL","1989-01-14",1989,1,14,0,10800,9400,20200
"AL","1989-01-15",1989,1,15,0,10800,9430,20230
"AL","1989-01-16",1989,1,16,0,10800,9460,20260
"AL","1989-01-17",1989,1,17,285,10700,9480,20465
"AL","1989-01-18",1989,1,18,365,10700,9480,20545
"AL","1989-01-19",1989,1,19,12300,10700,9270,32270
"AL","1989-01-20",1989,1,20,0,10700,9310,20010
"AL","1989-01-21",1989,1,21,2510,10700,9350,22560
"AL","1989-01-22",1989,1,22,0,10700,9380,20080
"AL","1989-01-23",1989,1,23,0,10700,9420,20120
"AL","1989-01-24",1989,1,24,0,10600,9450,20050
"AL","1989-01-25",1989,1,25,0,10600,9470,20070
"AL","1989-01-26",1989,1,26,0,10600,9480,20080
"AL","1989-01-27",1989,1,27,6100,10600,9370,26070
"AL","1989-01-28",1989,1,28,0,10600,9390,19990
"AL","1989-01-29",1989,1,29,0,10600,9440,20040
"AL","1989-01-30",1989,1,30,0,10600,9460,20060
"AL","1989-01-31",1989,1,31,0,10500,9480,19980
"AL","1989-02-01",1989,2,32,0,10500,9490,19990
"AL","1989-02-02",1989,2,33,219,10500,9480,20199
"AL","1989-02-03",1989,2,34,1510,10500,9440,21450
"AL","1989-02-04",1989,2,35,1160,10500,9410,21070
"AL","1989-02-05",1989,2,36,0,10500,9420,19920
"AL","1989-02-06",1989,2,37,0,10500,9420,19920
"AL","1989-02-07",1989,2,38,0,10400,9420,19820
"AL","1989-02-08",1989,2,39,0,10400,9420,19820
"AL","1989-02-09",1989,2,40,1160,10400,9390,20950
"AL","1989-02-10",1989,2,41,0,10400,9390,19790
"AL","1989-02-11",1989,2,42,85.7,10400,9390,19875.7
"AL","1989-02-12",1989,2,43,85.7,10400,9380,19865.7
"AL","1989-02-13",1989,2,44,0,10400,9380,19780
"AL","1989-02-14",1989,2,45,0,10300,9380,19680
"AL","1989-02-15",1989,2,46,134,10300,9370,19804
"AL","1989-02-16",1989,2,47,0,10300,9360,19660
"AL","1989-02-17",1989,2,48,0,10300,9350,19650
"AL","1989-02-18",1989,2,49,0,10300,9340,19640
"AL","1989-02-19",1989,2,50,0,10300,9330,19630
"AL","1989-02-20",1989,2,51,0,10200,9320,19520
"AL","1989-02-21",1989,2,52,0,10200,9310,19510
"AL","1989-02-22",1989,2,53,0,10200,9300,19500
"AL","1989-02-23",1989,2,54,0,10200,9290,19490
"AL","1989-02-24",1989,2,55,0,10200,9280,19480
"AL","1989-02-25",1989,2,56,0,10200,9270,19470
"AL","1989-02-26",1989,2,57,1350,10100,9240,20690
"AL","1989-02-27",1989,2,58,3730,10100,9170,23000
"AL","1989-02-28",1989,2,59,953,10100,9160,20213
"AL","1989-03-01",1989,3,60,4810,10100,9090,24000
"AL","1989-03-02",1989,3,61,1910,10100,9070,21080
"AL","1989-03-03",1989,3,62,0,10000,9100,19100
"AL","1989-03-04",1989,3,63,3130,10000,9060,22190
"AL","1989-03-05",1989,3,64,22200,10000,8700,40900
"AL","1989-03-06",1989,3,65,2290,9990,8720,21000
"AL","1989-03-07",1989,3,66,0,9980,8860,18840
"AL","1989-03-08",1989,3,67,0,9960,8920,18880
"AL","1989-03-09",1989,3,68,0,9940,8960,18900
"AL","1989-03-10",1989,3,69,157,9930,9000,19087
"AL","1989-03-11",1989,3,70,0,9910,9030,18940
"AL","1989-03-12",1989,3,71,0,9890,9070,18960
"AL","1989-03-13",1989,3,72,0,9870,9090,18960
"AL","1989-03-14",1989,3,73,0,9850,9120,18970
"AL","1989-03-15",1989,3,74,1250,9840,9110,20200
"AL","1989-03-16",1989,3,75,52100,9830,8260,70190
"AL","1989-03-17",1989,3,76,0,9820,8320,18140
"AL","1989-03-18",1989,3,77,0,9800,8600,18400
"AL","1989-03-19",1989,3,78,0,9790,8680,18470
"AL","1989-03-20",1989,3,79,0,9770,8740,18510
"AL","1989-03-21",1989,3,80,472,9760,8790,19022
"AL","1989-03-22",1989,3,81,0,9740,8820,18560
"AL","1989-03-23",1989,3,82,0,9720,8850,18570
"AL","1989-03-24",1989,3,83,0,9700,8920,18620
"AL","1989-03-25",1989,3,84,315,9680,8970,18965
"AL","1989-03-26",1989,3,85,0,9660,9010,18670
"AL","1989-03-27",1989,3,86,0,10300,9170,19470
"AL","1989-03-28",1989,3,87,0,13900,17100,31000
"AL","1989-03-29",1989,3,88,0,16300,21800,38100
"AL","1989-03-30",1989,3,89,0,12500,11700,24200
"AL","1989-03-31",1989,3,90,0,11700,9740,21440
"AL","1989-04-01",1989,4,91,0,11100,9330,20430
"AL","1989-04-02",1989,4,92,0,10900,9290,20190
"AL","1989-04-03",1989,4,93,2700,11300,12500,26500
"AL","1989-04-04",1989,4,94,0,13500,14700,28200
"AL","1989-04-05",1989,4,95,17400,14400,15300,47100
"AL","1989-04-06",1989,4,96,1090,16800,17800,35690
"AL","1989-04-07",1989,4,97,0,13600,11500,25100
"AL","1989-04-08",1989,4,98,0,13000,11100,24100
"AL","1989-04-09",1989,4,99,0,13200,10500,23700
"AL","1989-04-10",1989,4,100,4000,11900,9640,25540
"AL","1989-04-11",1989,4,101,256,11600,9510,21366
"AL","1989-04-12",1989,4,102,1050,11500,9530,22080
"AL","1989-04-13",1989,4,103,4520,12000,9640,26160
"AL","1989-04-14",1989,4,104,0,11400,9510,20910
"AL","1989-04-15",1989,4,105,3160,14200,16300,33660
"AL","1989-04-16",1989,4,106,0,11400,13300,24700
"AL","1989-04-17",1989,4,107,0,11100,15600,26700
"AL","1989-04-18",1989,4,108,6560,11800,22200,40560
"AL","1989-04-19",1989,4,109,0,11000,10300,21300
"AL","1989-04-20",1989,4,110,0,10900,9930,20830
"AL","1989-04-21",1989,4,111,0,10800,9920,20720
"AL","1989-04-22",1989,4,112,6230,11700,9910,27840
"AL","1989-04-23",1989,4,113,0,10700,9820,20520
"AL","1989-04-24",1989,4,114,0,10600,9810,20410
"AL","1989-04-25",1989,4,115,0,10500,9760,20260
"AL","1989-04-26",1989,4,116,3160,10500,9780,23440
"AL","1989-04-27",1989,4,117,3890,10700,9810,24400
"AL","1989-04-28",1989,4,118,1090,10500,9730,21320
"AL","1989-04-29",1989,4,119,1260,10200,9760,21220
"AL","1989-04-30",1989,4,120,2960,10600,9710,23270
"AL","1989-05-01",1989,5,121,4920,11100,9780,25800
"AL","1989-05-02",1989,5,122,0,10200,9620,19820
"AL","1989-05-03",1989,5,123,415,10200,9620,20235
"AL","1989-05-04",1989,5,124,254,10200,9660,20114
"AL","1989-05-05",1989,5,125,0,10100,9710,19810
"AL","1989-05-06",1989,5,126,16900,12900,11100,40900
"AL","1989-05-07",1989,5,127,1150,10400,9440,20990
"AL","1989-05-08",1989,5,128,0,10300,9540,19840
"AL","1989-05-09",1989,5,129,0,10100,9580,19680
"AL","1989-05-10",1989,5,130,0,9690,9550,19240
"AL","1989-05-11",1989,5,131,0,9370,9530,18900
"AL","1989-05-12",1989,5,132,0,9090,9490,18580
"AL","1989-05-13",1989,5,133,0,8970,9430,18400
"AL","1989-05-14",1989,5,134,11100,8880,9340,29320
"AL","1989-05-15",1989,5,135,4530,9160,9220,22910
"AL","1989-05-16",1989,5,136,1960,9100,9250,20310
"AL","1989-05-17",1989,5,137,0,8760,9260,18020
"AL","1989-05-18",1989,5,138,0,8720,9280,18000
"AL","1989-05-19",1989,5,139,4060,8690,9200,21950
"AL","1989-05-20",1989,5,140,22400,10400,9010,41810
"AL","1989-05-21",1989,5,141,24800,12400,8990,46190
"AL","1989-05-22",1989,5,142,1020,10300,8820,20140
"AL","1989-05-23",1989,5,143,0,9500,9040,18540
"AL","1989-05-24",1989,5,144,2770,9060,9050,20880
"AL","1989-05-25",1989,5,145,20700,9240,9050,38990
"AL","1989-05-26",1989,5,146,47200,20700,16000,83900
"AL","1989-05-27",1989,5,147,1390,10800,8650,20840
"AL","1989-05-28",1989,5,148,508,10500,8860,19868
"AL","1989-05-29",1989,5,149,0,10300,9000,19300
"AL","1989-05-30",1989,5,150,12000,9860,9060,30920
"AL","1989-05-31",1989,5,151,27700,13400,12800,53900
"AL","1989-06-01",1989,6,152,10300,14000,11600,35900
"AL","1989-06-02",1989,6,153,1590,10800,8930,21320
"AL","1989-06-03",1989,6,154,6840,10900,9130,26870
"AL","1989-06-04",1989,6,155,7140,11200,9150,27490
"AL","1989-06-05",1989,6,156,0,10200,9110,19310
"AL","1989-06-06",1989,6,157,920,10000,9190,20110
"AL","1989-06-07",1989,6,158,4140,10000,9190,23330
"AL","1989-06-08",1989,6,159,40500,9500,15500,65500
"AL","1989-06-09",1989,6,160,38100,17200,21200,76500
"AL","1989-06-10",1989,6,161,7530,11900,9910,29340
"AL","1989-06-11",1989,6,162,0,10800,9290,20090
"AL","1989-06-12",1989,6,163,552,10400,9460,20412
"AL","1989-06-13",1989,6,164,16300,10500,9540,36340
"AL","1989-06-14",1989,6,165,17300,12500,11800,41600
"AL","1989-06-15",1989,6,166,3960,11100,9460,24520
"AL","1989-06-16",1989,6,167,8100,12600,10300,31000
"AL","1989-06-17",1989,6,168,253,10600,9530,20383
"AL","1989-06-18",1989,6,169,0,10100,9590,19690
"AL","1989-06-19",1989,6,170,552,9680,9580,19812
"AL","1989-06-20",1989,6,171,0,9490,9520,19010
"AL","1989-06-21",1989,6,172,0,9350,9460,18810
"AL","1989-06-22",1989,6,173,6440,9230,9380,25050
"AL","1989-06-23",1989,6,174,19800,9720,9270,38790
"AL","1989-06-24",1989,6,175,22600,13000,9250,44850
"AL","1989-06-25",1989,6,176,1660,10400,9070,21130
"AL","1989-06-26",1989,6,177,920,9790,9250,19960
"AL","1989-06-27",1989,6,178,14100,9890,9290,33280
"AL","1989-06-28",1989,6,179,9120,10300,9260,28680
"AL","1989-06-29",1989,6,180,0,9500,9280,18780
"AL","1989-06-30",1989,6,181,0,9300,9390,18690
"AL","1989-07-01",1989,7,182,22300,9720,9490,41510
"AL","1989-07-02",1989,7,183,19900,11900,9760,41560
"AL","1989-07-03",1989,7,184,0,9820,9300,19120
"AL","1989-07-04",1989,7,185,0,9340,9570,18910
"AL","1989-07-05",1989,7,186,0,9090,9690,18780
"AL","1989-07-06",1989,7,187,0,9040,9740,18780
"AL","1989-07-07",1989,7,188,0,9000,9800,18800
"AL","1989-07-08",1989,7,189,0,8960,9810,18770
"AL","1989-07-09",1989,7,190,0,8930,9760,18690
"AL","1989-07-10",1989,7,191,0,8900,9830,18730
"AL","1989-07-11",1989,7,192,0,8870,9870,18740
"AL","1989-07-12",1989,7,193,583,8840,9760,19183
"AL","1989-07-13",1989,7,194,0,8810,9650,18460
"AL","1989-07-14",1989,7,195,0,8780,9630,18410
"AL","1989-07-15",1989,7,196,0,8750,9660,18410
"AL","1989-07-16",1989,7,197,0,8720,9690,18410
"AL","1989-07-17",1989,7,198,0,8700,9700,18400
"AL","1989-07-18",1989,7,199,5690,9080,9620,24390
"AL","1989-07-19",1989,7,200,1170,8660,9500,19330
"AL","1989-07-20",1989,7,201,4820,9050,9380,23250
"AL","1989-07-21",1989,7,202,0,8620,9410,18030
"AL","1989-07-22",1989,7,203,0,8590,9490,18080
"AL","1989-07-23",1989,7,204,0,8670,9510,18180
"AL","1989-07-24",1989,7,205,0,8550,9520,18070
"AL","1989-07-25",1989,7,206,0,8630,9490,18120
"AL","1989-07-26",1989,7,207,0,8510,9440,17950
"AL","1989-07-27",1989,7,208,583,8600,9340,18523
"AL","1989-07-28",1989,7,209,3150,8640,9230,21020
"AL","1989-07-29",1989,7,210,0,8460,9160,17620
"AL","1989-07-30",1989,7,211,4360,8590,9070,22020
"AL","1989-07-31",1989,7,212,9180,9400,8930,27510
"AL","1989-08-01",1989,8,213,0,8700,8870,17570
"AL","1989-08-02",1989,8,214,0,8580,8980,17560
"AL","1989-08-03",1989,8,215,0,8410,9000,17410
"AL","1989-08-04",1989,8,216,0,8510,9000,17510
"AL","1989-08-05",1989,8,217,6870,8760,8930,24560
"AL","1989-08-06",1989,8,218,526,8370,9000,17896
"AL","1989-08-07",1989,8,219,0,8450,9060,17510
"AL","1989-08-08",1989,8,220,0,8330,8970,17300
"AL","1989-08-09",1989,8,221,0,8440,8900,17340
"AL","1989-08-10",1989,8,222,0,8350,8970,17320
"AL","1989-08-11",1989,8,223,0,8290,9040,17330
"AL","1989-08-12",1989,8,224,0,8370,9070,17440
"AL","1989-08-13",1989,8,225,57400,13600,8950,79950
"AL","1989-08-14",1989,8,226,26500,14600,10000,51100
"AL","1989-08-15",1989,8,227,81300,35800,42100,159200
"AL","1989-08-16",1989,8,228,7030,16200,16200,39430
"AL","1989-08-17",1989,8,229,0,12500,9050,21550
"AL","1989-08-18",1989,8,230,0,11700,8840,20540
"AL","1989-08-19",1989,8,231,0,11400,8940,20340
"AL","1989-08-20",1989,8,232,14900,11200,9000,35100
"AL","1989-08-21",1989,8,233,19800,13900,9980,43680
"AL","1989-08-22",1989,8,234,702,11400,8940,21042
"AL","1989-08-23",1989,8,235,18100,15400,12300,45800
"AL","1989-08-24",1989,8,236,0,11600,8960,20560
"AL","1989-08-25",1989,8,237,0,11300,9140,20440
"AL","1989-08-26",1989,8,238,0,10900,9170,20070
"AL","1989-08-27",1989,8,239,1400,10600,9180,21180
"AL","1989-08-28",1989,8,240,3210,10600,9200,23010
"AL","1989-08-29",1989,8,241,0,10300,9210,19510
"AL","1989-08-30",1989,8,242,0,10200,9270,19470
"AL","1989-08-31",1989,8,243,0,9980,9270,19250
"AL","1989-09-01",1989,9,244,77000,20900,22800,120700
"AL","1989-09-02",1989,9,245,12800,16100,13200,42100
"AL","1989-09-03",1989,9,246,303,12000,9030,21333
"AL","1989-09-04",1989,9,247,0,11700,9220,20920
"AL","1989-09-05",1989,9,248,7910,11500,9390,28800
"AL","1989-09-06",1989,9,249,12400,13100,10100,35600
"AL","1989-09-07",1989,9,250,0,11500,9390,20890
"AL","1989-09-08",1989,9,251,0,11100,9520,20620
"AL","1989-09-09",1989,9,252,17900,17700,11200,46800
"AL","1989-09-10",1989,9,253,549,11700,9370,21619
"AL","1989-09-11",1989,9,254,0,11400,9480,20880
"AL","1989-09-12",1989,9,255,0,11100,9520,20620
"AL","1989-09-13",1989,9,256,0,10800,9530,20330
"AL","1989-09-14",1989,9,257,0,10700,9530,20230
"AL","1989-09-15",1989,9,258,0,10500,9540,20040
"AL","1989-09-16",1989,9,259,0,10400,9540,19940
"AL","1989-09-17",1989,9,260,0,10300,9550,19850
"AL","1989-09-18",1989,9,261,0,10200,9560,19760
"AL","1989-09-19",1989,9,262,0,10100,9570,19670
"AL","1989-09-20",1989,9,263,549,9910,9550,20009
"AL","1989-09-21",1989,9,264,0,9770,9540,19310
"AL","1989-09-22",1989,9,265,0,9660,9530,19190
"AL","1989-09-23",1989,9,266,1310,9610,9480,20400
"AL","1989-09-24",1989,9,267,151,9540,9420,19111
"AL","1989-09-25",1989,9,268,0,9570,9380,18950
"AL","1989-09-26",1989,9,269,0,9690,9370,19060
"AL","1989-09-27",1989,9,270,0,9670,9350,19020
"AL","1989-09-28",1989,9,271,0,9640,9330,18970
"AL","1989-09-29",1989,9,272,0,9640,9330,18970
"AL","1989-09-30",1989,9,273,0,9600,9320,18920
"AL","1989-10-01",1989,10,274,0,9530,9310,18840
"AL","1989-10-02",1989,10,275,0,9510,9290,18800
"AL","1989-10-03",1989,10,276,6790,9820,9120,25730
"AL","1989-10-04",1989,10,277,0,9740,9070,18810
"AL","1989-10-05",1989,10,278,0,9770,9110,18880
"AL","1989-10-06",1989,10,279,6590,10000,9050,25640
"AL","1989-10-07",1989,10,280,9130,11100,9050,29280
"AL","1989-10-08",1989,10,281,0,10300,9050,19350
"AL","1989-10-09",1989,10,282,0,10100,9120,19220
"AL","1989-10-10",1989,10,283,0,10100,9140,19240
"AL","1989-10-11",1989,10,284,13800,11300,9340,34440
"AL","1989-10-12",1989,10,285,151,10500,9050,19701
"AL","1989-10-13",1989,10,286,0,10300,9140,19440
"AL","1989-10-14",1989,10,287,0,10200,9150,19350
"AL","1989-10-15",1989,10,288,151,10200,9130,19481
"AL","1989-10-16",1989,10,289,0,10200,9110,19310
"AL","1989-10-17",1989,10,290,1310,10300,9090,20700
"AL","1989-10-18",1989,10,291,0,10200,9090,19290
"AL","1989-10-19",1989,10,292,0,10200,9100,19300
"AL","1989-10-20",1989,10,293,0,10200,9110,19310
"AL","1989-10-21",1989,10,294,0,10200,9130,19330
"AL","1989-10-22",1989,10,295,0,10100,9150,19250
"AL","1989-10-23",1989,10,296,0,10100,9170,19270
"AL","1989-10-24",1989,10,297,0,10100,9190,19290
"AL","1989-10-25",1989,10,298,0,10100,9210,19310
"AL","1989-10-26",1989,10,299,151,10100,9220,19471
"AL","1989-10-27",1989,10,300,0,10100,9250,19350
"AL","1989-10-28",1989,10,301,0,10100,9260,19360
"AL","1989-10-29",1989,10,302,0,10100,9260,19360
"AL","1989-10-30",1989,10,303,15500,12200,9670,37370
"AL","1989-10-31",1989,10,304,5930,10800,9250,25980
"AL","1989-11-01",1989,11,305,22100,13500,9940,45540
"AL","1989-11-02",1989,11,306,8410,11000,8810,28220
"AL","1989-11-03",1989,11,307,7100,11000,8780,26880
"AL","1989-11-04",1989,11,308,475,10900,8890,20265
"AL","1989-11-05",1989,11,309,12300,10800,8760,31860
"AL","1989-11-06",1989,11,310,13400,11400,8980,33780
"AL","1989-11-07",1989,11,311,6810,12900,13000,32710
"AL","1989-11-08",1989,11,312,9240,12000,10200,31440
"AL","1989-11-09",1989,11,313,674,15000,16800,32474
"AL","1989-11-10",1989,11,314,1390,14800,16000,32190
"AL","1989-11-11",1989,11,315,237,12400,9920,22557
"AL","1989-11-12",1989,11,316,2590,12300,9560,24450
"AL","1989-11-13",1989,11,317,0,11500,9180,20680
"AL","1989-11-14",1989,11,318,0,11400,9210,20610
"AL","1989-11-15",1989,11,319,0,11300,9210,20510
"AL","1989-11-16",1989,11,320,14300,11300,8940,34540
"AL","1989-11-17",1989,11,321,4110,11200,8900,24210
"AL","1989-11-18",1989,11,322,1190,11100,8990,21280
"AL","1989-11-19",1989,11,323,2360,11100,9020,22480
"AL","1989-11-20",1989,11,324,0,11000,9070,20070
"AL","1989-11-21",1989,11,325,0,11000,9150,20150
"AL","1989-11-22",1989,11,326,2760,10900,9140,22800
"AL","1989-11-23",1989,11,327,1060,10900,9160,21120
"AL","1989-11-24",1989,11,328,0,10800,9190,19990
"AL","1989-11-25",1989,11,329,0,10800,9220,20020
"AL","1989-11-26",1989,11,330,0,10700,9250,19950
"AL","1989-11-27",1989,11,331,0,10700,9290,19990
"AL","1989-11-28",1989,11,332,5910,11000,9350,26260
"AL","1989-11-29",1989,11,333,12000,10800,9060,31860
"AL","1989-11-30",1989,11,334,0,10700,9090,19790
"AL","1989-12-01",1989,12,335,0,10700,9190,19890
"AL","1989-12-02",1989,12,336,0,10600,9230,19830
"AL","1989-12-03",1989,12,337,1640,10600,9210,21450
"AL","1989-12-04",1989,12,338,133,10600,9220,19953
"AL","1989-12-05",1989,12,339,0,10600,9240,19840
"AL","1989-12-06",1989,12,340,0,10500,9250,19750
"AL","1989-12-07",1989,12,341,352,10500,9250,20102
"AL","1989-12-08",1989,12,342,0,10500,9250,19750
"AL","1989-12-09",1989,12,343,0,10500,9250,19750
"AL","1989-12-10",1989,12,344,2610,10400,9210,22220
"AL","1989-12-11",1989,12,345,171,10400,9210,19781
"AL","1989-12-12",1989,12,346,133,10400,9220,19753
"AL","1989-12-13",1989,12,347,219,10400,9220,19839
"AL","1989-12-14",1989,12,348,0,10300,9210,19510
"AL","1989-12-15",1989,12,349,6530,10300,9100,25930
"AL","1989-12-16",1989,12,350,1310,10300,9080,20690
"AL","1989-12-17",1989,12,351,0,10300,9120,19420
"AL","1989-12-18",1989,12,352,704,10200,9130,20034
"AL","1989-12-19",1989,12,353,85.5,10200,9120,19405.5
"AL","1989-12-20",1989,12,354,0,10200,9130,19330
"AL","1989-12-21",1989,12,355,0,10200,9140,19340
"AL","1989-12-22",1989,12,356,0,10100,9130,19230
"AL","1989-12-23",1989,12,357,0,10100,9130,19230
"AL","1989-12-24",1989,12,358,0,10100,9120,19220
"AL","1989-12-25",1989,12,359,523,10100,9110,19733
"AL","1989-12-26",1989,12,360,3610,10000,9040,22650
"AL","1989-12-27",1989,12,361,2200,10000,9000,21200
"AL","1989-12-28",1989,12,362,85.5,9990,9030,19105.5
"AL","1989-12-29",1989,12,363,0,9970,9030,19000
"AL","1989-12-30",1989,12,364,5790,9950,8940,24680
"AL","1989-12-31",1989,12,365,0,9920,8950,18870
"AL","1990-01-01",1990,1,1,998,9900,8960,19858
"AL","1990-01-02",1990,1,2,1080,9880,8960,19920
"AL","1990-01-03",1990,1,3,0,9860,8970,18830
"AL","1990-01-04",1990,1,4,0,9840,8990,18830
"AL","1990-01-05",1990,1,5,0,9810,9010,18820
"AL","1990-01-06",1990,1,6,0,9790,9000,18790
"AL","1990-01-07",1990,1,7,0,9770,9000,18770
"AL","1990-01-08",1990,1,8,0,9750,8990,18740
"AL","1990-01-09",1990,1,9,0,9720,9000,18720
"AL","1990-01-10",1990,1,10,0,9700,9000,18700
"AL","1990-01-11",1990,1,11,0,9680,8990,18670
"AL","1990-01-12",1990,1,12,3920,9660,8920,22500
"AL","1990-01-13",1990,1,13,3470,9640,8850,21960
"AL","1990-01-14",1990,1,14,0,9620,8870,18490
"AL","1990-01-15",1990,1,15,0,9610,8880,18490
"AL","1990-01-16",1990,1,16,0,9590,8890,18480
"AL","1990-01-17",1990,1,17,0,9570,8890,18460
"AL","1990-01-18",1990,1,18,957,9550,8880,19387
"AL","1990-01-19",1990,1,19,860,9530,8860,19250
"AL","1990-01-20",1990,1,20,0,9510,8860,18370
"AL","1990-01-21",1990,1,21,0,9500,8850,18350
"AL","1990-01-22",1990,1,22,0,9480,8850,18330
"AL","1990-01-23",1990,1,23,4920,9460,8750,23130
"AL","1990-01-24",1990,1,24,0,9450,8760,18210
"AL","1990-01-25",1990,1,25,17700,9440,8480,35620
"AL","1990-01-26",1990,1,26,0,9420,8520,17940
"AL","1990-01-27",1990,1,27,1030,9410,8610,19050
"AL","1990-01-28",1990,1,28,0,9390,8630,18020
"AL","1990-01-29",1990,1,29,10200,9380,8480,28060
"AL","1990-01-30",1990,1,30,0,9360,8510,17870
"AL","1990-01-31",1990,1,31,0,9350,8600,17950
"AL","1990-02-01",1990,2,32,0,9330,8630,17960
"AL","1990-02-02",1990,2,33,0,9320,8630,17950
"AL","1990-02-03",1990,2,34,0,9300,8640,17940
"AL","1990-02-04",1990,2,35,1350,9280,8620,19250
"AL","1990-02-05",1990,2,36,429,9260,8620,18309
"AL","1990-02-06",1990,2,37,0,9250,8630,17880
"AL","1990-02-07",1990,2,38,0,9230,8650,17880
"AL","1990-02-08",1990,2,39,0,9220,8650,17870
"AL","1990-02-09",1990,2,40,0,9200,8650,17850
"AL","1990-02-10",1990,2,41,0,9180,8650,17830
"AL","1990-02-11",1990,2,42,0,9170,8640,17810
"AL","1990-02-12",1990,2,43,0,9150,8640,17790
"AL","1990-02-13",1990,2,44,85.7,9130,8630,17845.7
"AL","1990-02-14",1990,2,45,0,9120,8620,17740
"AL","1990-02-15",1990,2,46,0,9100,8620,17720
"AL","1990-02-16",1990,2,47,0,9080,8600,17680
"AL","1990-02-17",1990,2,48,9590,9070,8430,27090
"AL","1990-02-18",1990,2,49,1970,9050,8410,19430
"AL","1990-02-19",1990,2,50,0,9040,8460,17500
"AL","1990-02-20",1990,2,51,0,9020,8490,17510
"AL","1990-02-21",1990,2,52,0,9010,8500,17510
"AL","1990-02-22",1990,2,53,0,8990,8500,17490
"AL","1990-02-23",1990,2,54,0,8980,8510,17490
"AL","1990-02-24",1990,2,55,0,8960,8510,17470
"AL","1990-02-25",1990,2,56,3910,8940,8430,21280
"AL","1990-02-26",1990,2,57,85.7,8930,8430,17445.7
"AL","1990-02-27",1990,2,58,1630,8910,8430,18970
"AL","1990-02-28",1990,2,59,984,8890,8420,18294
"AL","1990-03-01",1990,3,60,85.7,8880,8430,17395.7
"AL","1990-03-02",1990,3,61,0,8860,8480,17340
"AL","1990-03-03",1990,3,62,0,8840,8510,17350
"AL","1990-03-04",1990,3,63,0,8830,8510,17340
"AL","1990-03-05",1990,3,64,2740,8810,8430,19980
"AL","1990-03-06",1990,3,65,0,8800,8420,17220
"AL","1990-03-07",1990,3,66,0,8780,8440,17220
"AL","1990-03-08",1990,3,67,0,8760,8460,17220
"AL","1990-03-09",1990,3,68,345,8750,8470,17565
"AL","1990-03-10",1990,3,69,7550,8730,8310,24590
"AL","1990-03-11",1990,3,70,0,8720,8350,17070
"AL","1990-03-12",1990,3,71,3050,11200,15000,29250
"AL","1990-03-13",1990,3,72,18500,50700,61600,130800
"AL","1990-03-14",1990,3,73,0,17800,26300,44100
"AL","1990-03-15",1990,3,74,9730,18400,14600,42730
"AL","1990-03-16",1990,3,75,2550,12700,10500,25750
"AL","1990-03-17",1990,3,76,0,11300,8730,20030
"AL","1990-03-18",1990,3,77,6000,11900,8620,26520
"AL","1990-03-19",1990,3,78,2630,11200,8600,22430
"AL","1990-03-20",1990,3,79,0,11000,8680,19680
"AL","1990-03-21",1990,3,80,0,10700,8760,19460
"AL","1990-03-22",1990,3,81,345,10600,8880,19825
"AL","1990-03-23",1990,3,82,0,10300,8820,19120
"AL","1990-03-24",1990,3,83,0,10200,8790,18990
"AL","1990-03-25",1990,3,84,0,10100,8730,18830
"AL","1990-03-26",1990,3,85,0,10000,8740,18740
"AL","1990-03-27",1990,3,86,0,9930,8790,18720
"AL","1990-03-28",1990,3,87,0,9850,8820,18670
"AL","1990-03-29",1990,3,88,0,9780,8860,18640
"AL","1990-03-30",1990,3,89,0,9720,8920,18640
"AL","1990-03-31",1990,3,90,0,9660,8990,18650
"AL","1990-04-01",1990,4,91,0,9600,9040,18640
"AL","1990-04-02",1990,4,92,3790,9550,9060,22400
"AL","1990-04-03",1990,4,93,19000,10900,8950,38850
"AL","1990-04-04",1990,4,94,0,9780,8710,18490
"AL","1990-04-05",1990,4,95,0,10800,9690,20490
"AL","1990-04-06",1990,4,96,0,10100,8960,19060
"AL","1990-04-07",1990,4,97,0,9640,8780,18420
"AL","1990-04-08",1990,4,98,0,9580,8770,18350
"AL","1990-04-09",1990,4,99,0,9540,8760,18300
"AL","1990-04-10",1990,4,100,2860,9560,8760,21180
"AL","1990-04-11",1990,4,101,1470,9790,8710,19970
"AL","1990-04-12",1990,4,102,0,9450,8680,18130
"AL","1990-04-13",1990,4,103,0,9320,8660,17980
"AL","1990-04-14",1990,4,104,0,9300,8650,17950
"AL","1990-04-15",1990,4,105,0,9270,8640,17910
"AL","1990-04-16",1990,4,106,5280,9370,8670,23320
"AL","1990-04-17",1990,4,107,0,9200,8610,17810
"AL","1990-04-18",1990,4,108,3680,9800,8640,22120
"AL","1990-04-19",1990,4,109,0,9190,8610,17800
"AL","1990-04-20",1990,4,110,0,9160,8630,17790
"AL","1990-04-21",1990,4,111,0,9140,8650,17790
"AL","1990-04-22",1990,4,112,0,9120,8670,17790
"AL","1990-04-23",1990,4,113,0,9100,8700,17800
"AL","1990-04-24",1990,4,114,0,9080,8730,17810
"AL","1990-04-25",1990,4,115,9750,10800,9000,29550
"AL","1990-04-26",1990,4,116,996,9430,8580,19006
"AL","1990-04-27",1990,4,117,0,9110,8600,17710
"AL","1990-04-28",1990,4,118,26100,12200,12700,51000
"AL","1990-04-29",1990,4,119,26200,13700,16700,56600
"AL","1990-04-30",1990,4,120,9210,10900,9490,29600
"AL","1990-05-01",1990,5,121,3650,10200,8320,22170
"AL","1990-05-02",1990,5,122,0,9770,8380,18150
"AL","1990-05-03",1990,5,123,0,9680,8380,18060
"AL","1990-05-04",1990,5,124,0,9600,8410,18010
"AL","1990-05-05",1990,5,125,0,9520,8490,18010
"AL","1990-05-06",1990,5,126,0,9460,8560,18020
"AL","1990-05-07",1990,5,127,0,9400,8600,18000
"AL","1990-05-08",1990,5,128,0,9360,8660,18020
"AL","1990-05-09",1990,5,129,0,8780,8750,17530
"AL","1990-05-10",1990,5,130,29000,9870,9290,48160
"AL","1990-05-11",1990,5,131,42000,9770,8990,60760
"AL","1990-05-12",1990,5,132,0,9840,11300,21140
"AL","1990-05-13",1990,5,133,0,12800,15500,28300
"AL","1990-05-14",1990,5,134,0,12400,9270,21670
"AL","1990-05-15",1990,5,135,13100,12200,9070,34370
"AL","1990-05-16",1990,5,136,19400,15300,13800,48500
"AL","1990-05-17",1990,5,137,82200,33900,44200,160300
"AL","1990-05-18",1990,5,138,2700,14400,16600,33700
"AL","1990-05-19",1990,5,139,3140,12300,9420,24860
"AL","1990-05-20",1990,5,140,0,11700,9330,21030
"AL","1990-05-21",1990,5,141,19500,17500,14300,51300
"AL","1990-05-22",1990,5,142,0,11900,9540,21440
"AL","1990-05-23",1990,5,143,0,11200,9560,20760
"AL","1990-05-24",1990,5,144,23900,17100,13600,54600
"AL","1990-05-25",1990,5,145,0,11700,9400,21100
"AL","1990-05-26",1990,5,146,0,11200,9530,20730
"AL","1990-05-27",1990,5,147,10500,11200,9570,31270
"AL","1990-05-28",1990,5,148,13200,12400,10100,35700
"AL","1990-05-29",1990,5,149,0,10900,9450,20350
"AL","1990-05-30",1990,5,150,0,10400,9510,19910
"AL","1990-05-31",1990,5,151,0,9920,9440,19360
"AL","1990-06-01",1990,6,152,0,9770,9400,19170
"AL","1990-06-02",1990,6,153,1330,9640,9350,20320
"AL","1990-06-03",1990,6,154,0,9480,9300,18780
"AL","1990-06-04",1990,6,155,33200,12500,9280,54980
"AL","1990-06-05",1990,6,156,4670,10400,8970,24040
"AL","1990-06-06",1990,6,157,3730,10500,9130,23360
"AL","1990-06-07",1990,6,158,21800,14400,9540,45740
"AL","1990-06-08",1990,6,159,0,10700,9060,19760
"AL","1990-06-09",1990,6,160,828,10200,9180,20208
"AL","1990-06-10",1990,6,161,4280,10500,9180,23960
"AL","1990-06-11",1990,6,162,414,9900,9160,19474
"AL","1990-06-12",1990,6,163,0,9640,9210,18850
"AL","1990-06-13",1990,6,164,96000,19300,26200,141500
"AL","1990-06-14",1990,6,165,27800,13700,19600,61100
"AL","1990-06-15",1990,6,166,0,11200,9400,20600
"AL","1990-06-16",1990,6,167,1430,10700,9570,21700
"AL","1990-06-17",1990,6,168,5010,10700,9570,25280
"AL","1990-06-18",1990,6,169,22500,14500,10000,47000
"AL","1990-06-19",1990,6,170,760,11200,9500,21460
"AL","1990-06-20",1990,6,171,0,10600,9570,20170
"AL","1990-06-21",1990,6,172,414,10400,9580,20394
"AL","1990-06-22",1990,6,173,1840,10100,9540,21480
"AL","1990-06-23",1990,6,174,12700,11100,9540,33340
"AL","1990-06-24",1990,6,175,507,10300,9440,20247
"AL","1990-06-25",1990,6,176,2940,9980,9600,22520
"AL","1990-06-26",1990,6,177,0,9690,9590,19280
"AL","1990-06-27",1990,6,178,15700,11800,9480,36980
"AL","1990-06-28",1990,6,179,0,10200,9380,19580
"AL","1990-06-29",1990,6,180,1860,10000,9440,21300
"AL","1990-06-30",1990,6,181,8700,10600,9430,28730
"AL","1990-07-01",1990,7,182,17900,13400,9350,40650
"AL","1990-07-02",1990,7,183,0,10500,9460,19960
"AL","1990-07-03",1990,7,184,0,9830,9710,19540
"AL","1990-07-04",1990,7,185,0,9620,9780,19400
"AL","1990-07-05",1990,7,186,0,9530,9770,19300
"AL","1990-07-06",1990,7,187,0,9480,9710,19190
"AL","1990-07-07",1990,7,188,0,9450,9680,19130
"AL","1990-07-08",1990,7,189,18700,9410,9510,37620
"AL","1990-07-09",1990,7,190,50200,17500,9890,77590
"AL","1990-07-10",1990,7,191,5940,11900,9220,27060
"AL","1990-07-11",1990,7,192,0,10800,9430,20230
"AL","1990-07-12",1990,7,193,0,10300,9510,19810
"AL","1990-07-13",1990,7,194,0,10100,9490,19590
"AL","1990-07-14",1990,7,195,0,9940,9610,19550
"AL","1990-07-15",1990,7,196,4670,9800,9660,24130
"AL","1990-07-16",1990,7,197,9350,10900,9530,29780
"AL","1990-07-17",1990,7,198,4040,10500,9440,23980
"AL","1990-07-18",1990,7,199,3400,10300,9480,23180
"AL","1990-07-19",1990,7,200,8360,10700,9470,28530
"AL","1990-07-20",1990,7,201,9860,10600,9420,29880
"AL","1990-07-21",1990,7,202,5140,10700,9490,25330
"AL","1990-07-22",1990,7,203,0,9610,9570,19180
"AL","1990-07-23",1990,7,204,3500,9470,9550,22520
"AL","1990-07-24",1990,7,205,13300,10800,9420,33520
"AL","1990-07-25",1990,7,206,0,9840,9430,19270
"AL","1990-07-26",1990,7,207,0,9520,9580,19100
"AL","1990-07-27",1990,7,208,2920,9370,9550,21840
"AL","1990-07-28",1990,7,209,4520,9760,9500,23780
"AL","1990-07-29",1990,7,210,1930,9630,9470,21030
"AL","1990-07-30",1990,7,211,12500,10600,9390,32490
"AL","1990-07-31",1990,7,212,9640,11300,9240,30180
"AL","1990-08-01",1990,8,213,0,9970,9330,19300
"AL","1990-08-02",1990,8,214,0,9500,9510,19010
"AL","1990-08-03",1990,8,215,0,9290,9560,18850
"AL","1990-08-04",1990,8,216,2000,9270,9510,20780
"AL","1990-08-05",1990,8,217,0,9210,9500,18710
"AL","1990-08-06",1990,8,218,0,9190,9490,18680
"AL","1990-08-07",1990,8,219,0,9160,9520,18680
"AL","1990-08-08",1990,8,220,0,9130,9590,18720
"AL","1990-08-09",1990,8,221,0,9100,9600,18700
"AL","1990-08-10",1990,8,222,22800,9080,9340,41220
"AL","1990-08-11",1990,8,223,61500,19100,14400,95000
"AL","1990-08-12",1990,8,224,0,10600,8550,19150
"AL","1990-08-13",1990,8,225,395,10600,8990,19985
"AL","1990-08-14",1990,8,226,12300,10400,9210,31910
"AL","1990-08-15",1990,8,227,0,9960,9220,19180
"AL","1990-08-16",1990,8,228,34000,15400,14600,64000
"AL","1990-08-17",1990,8,229,0,10600,9010,19610
"AL","1990-08-18",1990,8,230,29800,10400,14500,54700
"AL","1990-08-19",1990,8,231,17900,12800,13800,44500
"AL","1990-08-20",1990,8,232,39400,23800,25000,88200
"AL","1990-08-21",1990,8,233,3840,12900,10100,26840
"AL","1990-08-22",1990,8,234,0,11900,9370,21270
"AL","1990-08-23",1990,8,235,0,11600,9550,21150
"AL","1990-08-24",1990,8,236,0,11200,9580,20780
"AL","1990-08-25",1990,8,237,790,10900,9580,21270
"AL","1990-08-26",1990,8,238,19000,12300,9730,41030
"AL","1990-08-27",1990,8,239,43700,23300,22700,89700
"AL","1990-08-28",1990,8,240,1210,12700,9970,23880
"AL","1990-08-29",1990,8,241,3510,11900,9610,25020
"AL","1990-08-30",1990,8,242,6320,13000,9750,29070
"AL","1990-08-31",1990,8,243,0,11600,9760,21360
"AL","1990-09-01",1990,9,244,10900,11800,9780,32480
"AL","1990-09-02",1990,9,245,742,11300,9700,21742
"AL","1990-09-03",1990,9,246,0,10800,9750,20550
"AL","1990-09-04",1990,9,247,1650,10700,9750,22100
"AL","1990-09-05",1990,9,248,4300,10900,9750,24950
"AL","1990-09-06",1990,9,249,18700,10500,10100,39300
"AL","1990-09-07",1990,9,250,74300,24400,33600,132300
"AL","1990-09-08",1990,9,251,26500,20600,22000,69100
"AL","1990-09-09",1990,9,252,0,12900,10400,23300
"AL","1990-09-10",1990,9,253,2200,12600,10400,25200
"AL","1990-09-11",1990,9,254,454,12400,10500,23354
"AL","1990-09-12",1990,9,255,7140,12000,10600,29740
"AL","1990-09-13",1990,9,256,21100,17600,15200,53900
"AL","1990-09-14",1990,9,257,8790,12500,12400,33690
"AL","1990-09-15",1990,9,258,30100,23200,22700,76000
"AL","1990-09-16",1990,9,259,6000,13800,12500,32300
"AL","1990-09-17",1990,9,260,5580,13900,11900,31380
"AL","1990-09-18",1990,9,261,0,12900,10900,23800
"AL","1990-09-19",1990,9,262,3850,12500,10900,27250
"AL","1990-09-20",1990,9,263,10600,14600,13000,38200
"AL","1990-09-21",1990,9,264,2750,12600,10900,26250
"AL","1990-09-22",1990,9,265,7300,13900,12200,33400
"AL","1990-09-23",1990,9,266,3570,12700,11000,27270
"AL","1990-09-24",1990,9,267,2640,12600,10900,26140
"AL","1990-09-25",1990,9,268,0,12200,10800,23000
"AL","1990-09-26",1990,9,269,0,12100,10800,22900
"AL","1990-09-27",1990,9,270,0,11800,10800,22600
"AL","1990-09-28",1990,9,271,0,11500,10700,22200
"AL","1990-09-29",1990,9,272,0,11400,10700,22100
"AL","1990-09-30",1990,9,273,2750,11300,10600,24650
"AL","1990-10-01",1990,10,274,7300,12000,10500,29800
"AL","1990-10-02",1990,10,275,10200,13800,10900,34900
"AL","1990-10-03",1990,10,276,5360,12200,11200,28760
"AL","1990-10-04",1990,10,277,16900,14700,15100,46700
"AL","1990-10-05",1990,10,278,11800,17500,16300,45600
"AL","1990-10-06",1990,10,279,0,12900,11100,24000
"AL","1990-10-07",1990,10,280,1340,12500,10500,24340
"AL","1990-10-08",1990,10,281,1370,12600,10500,24470
"AL","1990-10-09",1990,10,282,0,12400,10400,22800
"AL","1990-10-10",1990,10,283,0,12400,10400,22800
"AL","1990-10-11",1990,10,284,0,12300,10400,22700
"AL","1990-10-12",1990,10,285,13200,13600,10700,37500
"AL","1990-10-13",1990,10,286,1210,15500,11100,27810
"AL","1990-10-14",1990,10,287,0,12700,10300,23000
"AL","1990-10-15",1990,10,288,35800,20700,22900,79400
"AL","1990-10-16",1990,10,289,4110,15400,13200,32710
"AL","1990-10-17",1990,10,290,0,13400,10500,23900
"AL","1990-10-18",1990,10,291,87900,38300,48000,174200
"AL","1990-10-19",1990,10,292,27700,25200,28900,81800
"AL","1990-10-20",1990,10,293,728,16300,14500,31528
"AL","1990-10-21",1990,10,294,0,15300,14100,29400
"AL","1990-10-22",1990,10,295,32100,20300,27100,79500
"AL","1990-10-23",1990,10,296,0,15800,14200,30000
"AL","1990-10-24",1990,10,297,0,15300,13200,28500
"AL","1990-10-25",1990,10,298,0,15000,13200,28200
"AL","1990-10-26",1990,10,299,3000,15200,13200,31400
"AL","1990-10-27",1990,10,300,0,14600,13100,27700
"AL","1990-10-28",1990,10,301,4020,14500,13300,31820
"AL","1990-10-29",1990,10,302,728,14500,12900,28128
"AL","1990-10-30",1990,10,303,0,14300,12800,27100
"AL","1990-10-31",1990,10,304,0,14200,12700,26900
"AL","1990-11-01",1990,11,305,0,14100,12500,26600
"AL","1990-11-02",1990,11,306,0,14000,12400,26400
"AL","1990-11-03",1990,11,307,0,13900,12400,26300
"AL","1990-11-04",1990,11,308,0,13800,12300,26100
"AL","1990-11-05",1990,11,309,4550,14500,12400,31450
"AL","1990-11-06",1990,11,310,0,13700,12200,25900
"AL","1990-11-07",1990,11,311,0,13600,12200,25800
"AL","1990-11-08",1990,11,312,0,13600,12200,25800
"AL","1990-11-09",1990,11,313,0,13500,12200,25700
"AL","1990-11-10",1990,11,314,230,13500,12100,25830
"AL","1990-11-11",1990,11,315,0,13400,12100,25500
"AL","1990-11-12",1990,11,316,0,13400,12100,25500
"AL","1990-11-13",1990,11,317,0,13400,12100,25500
"AL","1990-11-14",1990,11,318,0,13300,12100,25400
"AL","1990-11-15",1990,11,319,0,13300,12100,25400
"AL","1990-11-16",1990,11,320,0,13300,12200,25500
"AL","1990-11-17",1990,11,321,0,13200,12200,25400
"AL","1990-11-18",1990,11,322,0,13200,12200,25400
"AL","1990-11-19",1990,11,323,0,13200,12200,25400
"AL","1990-11-20",1990,11,324,0,13200,12200,25400
"AL","1990-11-21",1990,11,325,0,13200,12200,25400
"AL","1990-11-22",1990,11,326,17900,16000,13700,47600
"AL","1990-11-23",1990,11,327,1410,13900,12600,27910
"AL","1990-11-24",1990,11,328,0,13400,12000,25400
"AL","1990-11-25",1990,11,329,0,13300,12000,25300
"AL","1990-11-26",1990,11,330,0,13300,11900,25200
"AL","1990-11-27",1990,11,331,0,13300,11900,25200
"AL","1990-11-28",1990,11,332,8260,13300,11800,33360
"AL","1990-11-29",1990,11,333,8720,13400,11900,34020
"AL","1990-11-30",1990,11,334,5820,13400,11800,31020
"AL","1990-12-01",1990,12,335,0,13300,11900,25200
"AL","1990-12-02",1990,12,336,0,13200,11900,25100
"AL","1990-12-03",1990,12,337,0,13200,12000,25200
"AL","1990-12-04",1990,12,338,0,13200,12000,25200
"AL","1990-12-05",1990,12,339,10300,13200,11800,35300
"AL","1990-12-06",1990,12,340,0,13100,11800,24900
"AL","1990-12-07",1990,12,341,0,13100,11900,25000
"AL","1990-12-08",1990,12,342,0,13100,11900,25000
"AL","1990-12-09",1990,12,343,0,13000,11900,24900
"AL","1990-12-10",1990,12,344,0,13000,11900,24900
"AL","1990-12-11",1990,12,345,0,13000,12000,25000
"AL","1990-12-12",1990,12,346,0,12900,11900,24800
"AL","1990-12-13",1990,12,347,0,12900,11900,24800
"AL","1990-12-14",1990,12,348,0,12900,11900,24800
"AL","1990-12-15",1990,12,349,0,12800,11900,24700
"AL","1990-12-16",1990,12,350,1620,12800,11800,26220
"AL","1990-12-17",1990,12,351,5900,12800,11700,30400
"AL","1990-12-18",1990,12,352,85.5,12800,11700,24585.5
"AL","1990-12-19",1990,12,353,1040,12700,11700,25440
"AL","1990-12-20",1990,12,354,0,12700,11700,24400
"AL","1990-12-21",1990,12,355,0,12700,11700,24400
"AL","1990-12-22",1990,12,356,133,12600,11700,24433
"AL","1990-12-23",1990,12,357,4800,12600,11600,29000
"AL","1990-12-24",1990,12,358,0,12600,11600,24200
"AL","1990-12-25",1990,12,359,0,12500,11600,24100
"AL","1990-12-26",1990,12,360,3750,12500,11500,27750
"AL","1990-12-27",1990,12,361,0,12500,11600,24100
"AL","1990-12-28",1990,12,362,0,12400,11500,23900
"AL","1990-12-29",1990,12,363,0,12400,11600,24000
"AL","1990-12-30",1990,12,364,523,12400,11500,24423
"AL","1990-12-31",1990,12,365,0,12300,11500,23800
"AL","1991-01-01",1991,1,1,0,12300,11500,23800
"AL","1991-01-02",1991,1,2,0,12300,11500,23800
"AL","1991-01-03",1991,1,3,0,12200,11500,23700
"AL","1991-01-04",1991,1,4,0,12200,11500,23700
"AL","1991-01-05",1991,1,5,0,12200,11400,23600
"AL","1991-01-06",1991,1,6,0,12100,11400,23500
"AL","1991-01-07",1991,1,7,0,12100,11400,23500
"AL","1991-01-08",1991,1,8,0,12100,11400,23500
"AL","1991-01-09",1991,1,9,0,12000,11400,23400
"AL","1991-01-10",1991,1,10,5090,12000,11300,28390
"AL","1991-01-11",1991,1,11,0,12000,11300,23300
"AL","1991-01-12",1991,1,12,2850,11900,11200,25950
"AL","1991-01-13",1991,1,13,1240,11900,11200,24340
"AL","1991-01-14",1991,1,14,2180,11900,11200,25280
"AL","1991-01-15",1991,1,15,6820,11800,11100,29720
"AL","1991-01-16",1991,1,16,5090,11800,11000,27890
"AL","1991-01-17",1991,1,17,0,11800,11000,22800
"AL","1991-01-18",1991,1,18,365,11700,11000,23065
"AL","1991-01-19",1991,1,19,0,11700,11100,22800
"AL","1991-01-20",1991,1,20,0,11700,11100,22800
"AL","1991-01-21",1991,1,21,143,11600,11100,22843
"AL","1991-01-22",1991,1,22,0,11600,11100,22700
"AL","1991-01-23",1991,1,23,2540,11600,11000,25140
"AL","1991-01-24",1991,1,24,8290,11600,10800,30690
"AL","1991-01-25",1991,1,25,0,11500,10900,22400
"AL","1991-01-26",1991,1,26,0,11500,10900,22400
"AL","1991-01-27",1991,1,27,0,11500,10900,22400
"AL","1991-01-28",1991,1,28,1400,11400,10900,23700
"AL","1991-01-29",1991,1,29,11600,11400,10700,33700
"AL","1991-01-30",1991,1,30,0,11400,10700,22100
"AL","1991-01-31",1991,1,31,0,11300,10800,22100
"AL","1991-02-01",1991,2,32,143,11300,10800,22243
"AL","1991-02-02",1991,2,33,0,11300,10800,22100
"AL","1991-02-03",1991,2,34,0,11200,10800,22000
"AL","1991-02-04",1991,2,35,0,11200,10800,22000
"AL","1991-02-05",1991,2,36,0,11200,10800,22000
"AL","1991-02-06",1991,2,37,0,11100,10800,21900
"AL","1991-02-07",1991,2,38,0,11100,10800,21900
"AL","1991-02-08",1991,2,39,0,11100,10700,21800
"AL","1991-02-09",1991,2,40,0,11000,10700,21700
"AL","1991-02-10",1991,2,41,0,11100,10800,21900
"AL","1991-02-11",1991,2,42,0,11000,10700,21700
"AL","1991-02-12",1991,2,43,0,11000,10700,21700
"AL","1991-02-13",1991,2,44,0,10900,10700,21600
"AL","1991-02-14",1991,2,45,0,10900,10700,21600
"AL","1991-02-15",1991,2,46,4490,10900,10600,25990
"AL","1991-02-16",1991,2,47,1330,10800,10500,22630
"AL","1991-02-17",1991,2,48,0,10800,10600,21400
"AL","1991-02-18",1991,2,49,0,10800,10500,21300
"AL","1991-02-19",1991,2,50,0,10800,10500,21300
"AL","1991-02-20",1991,2,51,5370,10700,10400,26470
"AL","1991-02-21",1991,2,52,267,10700,10400,21367
"AL","1991-02-22",1991,2,53,0,10700,10500,21200
"AL","1991-02-23",1991,2,54,0,10700,10400,21100
"AL","1991-02-24",1991,2,55,0,10600,10400,21000
"AL","1991-02-25",1991,2,56,9220,10600,10300,30120
"AL","1991-02-26",1991,2,57,0,10600,10300,20900
"AL","1991-02-27",1991,2,58,0,10600,10300,20900
"AL","1991-02-28",1991,2,59,1280,10500,10300,22080
"AL","1991-03-01",1991,3,60,0,10500,10300,20800
"AL","1991-03-02",1991,3,61,0,10500,10300,20800
"AL","1991-03-03",1991,3,62,3820,10400,10300,24520
"AL","1991-03-04",1991,3,63,0,10400,10300,20700
"AL","1991-03-05",1991,3,64,0,10400,10300,20700
"AL","1991-03-06",1991,3,65,925,10400,10300,21625
"AL","1991-03-07",1991,3,66,20800,10400,9890,41090
"AL","1991-03-08",1991,3,67,6580,10300,9800,26680
"AL","1991-03-09",1991,3,68,0,10300,9940,20240
"AL","1991-03-10",1991,3,69,3840,10300,9970,24110
"AL","1991-03-11",1991,3,70,0,10300,10000,20300
"AL","1991-03-12",1991,3,71,0,10200,10100,20300
"AL","1991-03-13",1991,3,72,0,10200,10100,20300
"AL","1991-03-14",1991,3,73,0,10200,10100,20300
"AL","1991-03-15",1991,3,74,0,10200,10200,20400
"AL","1991-03-16",1991,3,75,0,10100,10200,20300
"AL","1991-03-17",1991,3,76,0,10100,10200,20300
"AL","1991-03-18",1991,3,77,0,10100,10200,20300
"AL","1991-03-19",1991,3,78,0,10100,10200,20300
"AL","1991-03-20",1991,3,79,163,10000,12200,22363
"AL","1991-03-21",1991,3,80,7990,15500,22600,46090
"AL","1991-03-22",1991,3,81,28200,15500,20600,64300
"AL","1991-03-23",1991,3,82,23400,13200,14200,50800
"AL","1991-03-24",1991,3,83,37700,12800,12400,62900
"AL","1991-03-25",1991,3,84,5540,12700,12500,30740
"AL","1991-03-26",1991,3,85,1500,14500,16700,32700
"AL","1991-03-27",1991,3,86,3030,19700,28700,51430
"AL","1991-03-28",1991,3,87,9250,35600,39900,84750
"AL","1991-03-29",1991,3,88,43200,14900,13800,71900
"AL","1991-03-30",1991,3,89,1180,13500,11900,26580
"AL","1991-03-31",1991,3,90,0,13100,12000,25100
"AL","1991-04-01",1991,4,91,1140,12900,11900,25940
"AL","1991-04-02",1991,4,92,0,12700,12100,24800
"AL","1991-04-03",1991,4,93,0,12700,13800,26500
"AL","1991-04-04",1991,4,94,0,15000,18100,33100
"AL","1991-04-05",1991,4,95,0,18000,19300,37300
"AL","1991-04-06",1991,4,96,0,18300,14000,32300
"AL","1991-04-07",1991,4,97,0,13500,11600,25100
"AL","1991-04-08",1991,4,98,9480,13100,11800,34380
"AL","1991-04-09",1991,4,99,63000,31400,37200,131600
"AL","1991-04-10",1991,4,100,43900,15400,14000,73300
"AL","1991-04-11",1991,4,101,7610,14400,12700,34710
"AL","1991-04-12",1991,4,102,0,14500,14200,28700
"AL","1991-04-13",1991,4,103,0,15200,15500,30700
"AL","1991-04-14",1991,4,104,24000,16800,18700,59500
"AL","1991-04-15",1991,4,105,6030,19700,23400,49130
"AL","1991-04-16",1991,4,106,19300,19300,22800,61400
"AL","1991-04-17",1991,4,107,8540,19700,23600,51840
"AL","1991-04-18",1991,4,108,0,14900,13600,28500
"AL","1991-04-19",1991,4,109,0,14500,13500,28000
"AL","1991-04-20",1991,4,110,0,14200,13500,27700
"AL","1991-04-21",1991,4,111,0,14000,13400,27400
"AL","1991-04-22",1991,4,112,0,13900,13200,27100
"AL","1991-04-23",1991,4,113,10800,14800,13700,39300
"AL","1991-04-24",1991,4,114,13800,16200,16200,46200
"AL","1991-04-25",1991,4,115,1790,13900,13100,28790
"AL","1991-04-26",1991,4,116,0,13600,13100,26700
"AL","1991-04-27",1991,4,117,0,13500,13000,26500
"AL","1991-04-28",1991,4,118,0,13400,12800,26200
"AL","1991-04-29",1991,4,119,20300,13600,15500,49400
"AL","1991-04-30",1991,4,120,17500,15800,17900,51200
"AL","1991-05-01",1991,5,121,20700,20700,20200,61600
"AL","1991-05-02",1991,5,122,8410,17200,15400,41010
"AL","1991-05-03",1991,5,123,1180,14400,13200,28780
"AL","1991-05-04",1991,5,124,8770,14900,15000,38670
"AL","1991-05-05",1991,5,125,7690,16400,15300,39390
"AL","1991-05-06",1991,5,126,11300,14100,16200,41600
"AL","1991-05-07",1991,5,127,33800,22100,26900,82800
"AL","1991-05-08",1991,5,128,7840,17200,16100,41140
"AL","1991-05-09",1991,5,129,995,14800,13700,29495
"AL","1991-05-10",1991,5,130,0,14100,13700,27800
"AL","1991-05-11",1991,5,131,0,13900,13800,27700
"AL","1991-05-12",1991,5,132,0,13000,13600,26600
"AL","1991-05-13",1991,5,133,0,12500,13400,25900
"AL","1991-05-14",1991,5,134,0,12400,13200,25600
"AL","1991-05-15",1991,5,135,0,12200,13000,25200
"AL","1991-05-16",1991,5,136,9230,12100,12800,34130
"AL","1991-05-17",1991,5,137,38600,18800,13000,70400
"AL","1991-05-18",1991,5,138,4340,14300,12600,31240
"AL","1991-05-19",1991,5,139,0,13200,12700,25900
"AL","1991-05-20",1991,5,140,1660,13200,12700,27560
"AL","1991-05-21",1991,5,141,0,12900,12700,25600
"AL","1991-05-22",1991,5,142,0,12500,12600,25100
"AL","1991-05-23",1991,5,143,0,12200,12500,24700
"AL","1991-05-24",1991,5,144,1530,12100,12400,26030
"AL","1991-05-25",1991,5,145,3070,12300,12300,27670
"AL","1991-05-26",1991,5,146,40100,14300,13100,67500
"AL","1991-05-27",1991,5,147,69400,36400,34400,140200
"AL","1991-05-28",1991,5,148,17600,20900,18900,57400
"AL","1991-05-29",1991,5,149,36400,19600,26300,82300
"AL","1991-05-30",1991,5,150,56400,38600,38000,133000
"AL","1991-05-31",1991,5,151,13100,20100,19200,52400
"AL","1991-06-01",1991,6,152,18300,26000,21100,65400
"AL","1991-06-02",1991,6,153,30500,28600,26400,85500
"AL","1991-06-03",1991,6,154,0,17700,15000,32700
"AL","1991-06-04",1991,6,155,0,17100,15400,32500
"AL","1991-06-05",1991,6,156,0,16700,15400,32100
"AL","1991-06-06",1991,6,157,0,16300,15400,31700
"AL","1991-06-07",1991,6,158,0,15900,15300,31200
"AL","1991-06-08",1991,6,159,0,15500,15100,30600
"AL","1991-06-09",1991,6,160,12900,15200,15100,43200
"AL","1991-06-10",1991,6,161,3080,15000,15000,33080
"AL","1991-06-11",1991,6,162,0,14800,14800,29600
"AL","1991-06-12",1991,6,163,19400,15600,15100,50100
"AL","1991-06-13",1991,6,164,10600,17000,14900,42500
"AL","1991-06-14",1991,6,165,1840,15200,14600,31640
"AL","1991-06-15",1991,6,166,48100,17700,18900,84700
"AL","1991-06-16",1991,6,167,11500,17900,16300,45700
"AL","1991-06-17",1991,6,168,1770,15800,14900,32470
"AL","1991-06-18",1991,6,169,0,15100,14900,30000
"AL","1991-06-19",1991,6,170,3680,14800,14800,33280
"AL","1991-06-20",1991,6,171,4000,14400,14700,33100
"AL","1991-06-21",1991,6,172,41600,19000,21500,82100
"AL","1991-06-22",1991,6,173,40500,26900,29400,96800
"AL","1991-06-23",1991,6,174,3290,17200,15600,36090
"AL","1991-06-24",1991,6,175,0,16300,15100,31400
"AL","1991-06-25",1991,6,176,0,16000,15200,31200
"AL","1991-06-26",1991,6,177,0,15500,15000,30500
"AL","1991-06-27",1991,6,178,0,15000,14800,29800
"AL","1991-06-28",1991,6,179,35100,18400,16900,70400
"AL","1991-06-29",1991,6,180,40000,24100,27500,91600
"AL","1991-06-30",1991,6,181,23300,31600,24800,79700
"AL","1991-07-01",1991,7,182,9880,18900,17000,45780
"AL","1991-07-02",1991,7,183,6410,18000,15800,40210
"AL","1991-07-03",1991,7,184,18100,20100,20400,58600
"AL","1991-07-04",1991,7,185,7740,18100,16400,42240
"AL","1991-07-05",1991,7,186,10600,20000,17100,47700
"AL","1991-07-06",1991,7,187,5210,18400,16000,39610
"AL","1991-07-07",1991,7,188,161,18600,15700,34461
"AL","1991-07-08",1991,7,189,2100,16700,15500,34300
"AL","1991-07-09",1991,7,190,9180,17800,15500,42480
"AL","1991-07-10",1991,7,191,233,16300,15200,31733
"AL","1991-07-11",1991,7,192,1450,16000,15100,32550
"AL","1991-07-12",1991,7,193,2570,15400,15000,32970
"AL","1991-07-13",1991,7,194,14400,15300,14900,44600
"AL","1991-07-14",1991,7,195,5870,15800,14700,36370
"AL","1991-07-15",1991,7,196,0,15000,14600,29600
"AL","1991-07-16",1991,7,197,0,14800,14600,29400
"AL","1991-07-17",1991,7,198,14900,14600,14500,44000
"AL","1991-07-18",1991,7,199,29600,21100,15100,65800
"AL","1991-07-19",1991,7,200,1170,15900,14200,31270
"AL","1991-07-20",1991,7,201,394,15400,14300,30094
"AL","1991-07-21",1991,7,202,1170,14800,14200,30170
"AL","1991-07-22",1991,7,203,11500,16200,14200,41900
"AL","1991-07-23",1991,7,204,1530,15500,14000,31030
"AL","1991-07-24",1991,7,205,0,14700,14100,28800
"AL","1991-07-25",1991,7,206,1750,14300,13900,29950
"AL","1991-07-26",1991,7,207,14700,17600,13800,46100
"AL","1991-07-27",1991,7,208,0,15400,13600,29000
"AL","1991-07-28",1991,7,209,12800,14900,13800,41500
"AL","1991-07-29",1991,7,210,21600,17400,14300,53300
"AL","1991-07-30",1991,7,211,28200,23400,15100,66700
"AL","1991-07-31",1991,7,212,2090,16600,13900,32590
"AL","1991-08-01",1991,8,213,0,15900,14000,29900
"AL","1991-08-02",1991,8,214,0,15500,14000,29500
"AL","1991-08-03",1991,8,215,877,14900,13900,29677
"AL","1991-08-04",1991,8,216,10300,16300,13800,40400
"AL","1991-08-05",1991,8,217,592,15400,13700,29692
"AL","1991-08-06",1991,8,218,0,14900,13800,28700
"AL","1991-08-07",1991,8,219,0,14400,13700,28100
"AL","1991-08-08",1991,8,220,0,14100,13600,27700
"AL","1991-08-09",1991,8,221,0,14000,13500,27500
"AL","1991-08-10",1991,8,222,0,13900,13500,27400
"AL","1991-08-11",1991,8,223,0,13800,13500,27300
"AL","1991-08-12",1991,8,224,0,13700,13500,27200
"AL","1991-08-13",1991,8,225,0,13600,13400,27000
"AL","1991-08-14",1991,8,226,0,13500,13400,26900
"AL","1991-08-15",1991,8,227,10500,13400,13300,37200
"AL","1991-08-16",1991,8,228,1450,13400,13200,28050
"AL","1991-08-17",1991,8,229,14000,13300,13000,40300
"AL","1991-08-18",1991,8,230,63300,31400,19200,113900
"AL","1991-08-19",1991,8,231,0,15600,12600,28200
"AL","1991-08-20",1991,8,232,0,15500,12900,28400
"AL","1991-08-21",1991,8,233,0,15500,13000,28500
"AL","1991-08-22",1991,8,234,0,15100,13000,28100
"AL","1991-08-23",1991,8,235,0,14400,13000,27400
"AL","1991-08-24",1991,8,236,0,14000,12900,26900
"AL","1991-08-25",1991,8,237,9920,15800,12800,38520
"AL","1991-08-26",1991,8,238,3120,14700,12700,30520
"AL","1991-08-27",1991,8,239,3050,14600,12800,30450
"AL","1991-08-28",1991,8,240,0,14000,12800,26800
"AL","1991-08-29",1991,8,241,0,13700,12800,26500
"AL","1991-08-30",1991,8,242,0,13400,12800,26200
"AL","1991-08-31",1991,8,243,0,13200,12800,26000
"AL","1991-09-01",1991,9,244,0,13100,12800,25900
"AL","1991-09-02",1991,9,245,0,13000,12600,25600
"AL","1991-09-03",1991,9,246,9890,13000,12500,35390
"AL","1991-09-04",1991,9,247,23400,16900,12400,52700
"AL","1991-09-05",1991,9,248,6280,15800,12400,34480
"AL","1991-09-06",1991,9,249,1650,14300,12500,28450
"AL","1991-09-07",1991,9,250,18400,16200,13100,47700
"AL","1991-09-08",1991,9,251,26100,20500,14900,61500
"AL","1991-09-09",1991,9,252,13700,15500,15400,44600
"AL","1991-09-10",1991,9,253,23000,22500,21000,66500
"AL","1991-09-11",1991,9,254,16000,23200,19100,58300
"AL","1991-09-12",1991,9,255,4940,16200,13600,34740
"AL","1991-09-13",1991,9,256,2980,16000,13200,32180
"AL","1991-09-14",1991,9,257,3820,15500,13300,32620
"AL","1991-09-15",1991,9,258,8720,15700,14300,38720
"AL","1991-09-16",1991,9,259,15500,19300,17700,52500
"AL","1991-09-17",1991,9,260,0,15300,13000,28300
"AL","1991-09-18",1991,9,261,1400,15000,13100,29500
"AL","1991-09-19",1991,9,262,6170,15500,13200,34870
"AL","1991-09-20",1991,9,263,4200,15500,13300,33000
"AL","1991-09-21",1991,9,264,712,15000,13100,28812
"AL","1991-09-22",1991,9,265,0,14700,12900,27600
"AL","1991-09-23",1991,9,266,1100,14600,12900,28600
"AL","1991-09-24",1991,9,267,0,14300,12800,27100
"AL","1991-09-25",1991,9,268,2200,14100,12700,29000
"AL","1991-09-26",1991,9,269,8410,14500,13200,36110
"AL","1991-09-27",1991,9,270,9500,17100,14400,41000
"AL","1991-09-28",1991,9,271,0,15000,12900,27900
"AL","1991-09-29",1991,9,272,0,14600,12800,27400
"AL","1991-09-30",1991,9,273,1320,14400,12700,28420
"AL","1991-10-01",1991,10,274,3400,14600,12800,30800
"AL","1991-10-02",1991,10,275,7370,14100,13300,34770
"AL","1991-10-03",1991,10,276,12800,18200,17800,48800
"AL","1991-10-04",1991,10,277,0,14900,13300,28200
"AL","1991-10-05",1991,10,278,4580,14200,13000,31780
"AL","1991-10-06",1991,10,279,18300,16900,19100,54300
"AL","1991-10-07",1991,10,280,12800,17400,17300,47500
"AL","1991-10-08",1991,10,281,1560,17600,16100,35260
"AL","1991-10-09",1991,10,282,0,15000,12900,27900
"AL","1991-10-10",1991,10,283,0,14900,12800,27700
"AL","1991-10-11",1991,10,284,528,14800,12700,28028
"AL","1991-10-12",1991,10,285,1180,14700,12600,28480
"AL","1991-10-13",1991,10,286,553,14600,12500,27653
"AL","1991-10-14",1991,10,287,4130,14600,12500,31230
"AL","1991-10-15",1991,10,288,12800,17200,13900,43900
"AL","1991-10-16",1991,10,289,5180,16600,14500,36280
"AL","1991-10-17",1991,10,290,1040,15200,13300,29540
"AL","1991-10-18",1991,10,291,0,14600,12500,27100
"AL","1991-10-19",1991,10,292,0,14500,12400,26900
"AL","1991-10-20",1991,10,293,0,14400,12300,26700
"AL","1991-10-21",1991,10,294,0,14300,12300,26600
"AL","1991-10-22",1991,10,295,1670,14400,12200,28270
"AL","1991-10-23",1991,10,296,0,14100,12100,26200
"AL","1991-10-24",1991,10,297,0,14100,12100,26200
"AL","1991-10-25",1991,10,298,22700,18400,16700,57800
"AL","1991-10-26",1991,10,299,13900,20000,19200,53100
"AL","1991-10-27",1991,10,300,4130,15800,14500,34430
"AL","1991-10-28",1991,10,301,912,14900,12500,28312
"AL","1991-10-29",1991,10,302,0,14700,12400,27100
"AL","1991-10-30",1991,10,303,12300,17500,15700,45500
"AL","1991-10-31",1991,10,304,12000,18100,18200,48300
"AL","1991-11-01",1991,11,305,21100,15300,12800,49200
"AL","1991-11-02",1991,11,306,52700,15800,12000,80500
"AL","1991-11-03",1991,11,307,69500,15000,11000,95500
"AL","1991-11-04",1991,11,308,3590,14800,11600,29990
"AL","1991-11-05",1991,11,309,980,14700,12300,27980
"AL","1991-11-06",1991,11,310,0,14600,12600,27200
"AL","1991-11-07",1991,11,311,7050,14500,12500,34050
"AL","1991-11-08",1991,11,312,0,14400,12600,27000
"AL","1991-11-09",1991,11,313,0,14300,12700,27000
"AL","1991-11-10",1991,11,314,0,14200,12800,27000
"AL","1991-11-11",1991,11,315,9010,14200,12600,35810
"AL","1991-11-12",1991,11,316,0,14100,12700,26800
"AL","1991-11-13",1991,11,317,0,14100,12700,26800
"AL","1991-11-14",1991,11,318,0,14000,12700,26700
"AL","1991-11-15",1991,11,319,0,13900,12700,26600
"AL","1991-11-16",1991,11,320,7470,13900,12500,33870
"AL","1991-11-17",1991,11,321,0,13900,12500,26400
"AL","1991-11-18",1991,11,322,8330,13800,12400,34530
"AL","1991-11-19",1991,11,323,28900,13800,12000,54700
"AL","1991-11-20",1991,11,324,0,13700,12100,25800
"AL","1991-11-21",1991,11,325,0,14400,12500,26900
"AL","1991-11-22",1991,11,326,4650,16400,16700,37750
"AL","1991-11-23",1991,11,327,5280,17900,19400,42580
"AL","1991-11-24",1991,11,328,14500,15000,13200,42700
"AL","1991-11-25",1991,11,329,28700,14400,12100,55200
"AL","1991-11-26",1991,11,330,2860,14300,12200,29360
"AL","1991-11-27",1991,11,331,0,14100,12400,26500
"AL","1991-11-28",1991,11,332,4770,14000,12400,31170
"AL","1991-11-29",1991,11,333,0,14000,12500,26500
"AL","1991-11-30",1991,11,334,0,13900,12500,26400
"AL","1991-12-01",1991,12,335,38600,13800,11900,64300
"AL","1991-12-02",1991,12,336,0,13800,12000,25800
"AL","1991-12-03",1991,12,337,0,13700,12300,26000
"AL","1991-12-04",1991,12,338,1980,13600,12300,27880
"AL","1991-12-05",1991,12,339,0,13600,12300,25900
"AL","1991-12-06",1991,12,340,1170,13600,12300,27070
"AL","1991-12-07",1991,12,341,2080,13500,12300,27880
"AL","1991-12-08",1991,12,342,2800,13500,12300,28600
"AL","1991-12-09",1991,12,343,421,13400,12300,26121
"AL","1991-12-10",1991,12,344,0,13400,12300,25700
"AL","1991-12-11",1991,12,345,0,13400,12300,25700
"AL","1991-12-12",1991,12,346,0,13300,12200,25500
"AL","1991-12-13",1991,12,347,10000,13300,12100,35400
"AL","1991-12-14",1991,12,348,5800,13300,12000,31100
"AL","1991-12-15",1991,12,349,222,13300,12000,25522
"AL","1991-12-16",1991,12,350,0,13200,12100,25300
"AL","1991-12-17",1991,12,351,85.5,13200,12100,25385.5
"AL","1991-12-18",1991,12,352,1520,13200,12000,26720
"AL","1991-12-19",1991,12,353,2180,13200,12000,27380
"AL","1991-12-20",1991,12,354,0,13100,12000,25100
"AL","1991-12-21",1991,12,355,773,13100,12000,25873
"AL","1991-12-22",1991,12,356,0,13100,12000,25100
"AL","1991-12-23",1991,12,357,0,13000,12000,25000
"AL","1991-12-24",1991,12,358,0,13000,12000,25000
"AL","1991-12-25",1991,12,359,0,13000,12000,25000
"AL","1991-12-26",1991,12,360,0,13000,12000,25000
"AL","1991-12-27",1991,12,361,0,13000,12000,25000
"AL","1991-12-28",1991,12,362,0,12900,12000,24900
"AL","1991-12-29",1991,12,363,0,12900,11900,24800
"AL","1991-12-30",1991,12,364,0,12900,11900,24800
"AL","1991-12-31",1991,12,365,0,12900,11900,24800
"AL","1992-01-01",1992,1,1,0,12800,11900,24700
"AL","1992-01-02",1992,1,2,0,12800,11900,24700
"AL","1992-01-03",1992,1,3,937,12800,11900,25637
"AL","1992-01-04",1992,1,4,6000,12800,11800,30600
"AL","1992-01-05",1992,1,5,0,12700,11800,24500
"AL","1992-01-06",1992,1,6,156,12700,11800,24656
"AL","1992-01-07",1992,1,7,215,12700,11800,24715
"AL","1992-01-08",1992,1,8,0,12700,11800,24500
"AL","1992-01-09",1992,1,9,4280,12600,11700,28580
"AL","1992-01-10",1992,1,10,4470,12600,11600,28670
"AL","1992-01-11",1992,1,11,0,12600,11700,24300
"AL","1992-01-12",1992,1,12,0,12600,11700,24300
"AL","1992-01-13",1992,1,13,0,12600,11700,24300
"AL","1992-01-14",1992,1,14,2340,12600,11700,26640
"AL","1992-01-15",1992,1,15,1130,12500,11600,25230
"AL","1992-01-16",1992,1,16,0,12500,11600,24100
"AL","1992-01-17",1992,1,17,1560,12500,11600,25660
"AL","1992-01-18",1992,1,18,3570,12500,11500,27570
"AL","1992-01-19",1992,1,19,0,12500,11600,24100
"AL","1992-01-20",1992,1,20,1820,12400,11500,25720
"AL","1992-01-21",1992,1,21,5290,12400,11400,29090
"AL","1992-01-22",1992,1,22,0,12400,11400,23800
"AL","1992-01-23",1992,1,23,7520,12400,11300,31220
"AL","1992-01-24",1992,1,24,11200,12400,11200,34800
"AL","1992-01-25",1992,1,25,1940,12300,11200,25440
"AL","1992-01-26",1992,1,26,0,12300,11300,23600
"AL","1992-01-27",1992,1,27,781,12300,11300,24381
"AL","1992-01-28",1992,1,28,5840,12300,11200,29340
"AL","1992-01-29",1992,1,29,0,12300,11300,23600
"AL","1992-01-30",1992,1,30,0,12200,11300,23500
"AL","1992-01-31",1992,1,31,0,12200,11300,23500
"AL","1992-02-01",1992,2,32,0,12200,11400,23600
"AL","1992-02-02",1992,2,33,0,12200,11400,23600
"AL","1992-02-03",1992,2,34,0,12200,11400,23600
"AL","1992-02-04",1992,2,35,0,12100,11400,23500
"AL","1992-02-05",1992,2,36,0,12100,11400,23500
"AL","1992-02-06",1992,2,37,0,12100,11400,23500
"AL","1992-02-07",1992,2,38,0,12100,11400,23500
"AL","1992-02-08",1992,2,39,1670,12100,11300,25070
"AL","1992-02-09",1992,2,40,1030,12000,11300,24330
"AL","1992-02-10",1992,2,41,211,12000,11300,23511
"AL","1992-02-11",1992,2,42,469,12000,11300,23769
"AL","1992-02-12",1992,2,43,762,12000,11300,24062
"AL","1992-02-13",1992,2,44,93.8,11900,11200,23193.8
"AL","1992-02-14",1992,2,45,0,11900,11200,23100
"AL","1992-02-15",1992,2,46,0,11900,11200,23100
"AL","1992-02-16",1992,2,47,0,11900,11200,23100
"AL","1992-02-17",1992,2,48,0,11900,11200,23100
"AL","1992-02-18",1992,2,49,0,11800,11200,23000
"AL","1992-02-19",1992,2,50,0,11800,11200,23000
"AL","1992-02-20",1992,2,51,0,11800,11200,23000
"AL","1992-02-21",1992,2,52,1410,11800,11200,24410
"AL","1992-02-22",1992,2,53,2540,11700,11100,25340
"AL","1992-02-23",1992,2,54,2530,11700,11100,25330
"AL","1992-02-24",1992,2,55,0,11700,11100,22800
"AL","1992-02-25",1992,2,56,7220,11700,10900,29820
"AL","1992-02-26",1992,2,57,10900,11700,10800,33400
"AL","1992-02-27",1992,2,58,0,11600,10800,22400
"AL","1992-02-28",1992,2,59,469,11600,10900,22969
"AL","1992-02-29",1992,2,60,3300,11600,10900,25800
"AL","1992-03-01",1992,3,61,0,11600,10900,22500
"AL","1992-03-02",1992,3,62,0,11500,10900,22400
"AL","1992-03-03",1992,3,63,0,11500,10900,22400
"AL","1992-03-04",1992,3,64,0,11500,11000,22500
"AL","1992-03-05",1992,3,65,0,11500,11000,22500
"AL","1992-03-06",1992,3,66,11200,11500,10800,33500
"AL","1992-03-07",1992,3,67,11500,11400,10600,33500
"AL","1992-03-08",1992,3,68,5200,11400,10600,27200
"AL","1992-03-09",1992,3,69,11500,11400,10500,33400
"AL","1992-03-10",1992,3,70,19300,11400,10200,40900
"AL","1992-03-11",1992,3,71,14300,11400,10100,35800
"AL","1992-03-12",1992,3,72,0,11400,10300,21700
"AL","1992-03-13",1992,3,73,0,11300,10400,21700
"AL","1992-03-14",1992,3,74,0,11300,10500,21800
"AL","1992-03-15",1992,3,75,0,11300,10500,21800
"AL","1992-03-16",1992,3,76,0,11300,10600,21900
"AL","1992-03-17",1992,3,77,0,11300,10600,21900
"AL","1992-03-18",1992,3,78,0,11300,10700,22000
"AL","1992-03-19",1992,3,79,0,11200,10700,21900
"AL","1992-03-20",1992,3,80,0,11200,10700,21900
"AL","1992-03-21",1992,3,81,1550,11200,10700,23450
"AL","1992-03-22",1992,3,82,0,11200,10700,21900
"AL","1992-03-23",1992,3,83,0,11200,10700,21900
"AL","1992-03-24",1992,3,84,0,11100,10800,21900
"AL","1992-03-25",1992,3,85,0,11100,10800,21900
"AL","1992-03-26",1992,3,86,474,11100,10800,22374
"AL","1992-03-27",1992,3,87,237,11100,10800,22137
"AL","1992-03-28",1992,3,88,0,11000,10800,21800
"AL","1992-03-29",1992,3,89,0,11000,10800,21800
"AL","1992-03-30",1992,3,90,718,11000,10800,22518
"AL","1992-03-31",1992,3,91,474,11000,10800,22274
"AL","1992-04-01",1992,4,92,0,11000,10800,21800
"AL","1992-04-02",1992,4,93,2560,10900,10700,24160
"AL","1992-04-03",1992,4,94,0,10900,10700,21600
"AL","1992-04-04",1992,4,95,0,10900,10700,21600
"AL","1992-04-05",1992,4,96,1470,10900,10700,23070
"AL","1992-04-06",1992,4,97,0,10900,10600,21500
"AL","1992-04-07",1992,4,98,0,10900,10700,21600
"AL","1992-04-08",1992,4,99,4760,19200,30600,54560
"AL","1992-04-09",1992,4,100,0,13500,14700,28200
"AL","1992-04-10",1992,4,101,0,13700,15300,29000
"AL","1992-04-11",1992,4,102,7440,16600,19900,43940
"AL","1992-04-12",1992,4,103,26400,12800,11100,50300
"AL","1992-04-13",1992,4,104,209,12500,10700,23409
"AL","1992-04-14",1992,4,105,0,12300,10800,23100
"AL","1992-04-15",1992,4,106,256,12100,10800,23156
"AL","1992-04-16",1992,4,107,6320,12000,10800,29120
"AL","1992-04-17",1992,4,108,18600,12500,14600,45700
"AL","1992-04-18",1992,4,109,0,13100,13400,26500
"AL","1992-04-19",1992,4,110,2530,19100,26900,48530
"AL","1992-04-20",1992,4,111,4650,32300,50900,87850
"AL","1992-04-21",1992,4,112,8220,117000,153000,278220
"AL","1992-04-22",1992,4,113,16400,159000,186000,361400
"AL","1992-04-23",1992,4,114,2510,26000,29100,57610
"AL","1992-04-24",1992,4,115,3320,22500,24400,50220
"AL","1992-04-25",1992,4,116,348,21000,21800,43148
"AL","1992-04-26",1992,4,117,419,20400,21400,42219
"AL","1992-04-27",1992,4,118,0,18900,18300,37200
"AL","1992-04-28",1992,4,119,0,19300,18600,37900
"AL","1992-04-29",1992,4,120,0,20900,19700,40600
"AL","1992-04-30",1992,4,121,0,20900,17500,38400
"AL","1992-05-01",1992,5,122,0,17900,14800,32700
"AL","1992-05-02",1992,5,123,0,16900,14900,31800
"AL","1992-05-03",1992,5,124,6460,16500,15300,38260
"AL","1992-05-04",1992,5,125,2280,16400,15200,33880
"AL","1992-05-05",1992,5,126,0,15800,15300,31100
"AL","1992-05-06",1992,5,127,0,15600,15400,31000
"AL","1992-05-07",1992,5,128,0,15500,15400,30900
"AL","1992-05-08",1992,5,129,0,14800,15400,30200
"AL","1992-05-09",1992,5,130,0,14000,15200,29200
"AL","1992-05-10",1992,5,131,0,13400,14900,28300
"AL","1992-05-11",1992,5,132,0,13300,14600,27900
"AL","1992-05-12",1992,5,133,17900,13100,14400,45400
"AL","1992-05-13",1992,5,134,15900,16100,14300,46300
"AL","1992-05-14",1992,5,135,0,13900,14100,28000
"AL","1992-05-15",1992,5,136,4060,13500,14200,31760
"AL","1992-05-16",1992,5,137,15400,15200,14500,45100
"AL","1992-05-17",1992,5,138,35000,16400,17100,68500
"AL","1992-05-18",1992,5,139,49000,32100,33100,114200
"AL","1992-05-19",1992,5,140,16000,22600,21000,59600
"AL","1992-05-20",1992,5,141,0,16300,14900,31200
"AL","1992-05-21",1992,5,142,0,15400,15000,30400
"AL","1992-05-22",1992,5,143,2770,14500,14700,31970
"AL","1992-05-23",1992,5,144,7380,14000,14600,35980
"AL","1992-05-24",1992,5,145,31100,22100,15500,68700
"AL","1992-05-25",1992,5,146,0,15400,14300,29700
"AL","1992-05-26",1992,5,147,0,15100,14500,29600
"AL","1992-05-27",1992,5,148,0,15000,14400,29400
"AL","1992-05-28",1992,5,149,0,14700,14300,29000
"AL","1992-05-29",1992,5,150,0,14300,14200,28500
"AL","1992-05-30",1992,5,151,0,13800,14100,27900
"AL","1992-05-31",1992,5,152,0,13500,13900,27400
"AL","1992-06-01",1992,6,153,0,13400,13700,27100
"AL","1992-06-02",1992,6,154,1840,13300,13500,28640
"AL","1992-06-03",1992,6,155,0,13200,13400,26600
"AL","1992-06-04",1992,6,156,0,13100,13200,26300
"AL","1992-06-05",1992,6,157,920,13100,13200,27220
"AL","1992-06-06",1992,6,158,10700,14900,13000,38600
"AL","1992-06-07",1992,6,159,7870,13700,12900,34470
"AL","1992-06-08",1992,6,160,5940,14600,12800,33340
"AL","1992-06-09",1992,6,161,414,13800,12800,27014
"AL","1992-06-10",1992,6,162,0,13400,12800,26200
"AL","1992-06-11",1992,6,163,0,13300,12900,26200
"AL","1992-06-12",1992,6,164,0,12800,12900,25700
"AL","1992-06-13",1992,6,165,0,12700,12900,25600
"AL","1992-06-14",1992,6,166,0,12700,12800,25500
"AL","1992-06-15",1992,6,167,0,12600,12700,25300
"AL","1992-06-16",1992,6,168,6440,12600,12600,31640
"AL","1992-06-17",1992,6,169,7360,12500,12400,32260
"AL","1992-06-18",1992,6,170,13100,14400,12300,39800
"AL","1992-06-19",1992,6,171,26500,19400,12300,58200
"AL","1992-06-20",1992,6,172,3290,14800,12300,30390
"AL","1992-06-21",1992,6,173,760,14200,12400,27360
"AL","1992-06-22",1992,6,174,0,13900,12500,26400
"AL","1992-06-23",1992,6,175,8280,13800,12600,34680
"AL","1992-06-24",1992,6,176,27300,16900,13500,57700
"AL","1992-06-25",1992,6,177,24500,18400,15400,58300
"AL","1992-06-26",1992,6,178,11500,16900,15300,43700
"AL","1992-06-27",1992,6,179,17300,21300,19000,57600
"AL","1992-06-28",1992,6,180,2070,15600,13300,30970
"AL","1992-06-29",1992,6,181,1840,14900,13300,30040
"AL","1992-06-30",1992,6,182,32200,26500,23500,82200
"AL","1992-07-01",1992,7,183,6440,15300,13400,35140
"AL","1992-07-02",1992,7,184,31500,15000,22700,69200
"AL","1992-07-03",1992,7,185,25800,17100,22200,65100
"AL","1992-07-04",1992,7,186,14000,19100,18400,51500
"AL","1992-07-05",1992,7,187,0,15300,14100,29400
"AL","1992-07-06",1992,7,188,161,14700,14100,28961
"AL","1992-07-07",1992,7,189,0,14200,14000,28200
"AL","1992-07-08",1992,7,190,0,14000,13900,27900
"AL","1992-07-09",1992,7,191,263,13700,13700,27663
"AL","1992-07-10",1992,7,192,11700,13900,13700,39300
"AL","1992-07-11",1992,7,193,13700,15400,13700,42800
"AL","1992-07-12",1992,7,194,2490,14200,13500,30190
"AL","1992-07-13",1992,7,195,11200,14400,13600,39200
"AL","1992-07-14",1992,7,196,12000,16100,13800,41900
"AL","1992-07-15",1992,7,197,5120,14700,13500,33320
"AL","1992-07-16",1992,7,198,2330,13800,13400,29530
"AL","1992-07-17",1992,7,199,0,13500,13300,26800
"AL","1992-07-18",1992,7,200,321,13100,13200,26621
"AL","1992-07-19",1992,7,201,0,12800,13100,25900
"AL","1992-07-20",1992,7,202,4080,12700,13000,29780
"AL","1992-07-21",1992,7,203,6850,13200,12900,32950
"AL","1992-07-22",1992,7,204,2920,12700,12800,28420
"AL","1992-07-23",1992,7,205,3800,13000,12800,29600
"AL","1992-07-24",1992,7,206,0,12700,12700,25400
"AL","1992-07-25",1992,7,207,0,12500,12700,25200
"AL","1992-07-26",1992,7,208,0,12400,12700,25100
"AL","1992-07-27",1992,7,209,2950,12700,12600,28250
"AL","1992-07-28",1992,7,210,0,12300,12500,24800
"AL","1992-07-29",1992,7,211,0,12200,12600,24800
"AL","1992-07-30",1992,7,212,0,12100,12500,24600
"AL","1992-07-31",1992,7,213,0,12100,12500,24600
"AL","1992-08-01",1992,8,214,1980,12000,12400,26380
"AL","1992-08-02",1992,8,215,4210,12400,12300,28910
"AL","1992-08-03",1992,8,216,4700,13000,12200,29900
"AL","1992-08-04",1992,8,217,0,12300,12200,24500
"AL","1992-08-05",1992,8,218,0,12200,12200,24400
"AL","1992-08-06",1992,8,219,0,12100,12300,24400
"AL","1992-08-07",1992,8,220,0,11800,12300,24100
"AL","1992-08-08",1992,8,221,3510,11700,12200,27410
"AL","1992-08-09",1992,8,222,9370,13100,12100,34570
"AL","1992-08-10",1992,8,223,0,12200,12100,24300
"AL","1992-08-11",1992,8,224,19600,15400,12100,47100
"AL","1992-08-12",1992,8,225,1750,12400,11900,26050
"AL","1992-08-13",1992,8,226,3930,12600,12000,28530
"AL","1992-08-14",1992,8,227,395,12300,12000,24695
"AL","1992-08-15",1992,8,228,0,12100,12000,24100
"AL","1992-08-16",1992,8,229,0,12100,12100,24200
"AL","1992-08-17",1992,8,230,0,11800,12100,23900
"AL","1992-08-18",1992,8,231,7020,11500,12000,30520
"AL","1992-08-19",1992,8,232,26500,16700,12100,55300
"AL","1992-08-20",1992,8,233,0,12900,11700,24600
"AL","1992-08-21",1992,8,234,0,12700,12000,24700
"AL","1992-08-22",1992,8,235,2240,12300,11900,26440
"AL","1992-08-23",1992,8,236,2170,12300,11900,26370
"AL","1992-08-24",1992,8,237,0,11900,11900,23800
"AL","1992-08-25",1992,8,238,0,11900,11900,23800
"AL","1992-08-26",1992,8,239,33900,13700,12400,60000
"AL","1992-08-27",1992,8,240,10400,14200,11800,36400
"AL","1992-08-28",1992,8,241,0,12700,11700,24400
"AL","1992-08-29",1992,8,242,0,12500,11800,24300
"AL","1992-08-30",1992,8,243,13200,12200,12100,37500
"AL","1992-08-31",1992,8,244,23800,16800,13000,53600
"AL","1992-09-01",1992,9,245,18600,18000,17400,54000
"AL","1992-09-02",1992,9,246,0,13400,11600,25000
"AL","1992-09-03",1992,9,247,6550,13500,12000,32050
"AL","1992-09-04",1992,9,248,16700,18700,16900,52300
"AL","1992-09-05",1992,9,249,0,13700,11700,25400
"AL","1992-09-06",1992,9,250,5100,13600,11900,30600
"AL","1992-09-07",1992,9,251,11400,16600,13700,41700
"AL","1992-09-08",1992,9,252,1320,13400,11800,26520
"AL","1992-09-09",1992,9,253,1990,13400,11800,27190
"AL","1992-09-10",1992,9,254,0,12900,11800,24700
"AL","1992-09-11",1992,9,255,742,12900,11800,25442
"AL","1992-09-12",1992,9,256,0,12600,11700,24300
"AL","1992-09-13",1992,9,257,247,12500,11700,24447
"AL","1992-09-14",1992,9,258,2200,12400,11700,26300
"AL","1992-09-15",1992,9,259,19400,15500,12000,46900
"AL","1992-09-16",1992,9,260,6700,13300,11900,31900
"AL","1992-09-17",1992,9,261,36300,23200,23400,82900
"AL","1992-09-18",1992,9,262,9400,15000,14100,38500
"AL","1992-09-19",1992,9,263,13600,18000,16200,47800
"AL","1992-09-20",1992,9,264,1400,14300,11900,27600
"AL","1992-09-21",1992,9,265,0,13800,11900,25700
"AL","1992-09-22",1992,9,266,0,13600,12000,25600
"AL","1992-09-23",1992,9,267,0,13200,11900,25100
"AL","1992-09-24",1992,9,268,0,13000,11900,24900
"AL","1992-09-25",1992,9,269,0,12800,11800,24600
"AL","1992-09-26",1992,9,270,0,12700,11800,24500
"AL","1992-09-27",1992,9,271,549,12500,11700,24749
"AL","1992-09-28",1992,9,272,21200,16800,12300,50300
"AL","1992-09-29",1992,9,273,0,13600,11700,25300
"AL","1992-09-30",1992,9,274,0,13400,11700,25100
"AL","1992-10-01",1992,10,275,0,13100,11700,24800
"AL","1992-10-02",1992,10,276,0,12900,11700,24600
"AL","1992-10-03",1992,10,277,0,12500,11600,24100
"AL","1992-10-04",1992,10,278,0,12200,11500,23700
"AL","1992-10-05",1992,10,279,0,11900,11400,23300
"AL","1992-10-06",1992,10,280,0,11800,11500,23300
"AL","1992-10-07",1992,10,281,17400,12000,12000,41400
"AL","1992-10-08",1992,10,282,17900,14400,14300,46600
"AL","1992-10-09",1992,10,283,12700,13100,16300,42100
"AL","1992-10-10",1992,10,284,30800,21600,25900,78300
"AL","1992-10-11",1992,10,285,15200,20100,19800,55100
"AL","1992-10-12",1992,10,286,671,15000,13100,28771
"AL","1992-10-13",1992,10,287,0,14100,12200,26300
"AL","1992-10-14",1992,10,288,1760,14000,12200,27960
"AL","1992-10-15",1992,10,289,0,13900,12100,26000
"AL","1992-10-16",1992,10,290,0,13800,12000,25800
"AL","1992-10-17",1992,10,291,4030,14500,12000,30530
"AL","1992-10-18",1992,10,292,0,13700,12000,25700
"AL","1992-10-19",1992,10,293,0,13500,11900,25400
"AL","1992-10-20",1992,10,294,0,13300,11900,25200
"AL","1992-10-21",1992,10,295,4120,13300,11700,29120
"AL","1992-10-22",1992,10,296,595,13800,12100,26495
"AL","1992-10-23",1992,10,297,0,13100,11800,24900
"AL","1992-10-24",1992,10,298,0,13100,11700,24800
"AL","1992-10-25",1992,10,299,0,13000,11700,24700
"AL","1992-10-26",1992,10,300,0,13000,11700,24700
"AL","1992-10-27",1992,10,301,0,13000,11700,24700
"AL","1992-10-28",1992,10,302,0,12900,11700,24600
"AL","1992-10-29",1992,10,303,5280,12900,11800,29980
"AL","1992-10-30",1992,10,304,0,12900,11600,24500
"AL","1992-10-31",1992,10,305,0,12800,11500,24300
"AL","1992-11-01",1992,11,306,0,12800,11500,24300
"AL","1992-11-02",1992,11,307,5000,12800,11600,29400
"AL","1992-11-03",1992,11,308,14800,13000,11300,39100
"AL","1992-11-04",1992,11,309,14800,14100,12000,40900
"AL","1992-11-05",1992,11,310,1380,14200,13300,28880
"AL","1992-11-06",1992,11,311,4420,13200,11600,29220
"AL","1992-11-07",1992,11,312,2690,13000,11400,27090
"AL","1992-11-08",1992,11,313,0,13000,11500,24500
"AL","1992-11-09",1992,11,314,1060,12900,11500,25460
"AL","1992-11-10",1992,11,315,4970,12900,11500,29370
"AL","1992-11-11",1992,11,316,1920,17800,19700,39420
"AL","1992-11-12",1992,11,317,0,14100,12300,26400
"AL","1992-11-13",1992,11,318,1330,13200,11400,25930
"AL","1992-11-14",1992,11,319,5130,13100,11300,29530
"AL","1992-11-15",1992,11,320,459,13100,11300,24859
"AL","1992-11-16",1992,11,321,0,13000,11400,24400
"AL","1992-11-17",1992,11,322,5540,12900,11300,29740
"AL","1992-11-18",1992,11,323,9030,12900,11200,33130
"AL","1992-11-19",1992,11,324,0,12800,11300,24100
"AL","1992-11-20",1992,11,325,0,12800,11300,24100
"AL","1992-11-21",1992,11,326,25100,12700,10900,48700
"AL","1992-11-22",1992,11,327,38500,12700,10500,61700
"AL","1992-11-23",1992,11,328,0,12700,10800,23500
"AL","1992-11-24",1992,11,329,0,12600,11100,23700
"AL","1992-11-25",1992,11,330,0,12600,11200,23800
"AL","1992-11-26",1992,11,331,0,12500,11300,23800
"AL","1992-11-27",1992,11,332,0,12500,11300,23800
"AL","1992-11-28",1992,11,333,0,12500,11300,23800
"AL","1992-11-29",1992,11,334,0,12500,11300,23800
"AL","1992-11-30",1992,11,335,0,12400,11300,23700
"AL","1992-12-01",1992,12,336,0,12400,11300,23700
"AL","1992-12-02",1992,12,337,1120,12400,11300,24820
"AL","1992-12-03",1992,12,338,1920,12300,11300,25520
"AL","1992-12-04",1992,12,339,468,12300,11300,24068
"AL","1992-12-05",1992,12,340,2710,12300,11200,26210
"AL","1992-12-06",1992,12,341,1160,12300,11200,24660
"AL","1992-12-07",1992,12,342,0,12200,11200,23400
"AL","1992-12-08",1992,12,343,0,12200,11200,23400
"AL","1992-12-09",1992,12,344,0,12200,11200,23400
"AL","1992-12-10",1992,12,345,655,12200,11200,24055
"AL","1992-12-11",1992,12,346,258,12100,11200,23558
"AL","1992-12-12",1992,12,347,0,12100,11200,23300
"AL","1992-12-13",1992,12,348,0,12100,11200,23300
"AL","1992-12-14",1992,12,349,0,12100,11200,23300
"AL","1992-12-15",1992,12,350,1870,12100,11100,25070
"AL","1992-12-16",1992,12,351,14700,12000,10900,37600
"AL","1992-12-17",1992,12,352,11200,12000,10700,33900
"AL","1992-12-18",1992,12,353,0,12000,10800,22800
"AL","1992-12-19",1992,12,354,1030,12000,10900,23930
"AL","1992-12-20",1992,12,355,3540,12000,10800,26340
"AL","1992-12-21",1992,12,356,0,12000,10900,22900
"AL","1992-12-22",1992,12,357,0,11900,10900,22800
"AL","1992-12-23",1992,12,358,0,11900,10900,22800
"AL","1992-12-24",1992,12,359,0,11900,10900,22800
"AL","1992-12-25",1992,12,360,1400,11900,10900,24200
"AL","1992-12-26",1992,12,361,7970,11900,10800,30670
"AL","1992-12-27",1992,12,362,0,11900,10800,22700
"AL","1992-12-28",1992,12,363,0,11800,10800,22600
"AL","1992-12-29",1992,12,364,0,11800,10900,22700
"AL","1992-12-30",1992,12,365,4050,11800,10800,26650
"AL","1992-12-31",1992,12,366,4210,11800,10700,26710
"AL","1993-01-01",1993,1,1,8640,11800,10600,31040
"AL","1993-01-02",1993,1,2,161,11700,10700,22561
"AL","1993-01-03",1993,1,3,781,11700,10700,23181
"AL","1993-01-04",1993,1,4,2710,11700,10700,25110
"AL","1993-01-05",1993,1,5,996,11700,10700,23396
"AL","1993-01-06",1993,1,6,879,11700,10700,23279
"AL","1993-01-07",1993,1,7,0,11600,10700,22300
"AL","1993-01-08",1993,1,8,0,11600,10800,22400
"AL","1993-01-09",1993,1,9,0,11600,10800,22400
"AL","1993-01-10",1993,1,10,0,11600,10800,22400
"AL","1993-01-11",1993,1,11,0,11600,10700,22300
"AL","1993-01-12",1993,1,12,0,11500,10800,22300
"AL","1993-01-13",1993,1,13,7050,11500,10600,29150
"AL","1993-01-14",1993,1,14,8870,11500,10500,30870
"AL","1993-01-15",1993,1,15,3200,11500,10500,25200
"AL","1993-01-16",1993,1,16,2730,11500,10500,24730
"AL","1993-01-17",1993,1,17,0,11500,10500,22000
"AL","1993-01-18",1993,1,18,0,11400,10600,22000
"AL","1993-01-19",1993,1,19,0,11400,10600,22000
"AL","1993-01-20",1993,1,20,0,11400,10600,22000
"AL","1993-01-21",1993,1,21,5470,11400,10500,27370
"AL","1993-01-22",1993,1,22,13000,11400,10300,34700
"AL","1993-01-23",1993,1,23,1290,11300,10300,22890
"AL","1993-01-24",1993,1,24,4680,11300,10400,26380
"AL","1993-01-25",1993,1,25,10800,11300,10200,32300
"AL","1993-01-26",1993,1,26,0,11300,10300,21600
"AL","1993-01-27",1993,1,27,15700,11300,10100,37100
"AL","1993-01-28",1993,1,28,2340,11300,10100,23740
"AL","1993-01-29",1993,1,29,6400,11200,10100,27700
"AL","1993-01-30",1993,1,30,351,11200,10200,21751
"AL","1993-01-31",1993,1,31,0,11200,10300,21500
"AL","1993-02-01",1993,2,32,0,11200,10300,21500
"AL","1993-02-02",1993,2,33,0,11200,10400,21600
"AL","1993-02-03",1993,2,34,0,11100,10400,21500
"AL","1993-02-04",1993,2,35,0,11100,10400,21500
"AL","1993-02-05",1993,2,36,0,11100,10400,21500
"AL","1993-02-06",1993,2,37,0,11100,10400,21500
"AL","1993-02-07",1993,2,38,258,11100,10400,21758
"AL","1993-02-08",1993,2,39,0,11000,10400,21400
"AL","1993-02-09",1993,2,40,0,11000,10400,21400
"AL","1993-02-10",1993,2,41,0,11000,10400,21400
"AL","1993-02-11",1993,2,42,0,11000,10400,21400
"AL","1993-02-12",1993,2,43,0,11000,10400,21400
"AL","1993-02-13",1993,2,44,0,11000,10400,21400
"AL","1993-02-14",1993,2,45,0,10900,10400,21300
"AL","1993-02-15",1993,2,46,0,10900,10400,21300
"AL","1993-02-16",1993,2,47,0,10900,10400,21300
"AL","1993-02-17",1993,2,48,0,10900,10400,21300
"AL","1993-02-18",1993,2,49,0,10900,10400,21300
"AL","1993-02-19",1993,2,50,0,10800,10400,21200
"AL","1993-02-20",1993,2,51,0,10800,10300,21100
"AL","1993-02-21",1993,2,52,0,10800,10300,21100
"AL","1993-02-22",1993,2,53,96.5,10800,10300,21196.5
"AL","1993-02-23",1993,2,54,1750,10800,10300,22850
"AL","1993-02-24",1993,2,55,0,10800,10300,21100
"AL","1993-02-25",1993,2,56,0,10700,10300,21000
"AL","1993-02-26",1993,2,57,0,10700,10300,21000
"AL","1993-02-27",1993,2,58,0,10700,10300,21000
"AL","1993-02-28",1993,2,59,0,10700,10200,20900
"AL","1993-03-01",1993,3,60,0,10700,10200,20900
"AL","1993-03-02",1993,3,61,0,10700,10300,21000
"AL","1993-03-03",1993,3,62,0,10600,10300,20900
"AL","1993-03-04",1993,3,63,0,10600,10300,20900
"AL","1993-03-05",1993,3,64,0,10600,10300,20900
"AL","1993-03-06",1993,3,65,0,10600,10300,20900
"AL","1993-03-07",1993,3,66,0,10600,10300,20900
"AL","1993-03-08",1993,3,67,172,10500,10300,20972
"AL","1993-03-09",1993,3,68,5750,10500,10200,26450
"AL","1993-03-10",1993,3,69,172,10500,10100,20772
"AL","1993-03-11",1993,3,70,5970,10500,10000,26470
"AL","1993-03-12",1993,3,71,1060,10500,10000,21560
"AL","1993-03-13",1993,3,72,0,10500,10100,20600
"AL","1993-03-14",1993,3,73,0,10500,10100,20600
"AL","1993-03-15",1993,3,74,0,10400,10000,20400
"AL","1993-03-16",1993,3,75,0,10400,10000,20400
"AL","1993-03-17",1993,3,76,3450,10400,10000,23850
"AL","1993-03-18",1993,3,77,6360,10400,9880,26640
"AL","1993-03-19",1993,3,78,0,10400,9900,20300
"AL","1993-03-20",1993,3,79,474,10400,9910,20784
"AL","1993-03-21",1993,3,80,0,10300,9950,20250
"AL","1993-03-22",1993,3,81,0,10300,9980,20280
"AL","1993-03-23",1993,3,82,0,10300,10000,20300
"AL","1993-03-24",1993,3,83,0,10300,10000,20300
"AL","1993-03-25",1993,3,84,0,10300,10100,20400
"AL","1993-03-26",1993,3,85,0,10300,10100,20400
"AL","1993-03-27",1993,3,86,0,10300,10100,20400
"AL","1993-03-28",1993,3,87,0,10200,10100,20300
"AL","1993-03-29",1993,3,88,0,10400,11600,22000
"AL","1993-03-30",1993,3,89,0,14000,18900,32900
"AL","1993-03-31",1993,3,90,0,15100,19700,34800
"AL","1993-04-01",1993,4,91,3810,27300,23500,54610
"AL","1993-04-02",1993,4,92,3840,12700,11200,27740
"AL","1993-04-03",1993,4,93,0,12200,10600,22800
"AL","1993-04-04",1993,4,94,0,12100,10400,22500
"AL","1993-04-05",1993,4,95,0,11900,10400,22300
"AL","1993-04-06",1993,4,96,0,11700,10400,22100
"AL","1993-04-07",1993,4,97,0,11600,11500,23100
"AL","1993-04-08",1993,4,98,372,15300,19700,35372
"AL","1993-04-09",1993,4,99,11500,14800,17000,43300
"AL","1993-04-10",1993,4,100,10200,20600,20600,51400
"AL","1993-04-11",1993,4,101,1610,16300,18600,36510
"AL","1993-04-12",1993,4,102,12000,18900,19400,50300
"AL","1993-04-13",1993,4,103,34500,14300,12400,61200
"AL","1993-04-14",1993,4,104,837,14300,13300,28437
"AL","1993-04-15",1993,4,105,0,14800,14300,29100
"AL","1993-04-16",1993,4,106,4160,15500,15900,35560
"AL","1993-04-17",1993,4,107,26500,14000,12200,52700
"AL","1993-04-18",1993,4,108,8980,13300,11200,33480
"AL","1993-04-19",1993,4,109,632,13200,15300,29132
"AL","1993-04-20",1993,4,110,0,15600,16900,32500
"AL","1993-04-21",1993,4,111,0,14600,14700,29300
"AL","1993-04-22",1993,4,112,0,14600,15100,29700
"AL","1993-04-23",1993,4,113,0,15700,15200,30900
"AL","1993-04-24",1993,4,114,0,17000,13300,30300
"AL","1993-04-25",1993,4,115,3210,13800,11600,28610
"AL","1993-04-26",1993,4,116,1550,13400,11400,26350
"AL","1993-04-27",1993,4,117,0,13000,11300,24300
"AL","1993-04-28",1993,4,118,7590,12800,11300,31690
"AL","1993-04-29",1993,4,119,20300,19500,17600,57400
"AL","1993-04-30",1993,4,120,1520,13200,11400,26120
"AL","1993-05-01",1993,5,121,3650,13900,11300,28850
"AL","1993-05-02",1993,5,122,12400,13000,13800,39200
"AL","1993-05-03",1993,5,123,21700,18100,19000,58800
"AL","1993-05-04",1993,5,124,29700,21400,24000,75100
"AL","1993-05-05",1993,5,125,28800,25400,24100,78300
"AL","1993-05-06",1993,5,126,5430,18400,13800,37630
"AL","1993-05-07",1993,5,127,0,14700,12200,26900
"AL","1993-05-08",1993,5,128,923,14500,12200,27623
"AL","1993-05-09",1993,5,129,2170,13700,12200,28070
"AL","1993-05-10",1993,5,130,0,13100,12100,25200
"AL","1993-05-11",1993,5,131,831,12800,12000,25631
"AL","1993-05-12",1993,5,132,31800,22800,13500,68100
"AL","1993-05-13",1993,5,133,2080,13800,11800,27680
"AL","1993-05-14",1993,5,134,0,12900,11800,24700
"AL","1993-05-15",1993,5,135,508,12900,11800,25208
"AL","1993-05-16",1993,5,136,0,12400,11600,24000
"AL","1993-05-17",1993,5,137,0,12200,11600,23800
"AL","1993-05-18",1993,5,138,4060,12200,11500,27760
"AL","1993-05-19",1993,5,139,18100,16200,11600,45900
"AL","1993-05-20",1993,5,140,1250,13500,11500,26250
"AL","1993-05-21",1993,5,141,0,13000,11500,24500
"AL","1993-05-22",1993,5,142,0,12800,11600,24400
"AL","1993-05-23",1993,5,143,1850,12500,11500,25850
"AL","1993-05-24",1993,5,144,14400,12200,11700,38300
"AL","1993-05-25",1993,5,145,28200,18100,12500,58800
"AL","1993-05-26",1993,5,146,2660,13700,11500,27860
"AL","1993-05-27",1993,5,147,1040,13400,11700,26140
"AL","1993-05-28",1993,5,148,7380,12800,11800,31980
"AL","1993-05-29",1993,5,149,12400,15000,12500,39900
"AL","1993-05-30",1993,5,150,0,13200,11800,25000
"AL","1993-05-31",1993,5,151,16500,13100,13800,43400
"AL","1993-06-01",1993,6,152,39500,26800,26600,92900
"AL","1993-06-02",1993,6,153,2350,15000,13500,30850
"AL","1993-06-03",1993,6,154,0,14100,12200,26300
"AL","1993-06-04",1993,6,155,920,13900,12200,27020
"AL","1993-06-05",1993,6,156,0,13400,12200,25600
"AL","1993-06-06",1993,6,157,0,13100,12100,25200
"AL","1993-06-07",1993,6,158,6260,12900,12100,31260
"AL","1993-06-08",1993,6,159,23900,17000,13400,54300
"AL","1993-06-09",1993,6,160,32600,19600,23400,75600
"AL","1993-06-10",1993,6,161,34900,25700,26700,87300
"AL","1993-06-11",1993,6,162,8130,17600,14400,40130
"AL","1993-06-12",1993,6,163,0,15000,12700,27700
"AL","1993-06-13",1993,6,164,0,14400,12800,27200
"AL","1993-06-14",1993,6,165,1840,13700,12700,28240
"AL","1993-06-15",1993,6,166,17300,15400,12700,45400
"AL","1993-06-16",1993,6,167,5320,14800,12600,32720
"AL","1993-06-17",1993,6,168,920,13800,12600,27320
"AL","1993-06-18",1993,6,169,59800,30200,31000,121000
"AL","1993-06-19",1993,6,170,11500,19200,17100,47800
"AL","1993-06-20",1993,6,171,57800,16800,34700,109300
"AL","1993-06-21",1993,6,172,69600,45300,46800,161700
"AL","1993-06-22",1993,6,173,8330,22400,22500,53230
"AL","1993-06-23",1993,6,174,207,17400,15000,32607
"AL","1993-06-24",1993,6,175,0,16200,14800,31000
"AL","1993-06-25",1993,6,176,3680,16000,15000,34680
"AL","1993-06-26",1993,6,177,17100,19500,15300,51900
"AL","1993-06-27",1993,6,178,0,16200,15000,31200
"AL","1993-06-28",1993,6,179,1840,15700,15000,32540
"AL","1993-06-29",1993,6,180,0,15200,14900,30100
"AL","1993-06-30",1993,6,181,0,14900,14700,29600
"AL","1993-07-01",1993,7,182,0,14600,14500,29100
"AL","1993-07-02",1993,7,183,0,14400,14400,28800
"AL","1993-07-03",1993,7,184,17500,15700,14400,47600
"AL","1993-07-04",1993,7,185,2740,14700,14200,31640
"AL","1993-07-05",1993,7,186,18400,17400,14600,50400
"AL","1993-07-06",1993,7,187,1330,15100,14100,30530
"AL","1993-07-07",1993,7,188,4660,14900,14100,33660
"AL","1993-07-08",1993,7,189,1170,14200,14000,29370
"AL","1993-07-09",1993,7,190,4200,14100,13900,32200
"AL","1993-07-10",1993,7,191,6720,14200,13800,34720
"AL","1993-07-11",1993,7,192,0,13700,13700,27400
"AL","1993-07-12",1993,7,193,0,13600,13700,27300
"AL","1993-07-13",1993,7,194,1690,13800,13600,29090
"AL","1993-07-14",1993,7,195,3500,13500,13500,30500
"AL","1993-07-15",1993,7,196,5940,14200,13400,33540
"AL","1993-07-16",1993,7,197,263,13700,13400,27363
"AL","1993-07-17",1993,7,198,0,13500,13400,26900
"AL","1993-07-18",1993,7,199,0,13400,13400,26800
"AL","1993-07-19",1993,7,200,0,13300,13400,26700
"AL","1993-07-20",1993,7,201,0,13200,13300,26500
"AL","1993-07-21",1993,7,202,0,13200,13300,26500
"AL","1993-07-22",1993,7,203,0,13200,13200,26400
"AL","1993-07-23",1993,7,204,0,13100,13300,26400
"AL","1993-07-24",1993,7,205,0,13100,13200,26300
"AL","1993-07-25",1993,7,206,0,13100,13200,26300
"AL","1993-07-26",1993,7,207,24300,16000,13000,53300
"AL","1993-07-27",1993,7,208,1200,14600,12800,28600
"AL","1993-07-28",1993,7,209,5250,13700,12900,31850
"AL","1993-07-29",1993,7,210,7600,14000,12900,34500
"AL","1993-07-30",1993,7,211,9180,14500,12900,36580
"AL","1993-07-31",1993,7,212,394,13700,12800,26894
"AL","1993-08-01",1993,8,213,1170,13400,12900,27470
"AL","1993-08-02",1993,8,214,1580,13300,12900,27780
"AL","1993-08-03",1993,8,215,0,13100,12900,26000
"AL","1993-08-04",1993,8,216,8370,14000,12800,35170
"AL","1993-08-05",1993,8,217,9200,14800,12800,36800
"AL","1993-08-06",1993,8,218,0,13900,12800,26700
"AL","1993-08-07",1993,8,219,19300,17300,12900,49500
"AL","1993-08-08",1993,8,220,0,14300,12700,27000
"AL","1993-08-09",1993,8,221,0,14100,12900,27000
"AL","1993-08-10",1993,8,222,12700,13600,12900,39200
"AL","1993-08-11",1993,8,223,14700,16400,13200,44300
"AL","1993-08-12",1993,8,224,0,14100,12800,26900
"AL","1993-08-13",1993,8,225,0,13700,12900,26600
"AL","1993-08-14",1993,8,226,16800,16100,12900,45800
"AL","1993-08-15",1993,8,227,0,14000,12700,26700
"AL","1993-08-16",1993,8,228,877,13700,12800,27377
"AL","1993-08-17",1993,8,229,395,13300,12700,26395
"AL","1993-08-18",1993,8,230,0,13000,12700,25700
"AL","1993-08-19",1993,8,231,0,12900,12700,25600
"AL","1993-08-20",1993,8,232,0,12700,12600,25300
"AL","1993-08-21",1993,8,233,0,12600,12600,25200
"AL","1993-08-22",1993,8,234,0,12500,12500,25000
"AL","1993-08-23",1993,8,235,0,12500,12600,25100
"AL","1993-08-24",1993,8,236,1580,12800,12500,26880
"AL","1993-08-25",1993,8,237,1970,12700,12400,27070
"AL","1993-08-26",1993,8,238,0,12400,12300,24700
"AL","1993-08-27",1993,8,239,0,12300,12300,24600
"AL","1993-08-28",1993,8,240,16900,13000,12200,42100
"AL","1993-08-29",1993,8,241,11300,14400,12100,37800
"AL","1993-08-30",1993,8,242,0,13000,12100,25100
"AL","1993-08-31",1993,8,243,2960,12800,12100,27860
"AL","1993-09-01",1993,9,244,27400,18400,12700,58500
"AL","1993-09-02",1993,9,245,0,13600,11900,25500
"AL","1993-09-03",1993,9,246,1650,13500,12100,27250
"AL","1993-09-04",1993,9,247,5940,14100,12100,32140
"AL","1993-09-05",1993,9,248,0,13300,12100,25400
"AL","1993-09-06",1993,9,249,0,13100,12100,25200
"AL","1993-09-07",1993,9,250,0,12900,12100,25000
"AL","1993-09-08",1993,9,251,0,12700,12100,24800
"AL","1993-09-09",1993,9,252,13100,13800,12100,39000
"AL","1993-09-10",1993,9,253,14600,14500,12400,41500
"AL","1993-09-11",1993,9,254,6100,14100,12000,32200
"AL","1993-09-12",1993,9,255,1650,13200,12000,26850
"AL","1993-09-13",1993,9,256,5440,13800,12100,31340
"AL","1993-09-14",1993,9,257,13200,13100,12500,38800
"AL","1993-09-15",1993,9,258,54600,29200,27600,111400
"AL","1993-09-16",1993,9,259,303,14900,12700,27903
"AL","1993-09-17",1993,9,260,0,14300,12200,26500
"AL","1993-09-18",1993,9,261,0,14200,12300,26500
"AL","1993-09-19",1993,9,262,0,13900,12300,26200
"AL","1993-09-20",1993,9,263,0,13600,12100,25700
"AL","1993-09-21",1993,9,264,14200,14100,12500,40800
"AL","1993-09-22",1993,9,265,4910,14400,12400,31710
"AL","1993-09-23",1993,9,266,0,13600,12100,25700
"AL","1993-09-24",1993,9,267,522,13400,12100,26022
"AL","1993-09-25",1993,9,268,0,13100,12100,25200
"AL","1993-09-26",1993,9,269,0,12900,12000,24900
"AL","1993-09-27",1993,9,270,1980,12800,11900,26680
"AL","1993-09-28",1993,9,271,4490,12900,11900,29290
"AL","1993-09-29",1993,9,272,5370,13200,11800,30370
"AL","1993-09-30",1993,9,273,2850,13600,12200,28650
"AL","1993-10-01",1993,10,274,171,13200,11900,25271
"AL","1993-10-02",1993,10,275,6870,13500,12200,32570
"AL","1993-10-03",1993,10,276,243,13300,12100,25643
"AL","1993-10-04",1993,10,277,2180,13100,11800,27080
"AL","1993-10-05",1993,10,278,3320,13400,11800,28520
"AL","1993-10-06",1993,10,279,5950,13700,12200,31850
"AL","1993-10-07",1993,10,280,184,13300,11900,25384
"AL","1993-10-08",1993,10,281,18200,12900,15300,46400
"AL","1993-10-09",1993,10,282,9300,13200,15600,38100
"AL","1993-10-10",1993,10,283,21400,13700,13000,48100
"AL","1993-10-11",1993,10,284,0,13300,13600,26900
"AL","1993-10-12",1993,10,285,0,14500,16300,30800
"AL","1993-10-13",1993,10,286,0,16000,13200,29200
"AL","1993-10-14",1993,10,287,0,13500,11900,25400
"AL","1993-10-15",1993,10,288,0,13300,11900,25200
"AL","1993-10-16",1993,10,289,1340,13200,11800,26340
"AL","1993-10-17",1993,10,290,10300,16200,12600,39100
"AL","1993-10-18",1993,10,291,302,13600,11900,25802
"AL","1993-10-19",1993,10,292,4020,13200,12100,29320
"AL","1993-10-20",1993,10,293,11700,16500,15200,43400
"AL","1993-10-21",1993,10,294,3350,13600,13300,30250
"AL","1993-10-22",1993,10,295,20300,21400,20100,61800
"AL","1993-10-23",1993,10,296,0,14600,12800,27400
"AL","1993-10-24",1993,10,297,0,13900,11900,25800
"AL","1993-10-25",1993,10,298,0,13700,11900,25600
"AL","1993-10-26",1993,10,299,14100,13600,14600,42300
"AL","1993-10-27",1993,10,300,0,13500,12100,25600
"AL","1993-10-28",1993,10,301,0,13400,11900,25300
"AL","1993-10-29",1993,10,302,663,13300,11800,25763
"AL","1993-10-30",1993,10,303,753,13200,11800,25753
"AL","1993-10-31",1993,10,304,2260,13100,11700,27060
"AL","1993-11-01",1993,11,305,1900,13100,11600,26600
"AL","1993-11-02",1993,11,306,0,13000,11700,24700
"AL","1993-11-03",1993,11,307,0,12900,11800,24700
"AL","1993-11-04",1993,11,308,0,12800,11600,24400
"AL","1993-11-05",1993,11,309,11700,12700,12400,36800
"AL","1993-11-06",1993,11,310,18600,13300,11700,43600
"AL","1993-11-07",1993,11,311,2320,12800,11500,26620
"AL","1993-11-08",1993,11,312,0,12700,11600,24300
"AL","1993-11-09",1993,11,313,0,12700,11600,24300
"AL","1993-11-10",1993,11,314,0,12700,11600,24300
"AL","1993-11-11",1993,11,315,0,12600,11600,24200
"AL","1993-11-12",1993,11,316,10000,12600,11400,34000
"AL","1993-11-13",1993,11,317,8330,12600,11300,32230
"AL","1993-11-14",1993,11,318,20800,12500,11100,44400
"AL","1993-11-15",1993,11,319,4980,12900,12800,30680
"AL","1993-11-16",1993,11,320,5030,13000,13500,31530
"AL","1993-11-17",1993,11,321,0,12800,11700,24500
"AL","1993-11-18",1993,11,322,0,12800,12000,24800
"AL","1993-11-19",1993,11,323,0,12800,11900,24700
"AL","1993-11-20",1993,11,324,0,14500,13700,28200
"AL","1993-11-21",1993,11,325,0,12900,11700,24600
"AL","1993-11-22",1993,11,326,0,12700,11500,24200
"AL","1993-11-23",1993,11,327,0,12700,11500,24200
"AL","1993-11-24",1993,11,328,0,12600,11500,24100
"AL","1993-11-25",1993,11,329,0,12600,11500,24100
"AL","1993-11-26",1993,11,330,0,12500,11500,24000
"AL","1993-11-27",1993,11,331,33200,12500,10900,56600
"AL","1993-11-28",1993,11,332,4090,12400,10900,27390
"AL","1993-11-29",1993,11,333,834,12400,11100,24334
"AL","1993-11-30",1993,11,334,0,12400,11200,23600
"AL","1993-12-01",1993,12,335,0,12300,11200,23500
"AL","1993-12-02",1993,12,336,0,12300,11200,23500
"AL","1993-12-03",1993,12,337,2540,12300,11200,26040
"AL","1993-12-04",1993,12,338,386,12300,11200,23886
"AL","1993-12-05",1993,12,339,0,12200,11200,23400
"AL","1993-12-06",1993,12,340,0,12200,11200,23400
"AL","1993-12-07",1993,12,341,3320,12200,11100,26620
"AL","1993-12-08",1993,12,342,0,12200,11100,23300
"AL","1993-12-09",1993,12,343,0,12100,11200,23300
"AL","1993-12-10",1993,12,344,0,12100,11200,23300
"AL","1993-12-11",1993,12,345,2180,12100,11100,25380
"AL","1993-12-12",1993,12,346,0,12100,11100,23200
"AL","1993-12-13",1993,12,347,0,12000,11100,23100
"AL","1993-12-14",1993,12,348,0,12000,11100,23100
"AL","1993-12-15",1993,12,349,9130,14400,12100,35630
"AL","1993-12-16",1993,12,350,0,12600,11200,23800
"AL","1993-12-17",1993,12,351,0,12500,11100,23600
"AL","1993-12-18",1993,12,352,561,12300,11000,23861
"AL","1993-12-19",1993,12,353,234,12200,11000,23434
"AL","1993-12-20",1993,12,354,1120,12100,11000,24220
"AL","1993-12-21",1993,12,355,1130,12100,11000,24230
"AL","1993-12-22",1993,12,356,3480,12100,10900,26480
"AL","1993-12-23",1993,12,357,468,12000,10900,23368
"AL","1993-12-24",1993,12,358,234,12000,10900,23134
"AL","1993-12-25",1993,12,359,0,12000,10900,22900
"AL","1993-12-26",1993,12,360,0,11900,10900,22800
"AL","1993-12-27",1993,12,361,0,11900,10900,22800
"AL","1993-12-28",1993,12,362,0,11900,10900,22800
"AL","1993-12-29",1993,12,363,0,11800,10900,22700
"AL","1993-12-30",1993,12,364,1950,11800,10900,24650
"AL","1993-12-31",1993,12,365,468,11800,10900,23168
"AL","1994-01-01",1994,1,1,2340,11800,10800,24940
"AL","1994-01-02",1994,1,2,8420,11700,10700,30820
"AL","1994-01-03",1994,1,3,0,11700,10700,22400
"AL","1994-01-04",1994,1,4,0,11700,10700,22400
"AL","1994-01-05",1994,1,5,0,11700,10800,22500
"AL","1994-01-06",1994,1,6,391,11700,10800,22891
"AL","1994-01-07",1994,1,7,8160,11600,10600,30360
"AL","1994-01-08",1994,1,8,5680,11600,10500,27780
"AL","1994-01-09",1994,1,9,3240,11600,10500,25340
"AL","1994-01-10",1994,1,10,0,11600,10600,22200
"AL","1994-01-11",1994,1,11,0,11600,10600,22200
"AL","1994-01-12",1994,1,12,467,11600,10600,22667
"AL","1994-01-13",1994,1,13,860,11500,10600,22960
"AL","1994-01-14",1994,1,14,0,11500,10600,22100
"AL","1994-01-15",1994,1,15,0,11500,10700,22200
"AL","1994-01-16",1994,1,16,0,11500,10700,22200
"AL","1994-01-17",1994,1,17,781,11500,10700,22981
"AL","1994-01-18",1994,1,18,3540,11400,10600,25540
"AL","1994-01-19",1994,1,19,0,11400,10600,22000
"AL","1994-01-20",1994,1,20,0,11400,10600,22000
"AL","1994-01-21",1994,1,21,0,11400,10600,22000
"AL","1994-01-22",1994,1,22,0,11400,10600,22000
"AL","1994-01-23",1994,1,23,0,11300,10600,21900
"AL","1994-01-24",1994,1,24,0,11300,10600,21900
"AL","1994-01-25",1994,1,25,0,11300,10600,21900
"AL","1994-01-26",1994,1,26,3900,11300,10500,25700
"AL","1994-01-27",1994,1,27,1430,11300,10500,23230
"AL","1994-01-28",1994,1,28,2990,11300,10500,24790
"AL","1994-01-29",1994,1,29,4120,11300,10400,25820
"AL","1994-01-30",1994,1,30,1040,11200,10400,22640
"AL","1994-01-31",1994,1,31,0,11200,10500,21700
"AL","1994-02-01",1994,2,32,0,11200,10500,21700
"AL","1994-02-02",1994,2,33,0,11200,10500,21700
"AL","1994-02-03",1994,2,34,0,11200,10500,21700
"AL","1994-02-04",1994,2,35,0,11200,10500,21700
"AL","1994-02-05",1994,2,36,0,11100,10500,21600
"AL","1994-02-06",1994,2,37,0,11100,10500,21600
"AL","1994-02-07",1994,2,38,0,11100,10500,21600
"AL","1994-02-08",1994,2,39,0,11100,10500,21600
"AL","1994-02-09",1994,2,40,469,11100,10400,21969
"AL","1994-02-10",1994,2,41,857,11100,10400,22357
"AL","1994-02-11",1994,2,42,656,11000,10400,22056
"AL","1994-02-12",1994,2,43,0,11000,10400,21400
"AL","1994-02-13",1994,2,44,2050,11000,10400,23450
"AL","1994-02-14",1994,2,45,3340,11000,10300,24640
"AL","1994-02-15",1994,2,46,0,11000,10300,21300
"AL","1994-02-16",1994,2,47,0,11000,10400,21400
"AL","1994-02-17",1994,2,48,0,10900,10400,21300
"AL","1994-02-18",1994,2,49,0,10900,10400,21300
"AL","1994-02-19",1994,2,50,0,10900,10400,21300
"AL","1994-02-20",1994,2,51,3090,10900,10300,24290
"AL","1994-02-21",1994,2,52,739,13000,11100,24839
"AL","1994-02-22",1994,2,53,0,11200,10300,21500
"AL","1994-02-23",1994,2,54,0,11100,10300,21400
"AL","1994-02-24",1994,2,55,727,11000,10200,21927
"AL","1994-02-25",1994,2,56,1690,11000,10200,22890
"AL","1994-02-26",1994,2,57,0,11000,10200,21200
"AL","1994-02-27",1994,2,58,258,10900,10200,21358
"AL","1994-02-28",1994,2,59,0,10900,10200,21100
"AL","1994-03-01",1994,3,60,0,10900,10200,21100
"AL","1994-03-02",1994,3,61,0,10900,10200,21100
"AL","1994-03-03",1994,3,62,0,10800,10300,21100
"AL","1994-03-04",1994,3,63,0,10800,10300,21100
"AL","1994-03-05",1994,3,64,0,10800,10300,21100
"AL","1994-03-06",1994,3,65,0,10800,10300,21100
"AL","1994-03-07",1994,3,66,0,12800,10900,23700
"AL","1994-03-08",1994,3,67,0,11100,10300,21400
"AL","1994-03-09",1994,3,68,237,10900,10200,21337
"AL","1994-03-10",1994,3,69,0,10900,10200,21100
"AL","1994-03-11",1994,3,70,0,10900,10200,21100
"AL","1994-03-12",1994,3,71,345,10800,10200,21345
"AL","1994-03-13",1994,3,72,0,10800,10200,21000
"AL","1994-03-14",1994,3,73,0,10800,10200,21000
"AL","1994-03-15",1994,3,74,0,10700,10200,20900
"AL","1994-03-16",1994,3,75,0,10700,10200,20900
"AL","1994-03-17",1994,3,76,0,10700,10200,20900
"AL","1994-03-18",1994,3,77,1030,10700,10200,21930
"AL","1994-03-19",1994,3,78,1380,10600,10100,22080
"AL","1994-03-20",1994,3,79,517,10600,10100,21217
"AL","1994-03-21",1994,3,80,1130,10600,10100,21830
"AL","1994-03-22",1994,3,81,128,15200,17700,33028
"AL","1994-03-23",1994,3,82,0,13000,14800,27800
"AL","1994-03-24",1994,3,83,0,14100,14200,28300
"AL","1994-03-25",1994,3,84,21200,11600,10400,43200
"AL","1994-03-26",1994,3,85,194,11500,9980,21674
"AL","1994-03-27",1994,3,86,2410,11400,10100,23910
"AL","1994-03-28",1994,3,87,2800,11500,10100,24400
"AL","1994-03-29",1994,3,88,3150,13400,12000,28550
"AL","1994-03-30",1994,3,89,13400,11800,10500,35700
"AL","1994-03-31",1994,3,90,3640,11300,9900,24840
"AL","1994-04-01",1994,4,91,0,11200,9990,21190
"AL","1994-04-02",1994,4,92,0,12000,11800,23800
"AL","1994-04-03",1994,4,93,0,13500,13600,27100
"AL","1994-04-04",1994,4,94,0,11500,10500,22000
"AL","1994-04-05",1994,4,95,4070,11600,12500,28170
"AL","1994-04-06",1994,4,96,3510,11200,10500,25210
"AL","1994-04-07",1994,4,97,0,11100,10200,21300
"AL","1994-04-08",1994,4,98,0,11100,10100,21200
"AL","1994-04-09",1994,4,99,930,11500,13100,25530
"AL","1994-04-10",1994,4,100,4370,11700,20300,36370
"AL","1994-04-11",1994,4,101,209,10900,17300,28409
"AL","1994-04-12",1994,4,102,0,10900,14100,25000
"AL","1994-04-13",1994,4,103,2910,10800,12200,25910
"AL","1994-04-14",1994,4,104,3670,11300,11000,25970
"AL","1994-04-15",1994,4,105,0,10700,10600,21300
"AL","1994-04-16",1994,4,106,12700,13500,13000,39200
"AL","1994-04-17",1994,4,107,17700,15300,16500,49500
"AL","1994-04-18",1994,4,108,0,11500,10300,21800
"AL","1994-04-19",1994,4,109,0,11400,10400,21800
"AL","1994-04-20",1994,4,110,0,11300,10400,21700
"AL","1994-04-21",1994,4,111,0,11200,10300,21500
"AL","1994-04-22",1994,4,112,0,11100,10300,21400
"AL","1994-04-23",1994,4,113,2150,11000,10300,23450
"AL","1994-04-24",1994,4,114,1520,11000,10300,22820
"AL","1994-04-25",1994,4,115,0,10900,10300,21200
"AL","1994-04-26",1994,4,116,16300,12700,10900,39900
"AL","1994-04-27",1994,4,117,13600,12300,13400,39300
"AL","1994-04-28",1994,4,118,19200,17100,17600,53900
"AL","1994-04-29",1994,4,119,5950,11600,10800,28350
"AL","1994-04-30",1994,4,120,11300,12800,13300,37400
"AL","1994-05-01",1994,5,121,0,12800,11800,24600
"AL","1994-05-02",1994,5,122,0,11600,10400,22000
"AL","1994-05-03",1994,5,123,0,11500,10400,21900
"AL","1994-05-04",1994,5,124,0,11400,10400,21800
"AL","1994-05-05",1994,5,125,3320,11300,10300,24920
"AL","1994-05-06",1994,5,126,20500,17300,13800,51600
"AL","1994-05-07",1994,5,127,0,11700,10100,21800
"AL","1994-05-08",1994,5,128,0,11700,10300,22000
"AL","1994-05-09",1994,5,129,554,11300,10300,22154
"AL","1994-05-10",1994,5,130,623,10900,10200,21723
"AL","1994-05-11",1994,5,131,369,10500,10200,21069
"AL","1994-05-12",1994,5,132,1870,10300,10200,22370
"AL","1994-05-13",1994,5,133,0,9990,10100,20090
"AL","1994-05-14",1994,5,134,0,9980,10100,20080
"AL","1994-05-15",1994,5,135,7940,9870,10100,27910
"AL","1994-05-16",1994,5,136,21400,12900,10200,44500
"AL","1994-05-17",1994,5,137,0,10600,9900,20500
"AL","1994-05-18",1994,5,138,0,10400,10100,20500
"AL","1994-05-19",1994,5,139,0,10300,10100,20400
"AL","1994-05-20",1994,5,140,0,9840,10200,20040
"AL","1994-05-21",1994,5,141,0,9620,10200,19820
"AL","1994-05-22",1994,5,142,0,9560,10200,19760
"AL","1994-05-23",1994,5,143,0,9520,10200,19720
"AL","1994-05-24",1994,5,144,0,9480,10100,19580
"AL","1994-05-25",1994,5,145,623,9460,10100,20183
"AL","1994-05-26",1994,5,146,28100,9440,9760,47300
"AL","1994-05-27",1994,5,147,9330,10400,9510,29240
"AL","1994-05-28",1994,5,148,0,9680,9630,19310
"AL","1994-05-29",1994,5,149,0,9550,9770,19320
"AL","1994-05-30",1994,5,150,1110,9340,9820,20270
"AL","1994-05-31",1994,5,151,30500,13400,9580,53480
"AL","1994-06-01",1994,6,152,32700,17100,10400,60200
"AL","1994-06-02",1994,6,153,0,11100,9260,20360
"AL","1994-06-03",1994,6,154,0,10900,9610,20510
"AL","1994-06-04",1994,6,155,0,10400,9700,20100
"AL","1994-06-05",1994,6,156,0,10000,9740,19740
"AL","1994-06-06",1994,6,157,17700,9880,9650,37230
"AL","1994-06-07",1994,6,158,24800,13800,9860,48460
"AL","1994-06-08",1994,6,159,3150,11200,9500,23850
"AL","1994-06-09",1994,6,160,0,10200,9610,19810
"AL","1994-06-10",1994,6,161,0,10100,9690,19790
"AL","1994-06-11",1994,6,162,3860,9820,9690,23370
"AL","1994-06-12",1994,6,163,20900,11800,9660,42360
"AL","1994-06-13",1994,6,164,27500,14000,10700,52200
"AL","1994-06-14",1994,6,165,41900,26100,24500,92500
"AL","1994-06-15",1994,6,166,0,12400,9540,21940
"AL","1994-06-16",1994,6,167,0,11900,9750,21650
"AL","1994-06-17",1994,6,168,4600,11500,9760,25860
"AL","1994-06-18",1994,6,169,1100,11000,9730,21830
"AL","1994-06-19",1994,6,170,36700,17300,12100,66100
"AL","1994-06-20",1994,6,171,0,11900,9560,21460
"AL","1994-06-21",1994,6,172,0,11500,9780,21280
"AL","1994-06-22",1994,6,173,507,11000,9780,21287
"AL","1994-06-23",1994,6,174,0,10700,9780,20480
"AL","1994-06-24",1994,6,175,9570,10700,9750,30020
"AL","1994-06-25",1994,6,176,24600,13200,9850,47650
"AL","1994-06-26",1994,6,177,621,11300,9590,21511
"AL","1994-06-27",1994,6,178,4140,11400,9750,25290
"AL","1994-06-28",1994,6,179,0,10700,9740,20440
"AL","1994-06-29",1994,6,180,22000,10500,10100,42600
"AL","1994-06-30",1994,6,181,24800,14400,10600,49800
"AL","1994-07-01",1994,7,182,2210,11300,9650,23160
"AL","1994-07-02",1994,7,183,1180,11100,9830,22110
"AL","1994-07-03",1994,7,184,0,10600,9990,20590
"AL","1994-07-04",1994,7,185,0,10200,10000,20200
"AL","1994-07-05",1994,7,186,3500,10100,9970,23570
"AL","1994-07-06",1994,7,187,12300,10600,9920,32820
"AL","1994-07-07",1994,7,188,47900,19500,13600,81000
"AL","1994-07-08",1994,7,189,1710,11900,9560,23170
"AL","1994-07-09",1994,7,190,3030,11400,9840,24270
"AL","1994-07-10",1994,7,191,32800,23500,16600,72900
"AL","1994-07-11",1994,7,192,263,12600,9560,22423
"AL","1994-07-12",1994,7,193,0,12200,9830,22030
"AL","1994-07-13",1994,7,194,0,11900,9910,21810
"AL","1994-07-14",1994,7,195,0,11400,9990,21390
"AL","1994-07-15",1994,7,196,0,11000,9940,20940
"AL","1994-07-16",1994,7,197,919,10900,9890,21709
"AL","1994-07-17",1994,7,198,2800,10700,9880,23380
"AL","1994-07-18",1994,7,199,34600,15500,9950,60050
"AL","1994-07-19",1994,7,200,0,11600,9580,21180
"AL","1994-07-20",1994,7,201,9130,11400,9810,30340
"AL","1994-07-21",1994,7,202,21700,14700,10200,46600
"AL","1994-07-22",1994,7,203,5720,11800,9750,27270
"AL","1994-07-23",1994,7,204,7150,12400,9870,29420
"AL","1994-07-24",1994,7,205,0,11300,9850,21150
"AL","1994-07-25",1994,7,206,1390,11100,9900,22390
"AL","1994-07-26",1994,7,207,3940,11000,9900,24840
"AL","1994-07-27",1994,7,208,4700,11000,9870,25570
"AL","1994-07-28",1994,7,209,876,10800,9860,21536
"AL","1994-07-29",1994,7,210,0,10500,9890,20390
"AL","1994-07-30",1994,7,211,700,10400,9930,21030
"AL","1994-07-31",1994,7,212,0,10300,9930,20230
"AL","1994-08-01",1994,8,213,3970,10200,9890,24060
"AL","1994-08-02",1994,8,214,13600,11700,9790,35090
"AL","1994-08-03",1994,8,215,0,10700,9730,20430
"AL","1994-08-04",1994,8,216,9650,10500,9790,29940
"AL","1994-08-05",1994,8,217,13100,12100,9840,35040
"AL","1994-08-06",1994,8,218,0,10600,9740,20340
"AL","1994-08-07",1994,8,219,0,10400,9830,20230
"AL","1994-08-08",1994,8,220,20200,10200,9850,40250
"AL","1994-08-09",1994,8,221,30100,14500,10600,55200
"AL","1994-08-10",1994,8,222,0,11200,9500,20700
"AL","1994-08-11",1994,8,223,0,11100,9730,20830
"AL","1994-08-12",1994,8,224,0,10800,9790,20590
"AL","1994-08-13",1994,8,225,877,10600,9800,21277
"AL","1994-08-14",1994,8,226,197,10400,9800,20397
"AL","1994-08-15",1994,8,227,0,10200,9810,20010
"AL","1994-08-16",1994,8,228,0,10000,9780,19780
"AL","1994-08-17",1994,8,229,0,9980,9760,19740
"AL","1994-08-18",1994,8,230,0,9920,9800,19720
"AL","1994-08-19",1994,8,231,33100,13000,9840,55940
"AL","1994-08-20",1994,8,232,9760,11100,9620,30480
"AL","1994-08-21",1994,8,233,9270,12100,9710,31080
"AL","1994-08-22",1994,8,234,0,10900,9600,20500
"AL","1994-08-23",1994,8,235,0,10700,9690,20390
"AL","1994-08-24",1994,8,236,702,10500,9710,20912
"AL","1994-08-25",1994,8,237,0,10200,9700,19900
"AL","1994-08-26",1994,8,238,1750,10100,9690,21540
"AL","1994-08-27",1994,8,239,3140,10300,9730,23170
"AL","1994-08-28",1994,8,240,9650,9830,9650,29130
"AL","1994-08-29",1994,8,241,15000,11600,9550,36150
"AL","1994-08-30",1994,8,242,0,10500,9490,19990
"AL","1994-08-31",1994,8,243,18000,10500,9990,38490
"AL","1994-09-01",1994,9,244,20200,14800,10100,45100
"AL","1994-09-02",1994,9,245,0,11300,9350,20650
"AL","1994-09-03",1994,9,246,0,11000,9540,20540
"AL","1994-09-04",1994,9,247,0,10900,9570,20470
"AL","1994-09-05",1994,9,248,0,10600,9580,20180
"AL","1994-09-06",1994,9,249,2750,10400,9550,22700
"AL","1994-09-07",1994,9,250,4040,10400,9550,23990
"AL","1994-09-08",1994,9,251,0,10200,9540,19740
"AL","1994-09-09",1994,9,252,0,10100,9570,19670
"AL","1994-09-10",1994,9,253,0,9980,9580,19560
"AL","1994-09-11",1994,9,254,0,9860,9570,19430
"AL","1994-09-12",1994,9,255,0,9760,9550,19310
"AL","1994-09-13",1994,9,256,9060,9680,9500,28240
"AL","1994-09-14",1994,9,257,40000,13800,10400,64200
"AL","1994-09-15",1994,9,258,25000,16800,12300,54100
"AL","1994-09-16",1994,9,259,78300,30000,41600,149900
"AL","1994-09-17",1994,9,260,23800,20400,24100,68300
"AL","1994-09-18",1994,9,261,371,13900,10000,24271
"AL","1994-09-19",1994,9,262,0,13100,9990,23090
"AL","1994-09-20",1994,9,263,0,13000,10000,23000
"AL","1994-09-21",1994,9,264,4170,12700,10000,26870
"AL","1994-09-22",1994,9,265,26700,13700,14100,54500
"AL","1994-09-23",1994,9,266,15500,14600,14500,44600
"AL","1994-09-24",1994,9,267,16100,18200,16000,50300
"AL","1994-09-25",1994,9,268,247,13500,10700,24447
"AL","1994-09-26",1994,9,269,2200,12900,10300,25400
"AL","1994-09-27",1994,9,270,16100,17500,14900,48500
"AL","1994-09-28",1994,9,271,6250,15100,13300,34650
"AL","1994-09-29",1994,9,272,7150,15800,13900,36850
"AL","1994-09-30",1994,9,273,1020,14000,11000,26020
"AL","1994-10-01",1994,10,274,1100,13200,10500,24800
"AL","1994-10-02",1994,10,275,8430,15500,12400,36330
"AL","1994-10-03",1994,10,276,0,13500,10700,24200
"AL","1994-10-04",1994,10,277,0,13000,10500,23500
"AL","1994-10-05",1994,10,278,2150,12700,10400,25250
"AL","1994-10-06",1994,10,279,0,12300,10300,22600
"AL","1994-10-07",1994,10,280,0,12100,10300,22400
"AL","1994-10-08",1994,10,281,13500,13300,10600,37400
"AL","1994-10-09",1994,10,282,3590,13100,10900,27590
"AL","1994-10-10",1994,10,283,1990,12900,10200,25090
"AL","1994-10-11",1994,10,284,0,12500,10200,22700
"AL","1994-10-12",1994,10,285,0,12400,10200,22600
"AL","1994-10-13",1994,10,286,0,12400,10100,22500
"AL","1994-10-14",1994,10,287,0,12300,10100,22400
"AL","1994-10-15",1994,10,288,0,12300,10000,22300
"AL","1994-10-16",1994,10,289,0,12200,10100,22300
"AL","1994-10-17",1994,10,290,0,12200,10100,22300
"AL","1994-10-18",1994,10,291,45600,21500,23000,90100
"AL","1994-10-19",1994,10,292,24700,21100,22300,68100
"AL","1994-10-20",1994,10,293,0,13900,11400,25300
"AL","1994-10-21",1994,10,294,0,13500,10400,23900
"AL","1994-10-22",1994,10,295,0,13400,10400,23800
"AL","1994-10-23",1994,10,296,21600,16200,15100,52900
"AL","1994-10-24",1994,10,297,15200,19500,18000,52700
"AL","1994-10-25",1994,10,298,3530,15300,12900,31730
"AL","1994-10-26",1994,10,299,243,13900,10700,24843
"AL","1994-10-27",1994,10,300,1570,14000,10800,26370
"AL","1994-10-28",1994,10,301,0,13500,10700,24200
"AL","1994-10-29",1994,10,302,2410,13300,10800,26510
"AL","1994-10-30",1994,10,303,3990,14000,10900,28890
"AL","1994-10-31",1994,10,304,0,13200,10700,23900
"AL","1994-11-01",1994,11,305,0,13100,10600,23700
"AL","1994-11-02",1994,11,306,0,13000,10600,23600
"AL","1994-11-03",1994,11,307,0,13000,10600,23600
"AL","1994-11-04",1994,11,308,0,12900,10600,23500
"AL","1994-11-05",1994,11,309,3180,12900,10600,26680
"AL","1994-11-06",1994,11,310,1570,13000,10500,25070
"AL","1994-11-07",1994,11,311,0,12600,10600,23200
"AL","1994-11-08",1994,11,312,0,12600,10600,23200
"AL","1994-11-09",1994,11,313,0,12500,10600,23100
"AL","1994-11-10",1994,11,314,0,12500,10600,23100
"AL","1994-11-11",1994,11,315,0,12500,10600,23100
"AL","1994-11-12",1994,11,316,0,12400,10600,23000
"AL","1994-11-13",1994,11,317,0,12400,10600,23000
"AL","1994-11-14",1994,11,318,1400,12400,10600,24400
"AL","1994-11-15",1994,11,319,5600,13500,10800,29900
"AL","1994-11-16",1994,11,320,0,12500,10600,23100
"AL","1994-11-17",1994,11,321,0,12200,10500,22700
"AL","1994-11-18",1994,11,322,93.1,12200,10500,22793.1
"AL","1994-11-19",1994,11,323,4360,12800,10500,27660
"AL","1994-11-20",1994,11,324,0,12200,10500,22700
"AL","1994-11-21",1994,11,325,0,12200,10500,22700
"AL","1994-11-22",1994,11,326,34200,12600,9920,56720
"AL","1994-11-23",1994,11,327,22100,12400,9580,44080
"AL","1994-11-24",1994,11,328,0,12300,9830,22130
"AL","1994-11-25",1994,11,329,0,12300,10100,22400
"AL","1994-11-26",1994,11,330,0,12200,10100,22300
"AL","1994-11-27",1994,11,331,0,12200,10200,22400
"AL","1994-11-28",1994,11,332,13300,12200,10000,35500
"AL","1994-11-29",1994,11,333,17000,12200,9780,38980
"AL","1994-11-30",1994,11,334,7880,12200,9810,29890
"AL","1994-12-01",1994,12,335,0,12100,10000,22100
"AL","1994-12-02",1994,12,336,0,12100,10100,22200
"AL","1994-12-03",1994,12,337,0,12100,10200,22300
"AL","1994-12-04",1994,12,338,0,12100,10300,22400
"AL","1994-12-05",1994,12,339,0,12100,10300,22400
"AL","1994-12-06",1994,12,340,258,12100,10400,22758
"AL","1994-12-07",1994,12,341,0,12000,10400,22400
"AL","1994-12-08",1994,12,342,0,12000,10400,22400
"AL","1994-12-09",1994,12,343,1500,12000,10400,23900
"AL","1994-12-10",1994,12,344,1740,12000,10400,24140
"AL","1994-12-11",1994,12,345,187,12000,10400,22587
"AL","1994-12-12",1994,12,346,0,11900,10400,22300
"AL","1994-12-13",1994,12,347,0,11900,10500,22400
"AL","1994-12-14",1994,12,348,0,11900,10500,22400
"AL","1994-12-15",1994,12,349,0,11900,10500,22400
"AL","1994-12-16",1994,12,350,0,11900,10500,22400
"AL","1994-12-17",1994,12,351,866,11900,10500,23266
"AL","1994-12-18",1994,12,352,351,11800,10500,22651
"AL","1994-12-19",1994,12,353,0,11800,10500,22300
"AL","1994-12-20",1994,12,354,0,11800,10500,22300
"AL","1994-12-21",1994,12,355,0,11800,10500,22300
"AL","1994-12-22",1994,12,356,0,11800,10500,22300
"AL","1994-12-23",1994,12,357,0,11800,10500,22300
"AL","1994-12-24",1994,12,358,0,11700,10500,22200
"AL","1994-12-25",1994,12,359,0,11700,10500,22200
"AL","1994-12-26",1994,12,360,0,11700,10500,22200
"AL","1994-12-27",1994,12,361,0,11700,10500,22200
"AL","1994-12-28",1994,12,362,0,11700,10500,22200
"AL","1994-12-29",1994,12,363,0,11600,10500,22100
"AL","1994-12-30",1994,12,364,0,11600,10500,22100
"AL","1994-12-31",1994,12,365,93.5,11600,10500,22193.5
"AL","1995-01-01",1995,1,1,644,11600,10400,22644
"AL","1995-01-02",1995,1,2,0,11600,10400,22000
"AL","1995-01-03",1995,1,3,0,11500,10400,21900
"AL","1995-01-04",1995,1,4,0,11500,10400,21900
"AL","1995-01-05",1995,1,5,0,11500,10400,21900
"AL","1995-01-06",1995,1,6,0,11500,10400,21900
"AL","1995-01-07",1995,1,7,2030,11500,10300,23830
"AL","1995-01-08",1995,1,8,3730,11400,10300,25430
"AL","1995-01-09",1995,1,9,0,11400,10300,21700
"AL","1995-01-10",1995,1,10,0,11400,10300,21700
"AL","1995-01-11",1995,1,11,1560,11400,10300,23260
"AL","1995-01-12",1995,1,12,3980,11300,10200,25480
"AL","1995-01-13",1995,1,13,0,11300,10200,21500
"AL","1995-01-14",1995,1,14,3380,11300,10200,24880
"AL","1995-01-15",1995,1,15,0,11300,10200,21500
"AL","1995-01-16",1995,1,16,0,11300,10200,21500
"AL","1995-01-17",1995,1,17,0,11200,10200,21400
"AL","1995-01-18",1995,1,18,5380,11200,10100,26680
"AL","1995-01-19",1995,1,19,2770,11200,10100,24070
"AL","1995-01-20",1995,1,20,0,11200,10100,21300
"AL","1995-01-21",1995,1,21,508,11100,10100,21708
"AL","1995-01-22",1995,1,22,1940,11100,10100,23140
"AL","1995-01-23",1995,1,23,12900,11100,9900,33900
"AL","1995-01-24",1995,1,24,1990,11100,9890,22980
"AL","1995-01-25",1995,1,25,0,11100,9980,21080
"AL","1995-01-26",1995,1,26,0,11000,10000,21000
"AL","1995-01-27",1995,1,27,0,11000,10000,21000
"AL","1995-01-28",1995,1,28,0,11000,10000,21000
"AL","1995-01-29",1995,1,29,0,11000,10100,21100
"AL","1995-01-30",1995,1,30,0,11000,10100,21100
"AL","1995-01-31",1995,1,31,0,10900,10100,21000
"AL","1995-02-01",1995,2,32,0,10900,10100,21000
"AL","1995-02-02",1995,2,33,0,10900,10100,21000
"AL","1995-02-03",1995,2,34,0,10900,10100,21000
"AL","1995-02-04",1995,2,35,0,10800,10100,20900
"AL","1995-02-05",1995,2,36,3300,10800,9990,24090
"AL","1995-02-06",1995,2,37,305,10800,9970,21075
"AL","1995-02-07",1995,2,38,93.8,10800,9980,20873.8
"AL","1995-02-08",1995,2,39,0,10800,9990,20790
"AL","1995-02-09",1995,2,40,0,10700,9990,20690
"AL","1995-02-10",1995,2,41,0,10700,9970,20670
"AL","1995-02-11",1995,2,42,3780,10700,9900,24380
"AL","1995-02-12",1995,2,43,211,10700,9900,20811
"AL","1995-02-13",1995,2,44,0,10700,9920,20620
"AL","1995-02-14",1995,2,45,0,10600,9920,20520
"AL","1995-02-15",1995,2,46,0,10600,9920,20520
"AL","1995-02-16",1995,2,47,7750,10600,9760,28110
"AL","1995-02-17",1995,2,48,3200,10600,9720,23520
"AL","1995-02-18",1995,2,49,0,10600,9770,20370
"AL","1995-02-19",1995,2,50,0,10500,9810,20310
"AL","1995-02-20",1995,2,51,0,10500,9830,20330
"AL","1995-02-21",1995,2,52,3120,10500,9780,23400
"AL","1995-02-22",1995,2,53,211,10500,9790,20501
"AL","1995-02-23",1995,2,54,0,10500,9810,20310
"AL","1995-02-24",1995,2,55,93.8,10400,9810,20303.8
"AL","1995-02-25",1995,2,56,0,10400,9800,20200
"AL","1995-02-26",1995,2,57,0,10400,9800,20200
"AL","1995-02-27",1995,2,58,0,10400,9790,20190
"AL","1995-02-28",1995,2,59,0,10400,9790,20190
"AL","1995-03-01",1995,3,60,844,10300,9770,20914
"AL","1995-03-02",1995,3,61,0,10300,9760,20060
"AL","1995-03-03",1995,3,62,0,10300,9760,20060
"AL","1995-03-04",1995,3,63,0,10300,9750,20050
"AL","1995-03-05",1995,3,64,0,10300,9760,20060
"AL","1995-03-06",1995,3,65,14900,10300,9480,34680
"AL","1995-03-07",1995,3,66,11300,10200,9300,30800
"AL","1995-03-08",1995,3,67,20800,10200,9050,40050
"AL","1995-03-09",1995,3,68,157,10200,9160,19517
"AL","1995-03-10",1995,3,69,0,10200,9320,19520
"AL","1995-03-11",1995,3,70,0,10200,9390,19590
"AL","1995-03-12",1995,3,71,0,10200,9460,19660
"AL","1995-03-13",1995,3,72,0,10200,9540,19740
"AL","1995-03-14",1995,3,73,0,10100,9600,19700
"AL","1995-03-15",1995,3,74,0,13100,10100,23200
"AL","1995-03-16",1995,3,75,0,16600,21200,37800
"AL","1995-03-17",1995,3,76,0,14100,15800,29900
"AL","1995-03-18",1995,3,77,419,17300,21600,39319
"AL","1995-03-19",1995,3,78,0,13500,13300,26800
"AL","1995-03-20",1995,3,79,1440,13700,15300,30440
"AL","1995-03-21",1995,3,80,32500,16000,15700,64200
"AL","1995-03-22",1995,3,81,18100,13800,11900,43800
"AL","1995-03-23",1995,3,82,0,12800,10800,23600
"AL","1995-03-24",1995,3,83,0,13000,11600,24600
"AL","1995-03-25",1995,3,84,0,13600,14000,27600
"AL","1995-03-26",1995,3,85,3270,16700,20900,40870
"AL","1995-03-27",1995,3,86,474,12600,17900,30974
"AL","1995-03-28",1995,3,87,0,12300,14600,26900
"AL","1995-03-29",1995,3,88,0,12100,12700,24800
"AL","1995-03-30",1995,3,89,0,11900,11300,23200
"AL","1995-03-31",1995,3,90,0,11800,10700,22500
"AL","1995-04-01",1995,4,91,0,11600,10600,22200
"AL","1995-04-02",1995,4,92,2790,11500,10600,24890
"AL","1995-04-03",1995,4,93,2930,11500,10700,25130
"AL","1995-04-04",1995,4,94,1670,11500,10500,23670
"AL","1995-04-05",1995,4,95,4610,11900,10400,26910
"AL","1995-04-06",1995,4,96,5210,11300,10300,26810
"AL","1995-04-07",1995,4,97,10200,11200,10200,31600
"AL","1995-04-08",1995,4,98,0,11200,10300,21500
"AL","1995-04-09",1995,4,99,1540,11200,10700,23440
"AL","1995-04-10",1995,4,100,0,11200,10500,21700
"AL","1995-04-11",1995,4,101,0,11100,10700,21800
"AL","1995-04-12",1995,4,102,25600,12200,13300,51100
"AL","1995-04-13",1995,4,103,20800,14300,15800,50900
"AL","1995-04-14",1995,4,104,1790,14800,16400,32990
"AL","1995-04-15",1995,4,105,0,13100,14200,27300
"AL","1995-04-16",1995,4,106,0,12700,13400,26100
"AL","1995-04-17",1995,4,107,3230,11800,10800,25830
"AL","1995-04-18",1995,4,108,512,11700,10500,22712
"AL","1995-04-19",1995,4,109,16000,11500,14500,42000
"AL","1995-04-20",1995,4,110,35200,12700,13600,61500
"AL","1995-04-21",1995,4,111,0,13100,14800,27900
"AL","1995-04-22",1995,4,112,1610,15600,16600,33810
"AL","1995-04-23",1995,4,113,1520,14700,11700,27920
"AL","1995-04-24",1995,4,114,1490,12200,10800,24490
"AL","1995-04-25",1995,4,115,0,12000,10800,22800
"AL","1995-04-26",1995,4,116,1490,11900,10800,24190
"AL","1995-04-27",1995,4,117,1020,11800,10800,23620
"AL","1995-04-28",1995,4,118,1140,11700,10800,23640
"AL","1995-04-29",1995,4,119,0,11500,10700,22200
"AL","1995-04-30",1995,4,120,0,11500,10700,22200
"AL","1995-05-01",1995,5,121,0,11400,10700,22100
"AL","1995-05-02",1995,5,122,0,11300,10700,22000
"AL","1995-05-03",1995,5,123,0,11300,10800,22100
"AL","1995-05-04",1995,5,124,0,11200,10800,22000
"AL","1995-05-05",1995,5,125,0,11200,10900,22100
"AL","1995-05-06",1995,5,126,208,11200,10900,22308
"AL","1995-05-07",1995,5,127,0,11100,10900,22000
"AL","1995-05-08",1995,5,128,0,11100,10900,22000
"AL","1995-05-09",1995,5,129,0,10400,10900,21300
"AL","1995-05-10",1995,5,130,78700,23900,35300,137900
"AL","1995-05-11",1995,5,131,5330,13300,13800,32430
"AL","1995-05-12",1995,5,132,0,12000,11000,23000
"AL","1995-05-13",1995,5,133,0,11900,11000,22900
"AL","1995-05-14",1995,5,134,15100,11100,11600,37800
"AL","1995-05-15",1995,5,135,46200,25900,28600,100700
"AL","1995-05-16",1995,5,136,0,13200,11900,25100
"AL","1995-05-17",1995,5,137,29900,19400,21900,71200
"AL","1995-05-18",1995,5,138,1020,13100,11400,25520
"AL","1995-05-19",1995,5,139,0,12100,11600,23700
"AL","1995-05-20",1995,5,140,0,11700,11500,23200
"AL","1995-05-21",1995,5,141,0,11200,11400,22600
"AL","1995-05-22",1995,5,142,1520,11000,11200,23720
"AL","1995-05-23",1995,5,143,0,10800,11100,21900
"AL","1995-05-24",1995,5,144,25400,14300,11300,51000
"AL","1995-05-25",1995,5,145,0,11800,11000,22800
"AL","1995-05-26",1995,5,146,0,11600,11200,22800
"AL","1995-05-27",1995,5,147,0,11300,11200,22500
"AL","1995-05-28",1995,5,148,0,10800,11200,22000
"AL","1995-05-29",1995,5,149,45900,16100,12400,74400
"AL","1995-05-30",1995,5,150,2100,12200,11000,25300
"AL","1995-05-31",1995,5,151,0,11700,11200,22900
"AL","1995-06-01",1995,6,152,0,11000,11200,22200
"AL","1995-06-02",1995,6,153,0,10600,11100,21700
"AL","1995-06-03",1995,6,154,0,10500,11000,21500
"AL","1995-06-04",1995,6,155,8010,11100,10900,30010
"AL","1995-06-05",1995,6,156,0,10300,10800,21100
"AL","1995-06-06",1995,6,157,0,10200,10900,21100
"AL","1995-06-07",1995,6,158,5700,10200,10800,26700
"AL","1995-06-08",1995,6,159,10500,11000,10700,32200
"AL","1995-06-09",1995,6,160,3200,10700,10600,24500
"AL","1995-06-10",1995,6,161,0,10400,10600,21000
"AL","1995-06-11",1995,6,162,13900,11300,10600,35800
"AL","1995-06-12",1995,6,163,7180,11700,10600,29480
"AL","1995-06-13",1995,6,164,0,10800,10600,21400
"AL","1995-06-14",1995,6,165,0,10600,10800,21400
"AL","1995-06-15",1995,6,166,0,10100,10900,21000
"AL","1995-06-16",1995,6,167,0,9960,10900,20860
"AL","1995-06-17",1995,6,168,0,9930,10800,20730
"AL","1995-06-18",1995,6,169,0,9900,10800,20700
"AL","1995-06-19",1995,6,170,0,9880,10800,20680
"AL","1995-06-20",1995,6,171,0,9860,10900,20760
"AL","1995-06-21",1995,6,172,0,9840,10900,20740
"AL","1995-06-22",1995,6,173,0,9810,10800,20610
"AL","1995-06-23",1995,6,174,3520,10000,10700,24220
"AL","1995-06-24",1995,6,175,1270,9880,10700,21850
"AL","1995-06-25",1995,6,176,0,9760,10700,20460
"AL","1995-06-26",1995,6,177,0,10200,10700,20900
"AL","1995-06-27",1995,6,178,8280,9750,10600,28630
"AL","1995-06-28",1995,6,179,16900,10200,10400,37500
"AL","1995-06-29",1995,6,180,27200,14000,10100,51300
"AL","1995-06-30",1995,6,181,20900,16200,10200,47300
"AL","1995-07-01",1995,7,182,5570,12100,10000,27670
"AL","1995-07-02",1995,7,183,0,11300,10300,21600
"AL","1995-07-03",1995,7,184,0,11100,10500,21600
"AL","1995-07-04",1995,7,185,0,10900,10600,21500
"AL","1995-07-05",1995,7,186,583,10600,10600,21783
"AL","1995-07-06",1995,7,187,4630,10800,10600,26030
"AL","1995-07-07",1995,7,188,8900,11100,10600,30600
"AL","1995-07-08",1995,7,189,5470,11200,10500,27170
"AL","1995-07-09",1995,7,190,583,10600,10600,21783
"AL","1995-07-10",1995,7,191,2420,10600,10600,23620
"AL","1995-07-11",1995,7,192,0,10200,10700,20900
"AL","1995-07-12",1995,7,193,0,10000,10800,20800
"AL","1995-07-13",1995,7,194,6770,9970,10800,27540
"AL","1995-07-14",1995,7,195,10600,11200,10700,32500
"AL","1995-07-15",1995,7,196,12800,10200,10700,33700
"AL","1995-07-16",1995,7,197,31400,13100,10700,55200
"AL","1995-07-17",1995,7,198,12300,12300,10400,35000
"AL","1995-07-18",1995,7,199,4080,10800,10500,25380
"AL","1995-07-19",1995,7,200,24900,14100,11000,50000
"AL","1995-07-20",1995,7,201,1870,11200,10400,23470
"AL","1995-07-21",1995,7,202,8630,11100,10600,30330
"AL","1995-07-22",1995,7,203,4160,11200,10600,25960
"AL","1995-07-23",1995,7,204,6100,10700,10700,27500
"AL","1995-07-24",1995,7,205,0,10300,10700,21000
"AL","1995-07-25",1995,7,206,1750,10200,10700,22650
"AL","1995-07-26",1995,7,207,3340,10300,10700,24340
"AL","1995-07-27",1995,7,208,0,10000,10600,20600
"AL","1995-07-28",1995,7,209,1520,9970,10600,22090
"AL","1995-07-29",1995,7,210,12500,12300,10600,35400
"AL","1995-07-30",1995,7,211,0,10500,10500,21000
"AL","1995-07-31",1995,7,212,0,9980,10700,20680
"AL","1995-08-01",1995,8,213,0,9900,10700,20600
"AL","1995-08-02",1995,8,214,11300,11500,10600,33400
"AL","1995-08-03",1995,8,215,0,10100,10400,20500
"AL","1995-08-04",1995,8,216,2810,9960,10400,23170
"AL","1995-08-05",1995,8,217,2460,9890,10400,22750
"AL","1995-08-06",1995,8,218,4850,11200,10300,26350
"AL","1995-08-07",1995,8,219,0,10200,10300,20500
"AL","1995-08-08",1995,8,220,50400,16900,10200,77500
"AL","1995-08-09",1995,8,221,1930,11400,9690,23020
"AL","1995-08-10",1995,8,222,3310,11100,10100,24510
"AL","1995-08-11",1995,8,223,242,10700,10200,21142
"AL","1995-08-12",1995,8,224,5440,10300,10200,25940
"AL","1995-08-13",1995,8,225,21200,12300,10300,43800
"AL","1995-08-14",1995,8,226,67000,38300,31400,136700
"AL","1995-08-15",1995,8,227,66600,34000,39400,140000
"AL","1995-08-16",1995,8,228,0,17100,15000,32100
"AL","1995-08-17",1995,8,229,0,14000,10900,24900
"AL","1995-08-18",1995,8,230,0,13600,10900,24500
"AL","1995-08-19",1995,8,231,0,13500,10800,24300
"AL","1995-08-20",1995,8,232,20700,14600,11000,46300
"AL","1995-08-21",1995,8,233,725,13500,10700,24925
"AL","1995-08-22",1995,8,234,0,12700,10800,23500
"AL","1995-08-23",1995,8,235,0,12300,10800,23100
"AL","1995-08-24",1995,8,236,0,11900,10700,22600
"AL","1995-08-25",1995,8,237,0,11800,10600,22400
"AL","1995-08-26",1995,8,238,25000,14500,10500,50000
"AL","1995-08-27",1995,8,239,63200,25800,24100,113100
"AL","1995-08-28",1995,8,240,19000,23500,18700,61200
"AL","1995-08-29",1995,8,241,12600,15200,14000,41800
"AL","1995-08-30",1995,8,242,702,14300,11000,26002
"AL","1995-08-31",1995,8,243,0,14100,11000,25100
"AL","1995-09-01",1995,9,244,0,13500,11100,24600
"AL","1995-09-02",1995,9,245,0,12800,11000,23800
"AL","1995-09-03",1995,9,246,0,12500,10900,23400
"AL","1995-09-04",1995,9,247,0,12400,10800,23200
"AL","1995-09-05",1995,9,248,2200,12200,10800,25200
"AL","1995-09-06",1995,9,249,0,12000,10800,22800
"AL","1995-09-07",1995,9,250,4640,11800,10700,27140
"AL","1995-09-08",1995,9,251,1820,12200,10700,24720
"AL","1995-09-09",1995,9,252,3710,12300,10700,26710
"AL","1995-09-10",1995,9,253,0,11900,10600,22500
"AL","1995-09-11",1995,9,254,0,11900,10700,22600
"AL","1995-09-12",1995,9,255,0,11800,10700,22500
"AL","1995-09-13",1995,9,256,0,11700,10700,22400
"AL","1995-09-14",1995,9,257,879,11600,10600,23079
"AL","1995-09-15",1995,9,258,151,11500,10600,22251
"AL","1995-09-16",1995,9,259,1060,11300,10600,22960
"AL","1995-09-17",1995,9,260,16300,13100,10600,40000
"AL","1995-09-18",1995,9,261,7670,13800,10500,31970
"AL","1995-09-19",1995,9,262,371,12300,10500,23171
"AL","1995-09-20",1995,9,263,5250,12400,10600,28250
"AL","1995-09-21",1995,9,264,6220,13300,10600,30120
"AL","1995-09-22",1995,9,265,2600,12700,10500,25800
"AL","1995-09-23",1995,9,266,10400,13100,10800,34300
"AL","1995-09-24",1995,9,267,865,12600,10500,23965
"AL","1995-09-25",1995,9,268,419,12400,10500,23319
"AL","1995-09-26",1995,9,269,0,12100,10500,22600
"AL","1995-09-27",1995,9,270,0,12000,10500,22500
"AL","1995-09-28",1995,9,271,0,11900,10500,22400
"AL","1995-09-29",1995,9,272,0,11800,10500,22300
"AL","1995-09-30",1995,9,273,0,11600,10500,22100
"AL","1995-10-01",1995,10,274,21000,13200,10600,44800
"AL","1995-10-02",1995,10,275,56200,21200,21700,99100
"AL","1995-10-03",1995,10,276,4430,15200,12600,32230
"AL","1995-10-04",1995,10,277,10500,16500,15200,42200
"AL","1995-10-05",1995,10,278,0,14300,11000,25300
"AL","1995-10-06",1995,10,279,0,13500,10600,24100
"AL","1995-10-07",1995,10,280,28800,24400,20900,74100
"AL","1995-10-08",1995,10,281,56500,27800,36400,120700
"AL","1995-10-09",1995,10,282,3600,16300,15700,35600
"AL","1995-10-10",1995,10,283,2010,15600,12200,29810
"AL","1995-10-11",1995,10,284,922,15200,11800,27922
"AL","1995-10-12",1995,10,285,0,14800,11800,26600
"AL","1995-10-13",1995,10,286,0,14600,11800,26400
"AL","1995-10-14",1995,10,287,0,14400,11600,26000
"AL","1995-10-15",1995,10,288,11000,14700,11800,37500
"AL","1995-10-16",1995,10,289,9160,16700,13200,39060
"AL","1995-10-17",1995,10,290,0,14600,11900,26500
"AL","1995-10-18",1995,10,291,0,14200,11600,25800
"AL","1995-10-19",1995,10,292,0,14100,11500,25600
"AL","1995-10-20",1995,10,293,1470,14000,11500,26970
"AL","1995-10-21",1995,10,294,5000,14700,11400,31100
"AL","1995-10-22",1995,10,295,11200,15300,13300,39800
"AL","1995-10-23",1995,10,296,4780,15900,13700,34380
"AL","1995-10-24",1995,10,297,0,14200,11700,25900
"AL","1995-10-25",1995,10,298,67300,30300,18400,116000
"AL","1995-10-26",1995,10,299,4140,17100,17900,39140
"AL","1995-10-27",1995,10,300,0,15200,17600,32800
"AL","1995-10-28",1995,10,301,2140,15100,24100,41340
"AL","1995-10-29",1995,10,302,6900,16000,14700,37600
"AL","1995-10-30",1995,10,303,3770,15100,14000,32870
"AL","1995-10-31",1995,10,304,4370,15900,13700,33970
"AL","1995-11-01",1995,11,305,0,14600,12400,27000
"AL","1995-11-02",1995,11,306,15200,15500,13600,44300
"AL","1995-11-03",1995,11,307,26600,15600,13300,55500
"AL","1995-11-04",1995,11,308,1610,15400,12500,29510
"AL","1995-11-05",1995,11,309,459,14600,12400,27459
"AL","1995-11-06",1995,11,310,0,14500,12400,26900
"AL","1995-11-07",1995,11,311,0,14400,12400,26800
"AL","1995-11-08",1995,11,312,8330,14300,12300,34930
"AL","1995-11-09",1995,11,313,1880,14200,12300,28380
"AL","1995-11-10",1995,11,314,0,14100,12300,26400
"AL","1995-11-11",1995,11,315,9300,14100,12100,35500
"AL","1995-11-12",1995,11,316,0,14000,12200,26200
"AL","1995-11-13",1995,11,317,0,14000,12200,26200
"AL","1995-11-14",1995,11,318,0,13900,12200,26100
"AL","1995-11-15",1995,11,319,2000,13900,12100,28000
"AL","1995-11-16",1995,11,320,833,13800,12100,26733
"AL","1995-11-17",1995,11,321,0,13800,12100,25900
"AL","1995-11-18",1995,11,322,1150,13700,12000,26850
"AL","1995-11-19",1995,11,323,5480,13700,11900,31080
"AL","1995-11-20",1995,11,324,30000,13700,11500,55200
"AL","1995-11-21",1995,11,325,45600,13600,11000,70200
"AL","1995-11-22",1995,11,326,9360,13600,11200,34160
"AL","1995-11-23",1995,11,327,0,13600,11600,25200
"AL","1995-11-24",1995,11,328,0,13600,11800,25400
"AL","1995-11-25",1995,11,329,3330,13500,11800,28630
"AL","1995-11-26",1995,11,330,25300,13500,11500,50300
"AL","1995-11-27",1995,11,331,15900,13500,11400,40800
"AL","1995-11-28",1995,11,332,0,13500,11700,25200
"AL","1995-11-29",1995,11,333,0,13400,11900,25300
"AL","1995-11-30",1995,11,334,0,13400,11900,25300
"AL","1995-12-01",1995,12,335,730,13400,11900,26030
"AL","1995-12-02",1995,12,336,4740,13400,11900,30040
"AL","1995-12-03",1995,12,337,1600,13400,11900,26900
"AL","1995-12-04",1995,12,338,0,13300,11900,25200
"AL","1995-12-05",1995,12,339,281,13300,11900,25481
"AL","1995-12-06",1995,12,340,3670,13300,11900,28870
"AL","1995-12-07",1995,12,341,1160,13300,11900,26360
"AL","1995-12-08",1995,12,342,0,13200,11900,25100
"AL","1995-12-09",1995,12,343,561,13200,11900,25661
"AL","1995-12-10",1995,12,344,4890,13200,11800,29890
"AL","1995-12-11",1995,12,345,0,13200,11800,25000
"AL","1995-12-12",1995,12,346,0,13100,11800,24900
"AL","1995-12-13",1995,12,347,0,13100,11800,24900
"AL","1995-12-14",1995,12,348,8890,13100,11700,33690
"AL","1995-12-15",1995,12,349,16800,13100,11400,41300
"AL","1995-12-16",1995,12,350,0,13000,11600,24600
"AL","1995-12-17",1995,12,351,0,13000,11700,24700
"AL","1995-12-18",1995,12,352,0,13000,11700,24700
"AL","1995-12-19",1995,12,353,0,13000,11700,24700
"AL","1995-12-20",1995,12,354,0,12900,11700,24600
"AL","1995-12-21",1995,12,355,0,12900,11700,24600
"AL","1995-12-22",1995,12,356,93.5,12900,11700,24693.5
"AL","1995-12-23",1995,12,357,0,12900,11700,24600
"AL","1995-12-24",1995,12,358,0,12900,11700,24600
"AL","1995-12-25",1995,12,359,561,12800,11700,25061
"AL","1995-12-26",1995,12,360,3780,12800,11600,28180
"AL","1995-12-27",1995,12,361,1830,12800,11600,26230
"AL","1995-12-28",1995,12,362,129,12800,11600,24529
"AL","1995-12-29",1995,12,363,0,12700,11600,24300
"AL","1995-12-30",1995,12,364,0,12700,11600,24300
"AL","1995-12-31",1995,12,365,93.5,12700,11600,24393.5
"AL","1996-01-01",1996,1,1,1440,12700,11600,25740
"AL","1996-01-02",1996,1,2,5250,12600,11500,29350
"AL","1996-01-03",1996,1,3,0,12600,11500,24100
"AL","1996-01-04",1996,1,4,0,12600,11500,24100
"AL","1996-01-05",1996,1,5,0,12600,11500,24100
"AL","1996-01-06",1996,1,6,0,12500,11500,24000
"AL","1996-01-07",1996,1,7,0,12500,11500,24000
"AL","1996-01-08",1996,1,8,0,12500,11500,24000
"AL","1996-01-09",1996,1,9,0,12500,11500,24000
"AL","1996-01-10",1996,1,10,15600,12400,11200,39200
"AL","1996-01-11",1996,1,11,527,12400,11200,24127
"AL","1996-01-12",1996,1,12,2310,12400,11200,25910
"AL","1996-01-13",1996,1,13,0,12400,11300,23700
"AL","1996-01-14",1996,1,14,0,12400,11300,23700
"AL","1996-01-15",1996,1,15,0,12300,11300,23600
"AL","1996-01-16",1996,1,16,0,12300,11300,23600
"AL","1996-01-17",1996,1,17,156,12300,11300,23756
"AL","1996-01-18",1996,1,18,4160,12300,11200,27660
"AL","1996-01-19",1996,1,19,74200,12300,10200,96700
"AL","1996-01-20",1996,1,20,23600,12200,10000,45800
"AL","1996-01-21",1996,1,21,0,12200,10600,22800
"AL","1996-01-22",1996,1,22,0,12200,10900,23100
"AL","1996-01-23",1996,1,23,0,12200,11000,23200
"AL","1996-01-24",1996,1,24,0,12200,11000,23200
"AL","1996-01-25",1996,1,25,0,12100,11100,23200
"AL","1996-01-26",1996,1,26,0,12100,11100,23200
"AL","1996-01-27",1996,1,27,0,12100,11100,23200
"AL","1996-01-28",1996,1,28,20200,12100,10800,43100
"AL","1996-01-29",1996,1,29,3900,12000,10800,26700
"AL","1996-01-30",1996,1,30,13800,12000,10700,36500
"AL","1996-01-31",1996,1,31,860,12000,10800,23660
"AL","1996-02-01",1996,2,32,0,12000,10900,22900
"AL","1996-02-02",1996,2,33,0,11900,11000,22900
"AL","1996-02-03",1996,2,34,0,11900,11000,22900
"AL","1996-02-04",1996,2,35,0,11900,11000,22900
"AL","1996-02-05",1996,2,36,0,11900,11000,22900
"AL","1996-02-06",1996,2,37,0,11800,11000,22800
"AL","1996-02-07",1996,2,38,0,11800,11000,22800
"AL","1996-02-08",1996,2,39,129,11800,11000,22929
"AL","1996-02-09",1996,2,40,0,11700,11000,22700
"AL","1996-02-10",1996,2,41,0,11700,11000,22700
"AL","1996-02-11",1996,2,42,6900,11700,10900,29500
"AL","1996-02-12",1996,2,43,2310,11700,10800,24810
"AL","1996-02-13",1996,2,44,129,11600,10900,22629
"AL","1996-02-14",1996,2,45,938,11600,10900,23438
"AL","1996-02-15",1996,2,46,4030,11600,10800,26430
"AL","1996-02-16",1996,2,47,1160,11600,10800,23560
"AL","1996-02-17",1996,2,48,1880,11500,10800,24180
"AL","1996-02-18",1996,2,49,387,11500,10800,22687
"AL","1996-02-19",1996,2,50,93.8,11500,10800,22393.8
"AL","1996-02-20",1996,2,51,0,11500,10800,22300
"AL","1996-02-21",1996,2,52,1880,11400,10800,24080
"AL","1996-02-22",1996,2,53,0,11400,10800,22200
"AL","1996-02-23",1996,2,54,0,11400,10800,22200
"AL","1996-02-24",1996,2,55,1810,11400,10700,23910
"AL","1996-02-25",1996,2,56,7960,11300,10600,29860
"AL","1996-02-26",1996,2,57,0,11300,10600,21900
"AL","1996-02-27",1996,2,58,0,11300,10700,22000
"AL","1996-02-28",1996,2,59,10500,11300,10500,32300
"AL","1996-02-29",1996,2,60,4730,11200,10400,26330
"AL","1996-03-01",1996,3,61,0,11200,10500,21700
"AL","1996-03-02",1996,3,62,0,11200,10500,21700
"AL","1996-03-03",1996,3,63,0,11200,10600,21800
"AL","1996-03-04",1996,3,64,0,11200,10600,21800
"AL","1996-03-05",1996,3,65,3100,11100,10500,24700
"AL","1996-03-06",1996,3,66,10100,11100,10300,31500
"AL","1996-03-07",1996,3,67,237,11100,10400,21737
"AL","1996-03-08",1996,3,68,0,11100,10400,21500
"AL","1996-03-09",1996,3,69,0,11000,10500,21500
"AL","1996-03-10",1996,3,70,0,11000,10500,21500
"AL","1996-03-11",1996,3,71,0,11000,10500,21500
"AL","1996-03-12",1996,3,72,0,11000,10500,21500
"AL","1996-03-13",1996,3,73,0,10900,10600,21500
"AL","1996-03-14",1996,3,74,0,10900,10600,21500
"AL","1996-03-15",1996,3,75,0,10900,10600,21500
"AL","1996-03-16",1996,3,76,0,10900,10600,21500
"AL","1996-03-17",1996,3,77,0,10800,10600,21400
"AL","1996-03-18",1996,3,78,2610,10800,10500,23910
"AL","1996-03-19",1996,3,79,1190,10800,10500,22490
"AL","1996-03-20",1996,3,80,6510,10800,10400,27710
"AL","1996-03-21",1996,3,81,0,10800,10400,21200
"AL","1996-03-22",1996,3,82,0,10700,10400,21100
"AL","1996-03-23",1996,3,83,0,10700,10400,21100
"AL","1996-03-24",1996,3,84,0,10700,10500,21200
"AL","1996-03-25",1996,3,85,30700,10700,9930,51330
"AL","1996-03-26",1996,3,86,98300,10700,8580,117580
"AL","1996-03-27",1996,3,87,3280,10700,8820,22800
"AL","1996-03-28",1996,3,88,0,10600,9400,20000
"AL","1996-03-29",1996,3,89,0,10600,9630,20230
"AL","1996-03-30",1996,3,90,0,10600,9780,20380
"AL","1996-03-31",1996,3,91,0,10600,9870,20470
"AL","1996-04-01",1996,4,92,13700,10600,9700,34000
"AL","1996-04-02",1996,4,93,186,10600,9760,20546
"AL","1996-04-03",1996,4,94,4350,10500,9810,24660
"AL","1996-04-04",1996,4,95,186,10500,9890,20576
"AL","1996-04-05",1996,4,96,6560,10500,9830,26890
"AL","1996-04-06",1996,4,97,0,10500,9890,20390
"AL","1996-04-07",1996,4,98,0,10500,9980,20480
"AL","1996-04-08",1996,4,99,0,10400,10000,20400
"AL","1996-04-09",1996,4,100,0,10400,10000,20400
"AL","1996-04-10",1996,4,101,0,10400,10100,20500
"AL","1996-04-11",1996,4,102,0,10400,10100,20500
"AL","1996-04-12",1996,4,103,4430,10400,10000,24830
"AL","1996-04-13",1996,4,104,6690,10300,9950,26940
"AL","1996-04-14",1996,4,105,22400,10300,9600,42300
"AL","1996-04-15",1996,4,106,0,10300,9700,20000
"AL","1996-04-16",1996,4,107,9730,10300,9670,29700
"AL","1996-04-17",1996,4,108,768,10300,9750,20818
"AL","1996-04-18",1996,4,109,0,10300,9870,20170
"AL","1996-04-19",1996,4,110,5690,10300,9960,25950
"AL","1996-04-20",1996,4,111,16200,204000,193000,413200
"AL","1996-04-21",1996,4,112,285,100000,95100,195385
"AL","1996-04-22",1996,4,113,8670,30300,60800,99770
"AL","1996-04-23",1996,4,114,3320,67300,43000,113620
"AL","1996-04-24",1996,4,115,0,16500,15500,32000
"AL","1996-04-25",1996,4,116,209,20300,25700,46209
"AL","1996-04-26",1996,4,117,13100,44400,65200,122700
"AL","1996-04-27",1996,4,118,17300,67700,34300,119300
"AL","1996-04-28",1996,4,119,0,18300,17200,35500
"AL","1996-04-29",1996,4,120,0,18100,18200,36300
"AL","1996-04-30",1996,4,121,0,19400,20200,39600
"AL","1996-05-01",1996,5,122,13100,23600,23000,59700
"AL","1996-05-02",1996,5,123,3170,18700,18500,40370
"AL","1996-05-03",1996,5,124,0,18900,20800,39700
"AL","1996-05-04",1996,5,125,0,22300,26000,48300
"AL","1996-05-05",1996,5,126,0,23100,25900,49000
"AL","1996-05-06",1996,5,127,4600,25200,30100,59900
"AL","1996-05-07",1996,5,128,9270,18500,22800,50570
"AL","1996-05-08",1996,5,129,2490,20100,31800,54390
"AL","1996-05-09",1996,5,130,6510,18700,37700,62910
"AL","1996-05-10",1996,5,131,4920,17900,37900,60720
"AL","1996-05-11",1996,5,132,10600,18800,34900,64300
"AL","1996-05-12",1996,5,133,0,16300,19900,36200
"AL","1996-05-13",1996,5,134,0,16100,20000,36100
"AL","1996-05-14",1996,5,135,0,15600,19000,34600
"AL","1996-05-15",1996,5,136,554,15200,18800,34554
"AL","1996-05-16",1996,5,137,716,14900,18600,34216
"AL","1996-05-17",1996,5,138,0,14600,18300,32900
"AL","1996-05-18",1996,5,139,0,14400,18100,32500
"AL","1996-05-19",1996,5,140,3950,14000,17900,35850
"AL","1996-05-20",1996,5,141,56200,18000,31000,105200
"AL","1996-05-21",1996,5,142,738,14600,17900,33238
"AL","1996-05-22",1996,5,143,2770,14200,18000,34970
"AL","1996-05-23",1996,5,144,2290,13800,17800,33890
"AL","1996-05-24",1996,5,145,0,13600,17600,31200
"AL","1996-05-25",1996,5,146,0,13600,17500,31100
"AL","1996-05-26",1996,5,147,0,13500,17300,30800
"AL","1996-05-27",1996,5,148,0,13400,17100,30500
"AL","1996-05-28",1996,5,149,0,13200,16900,30100
"AL","1996-05-29",1996,5,150,0,12900,16600,29500
"AL","1996-05-30",1996,5,151,0,12900,16400,29300
"AL","1996-05-31",1996,5,152,0,12800,16100,28900
"AL","1996-06-01",1996,6,153,0,12700,15900,28600
"AL","1996-06-02",1996,6,154,0,12700,15700,28400
"AL","1996-06-03",1996,6,155,33100,16000,15900,65000
"AL","1996-06-04",1996,6,156,16200,15300,16200,47700
"AL","1996-06-05",1996,6,157,9210,15700,16000,40910
"AL","1996-06-06",1996,6,158,0,14100,15800,29900
"AL","1996-06-07",1996,6,159,27800,18800,17800,64400
"AL","1996-06-08",1996,6,160,2600,14900,15900,33400
"AL","1996-06-09",1996,6,161,921,14400,15900,31221
"AL","1996-06-10",1996,6,162,0,14000,15900,29900
"AL","1996-06-11",1996,6,163,3680,13300,15600,32580
"AL","1996-06-12",1996,6,164,3320,13400,15400,32120
"AL","1996-06-13",1996,6,165,1840,13100,15300,30240
"AL","1996-06-14",1996,6,166,6330,13600,15200,35130
"AL","1996-06-15",1996,6,167,0,13000,15000,28000
"AL","1996-06-16",1996,6,168,2580,12900,14900,30380
"AL","1996-06-17",1996,6,169,621,12800,14700,28121
"AL","1996-06-18",1996,6,170,1840,12700,14600,29140
"AL","1996-06-19",1996,6,171,15500,15200,14500,45200
"AL","1996-06-20",1996,6,172,5200,14900,14400,34500
"AL","1996-06-21",1996,6,173,414,13700,14400,28514
"AL","1996-06-22",1996,6,174,8280,13200,14400,35880
"AL","1996-06-23",1996,6,175,22000,17400,14900,54300
"AL","1996-06-24",1996,6,176,7910,14000,14500,36410
"AL","1996-06-25",1996,6,177,14000,16200,14900,45100
"AL","1996-06-26",1996,6,178,0,14100,14500,28600
"AL","1996-06-27",1996,6,179,26100,13800,15700,55600
"AL","1996-06-28",1996,6,180,44700,27000,28700,100400
"AL","1996-06-29",1996,6,181,0,15200,15200,30400
"AL","1996-06-30",1996,6,182,10700,14800,15400,40900
"AL","1996-07-01",1996,7,183,4310,14700,15100,34110
"AL","1996-07-02",1996,7,184,7820,13700,15200,36720
"AL","1996-07-03",1996,7,185,15300,15900,16000,47200
"AL","1996-07-04",1996,7,186,0,14000,14900,28900
"AL","1996-07-05",1996,7,187,0,13600,14900,28500
"AL","1996-07-06",1996,7,188,0,13000,14700,27700
"AL","1996-07-07",1996,7,189,3500,12900,14400,30800
"AL","1996-07-08",1996,7,190,19700,15400,14300,49400
"AL","1996-07-09",1996,7,191,16100,15600,14400,46100
"AL","1996-07-10",1996,7,192,525,14000,14100,28625
"AL","1996-07-11",1996,7,193,131,13400,14100,27631
"AL","1996-07-12",1996,7,194,0,13000,14000,27000
"AL","1996-07-13",1996,7,195,46000,16900,16900,79800
"AL","1996-07-14",1996,7,196,5710,14800,14300,34810
"AL","1996-07-15",1996,7,197,263,13700,14100,28063
"AL","1996-07-16",1996,7,198,321,13200,14000,27521
"AL","1996-07-17",1996,7,199,0,12800,13900,26700
"AL","1996-07-18",1996,7,200,0,12600,13800,26400
"AL","1996-07-19",1996,7,201,56400,21800,21900,100100
"AL","1996-07-20",1996,7,202,6320,15200,14000,35520
"AL","1996-07-21",1996,7,203,0,13700,13800,27500
"AL","1996-07-22",1996,7,204,1280,13600,13900,28780
"AL","1996-07-23",1996,7,205,0,13200,13700,26900
"AL","1996-07-24",1996,7,206,1920,12800,13500,28220
"AL","1996-07-25",1996,7,207,3970,13000,13400,30370
"AL","1996-07-26",1996,7,208,6640,13800,13300,33740
"AL","1996-07-27",1996,7,209,0,12800,13200,26000
"AL","1996-07-28",1996,7,210,0,12600,13200,25800
"AL","1996-07-29",1996,7,211,54700,14300,16300,85300
"AL","1996-07-30",1996,7,212,16800,16200,17000,50000
"AL","1996-07-31",1996,7,213,905,13600,13400,27905
"AL","1996-08-01",1996,8,214,2330,13200,13500,29030
"AL","1996-08-02",1996,8,215,0,12700,13500,26200
"AL","1996-08-03",1996,8,216,0,12600,13400,26000
"AL","1996-08-04",1996,8,217,0,12300,13400,25700
"AL","1996-08-05",1996,8,218,0,12100,13200,25300
"AL","1996-08-06",1996,8,219,27300,14600,13300,55200
"AL","1996-08-07",1996,8,220,90600,42300,44300,177200
"AL","1996-08-08",1996,8,221,31200,27500,30400,89100
"AL","1996-08-09",1996,8,222,0,16100,15200,31300
"AL","1996-08-10",1996,8,223,0,15500,14300,29800
"AL","1996-08-11",1996,8,224,0,15300,14300,29600
"AL","1996-08-12",1996,8,225,0,15000,14200,29200
"AL","1996-08-13",1996,8,226,1400,14700,14100,30200
"AL","1996-08-14",1996,8,227,8490,15500,14100,38090
"AL","1996-08-15",1996,8,228,2630,14400,13900,30930
"AL","1996-08-16",1996,8,229,16300,16500,14200,47000
"AL","1996-08-17",1996,8,230,0,14600,13800,28400
"AL","1996-08-18",1996,8,231,0,14300,13800,28100
"AL","1996-08-19",1996,8,232,0,13600,13600,27200
"AL","1996-08-20",1996,8,233,1230,13400,13400,28030
"AL","1996-08-21",1996,8,234,8780,15600,13300,37680
"AL","1996-08-22",1996,8,235,0,13900,13200,27100
"AL","1996-08-23",1996,8,236,66500,31700,24900,123100
"AL","1996-08-24",1996,8,237,0,15400,13100,28500
"AL","1996-08-25",1996,8,238,0,15000,13500,28500
"AL","1996-08-26",1996,8,239,0,14900,13500,28400
"AL","1996-08-27",1996,8,240,6500,15700,13400,35600
"AL","1996-08-28",1996,8,241,0,14600,13300,27900
"AL","1996-08-29",1996,8,242,0,14100,13300,27400
"AL","1996-08-30",1996,8,243,0,13500,13200,26700
"AL","1996-08-31",1996,8,244,0,13100,13100,26200
"AL","1996-09-01",1996,9,245,0,12900,13000,25900
"AL","1996-09-02",1996,9,246,0,12800,12900,25700
"AL","1996-09-03",1996,9,247,0,12700,12800,25500
"AL","1996-09-04",1996,9,248,3300,12700,12700,28700
"AL","1996-09-05",1996,9,249,41100,18800,13400,73300
"AL","1996-09-06",1996,9,250,0,14100,12400,26500
"AL","1996-09-07",1996,9,251,0,13800,12700,26500
"AL","1996-09-08",1996,9,252,0,13400,12700,26100
"AL","1996-09-09",1996,9,253,3850,13100,12700,29650
"AL","1996-09-10",1996,9,254,0,12800,12600,25400
"AL","1996-09-11",1996,9,255,2970,12700,12600,28270
"AL","1996-09-12",1996,9,256,13200,14700,12700,40600
"AL","1996-09-13",1996,9,257,1820,13900,12600,28320
"AL","1996-09-14",1996,9,258,0,13400,12600,26000
"AL","1996-09-15",1996,9,259,0,13200,12600,25800
"AL","1996-09-16",1996,9,260,0,13100,12600,25700
"AL","1996-09-17",1996,9,261,0,12900,12600,25500
"AL","1996-09-18",1996,9,262,0,12900,12500,25400
"AL","1996-09-19",1996,9,263,0,12700,12500,25200
"AL","1996-09-20",1996,9,264,0,12600,12500,25100
"AL","1996-09-21",1996,9,265,0,12500,12500,25000
"AL","1996-09-22",1996,9,266,5430,12500,12400,30330
"AL","1996-09-23",1996,9,267,5740,13200,12300,31240
"AL","1996-09-24",1996,9,268,4450,13200,12400,30050
"AL","1996-09-25",1996,9,269,1820,13200,12400,27420
"AL","1996-09-26",1996,9,270,12100,12900,12700,37700
"AL","1996-09-27",1996,9,271,0,13000,12400,25400
"AL","1996-09-28",1996,9,272,20500,16500,13100,50100
"AL","1996-09-29",1996,9,273,1790,14000,12300,28090
"AL","1996-09-30",1996,9,274,605,13600,12300,26505
"AL","1996-10-01",1996,10,275,1110,13400,12400,26910
"AL","1996-10-02",1996,10,276,0,13100,12300,25400
"AL","1996-10-03",1996,10,277,0,12900,12300,25200
"AL","1996-10-04",1996,10,278,0,12700,12200,24900
"AL","1996-10-05",1996,10,279,0,12600,12200,24800
"AL","1996-10-06",1996,10,280,0,12500,12200,24700
"AL","1996-10-07",1996,10,281,2830,12800,12200,27830
"AL","1996-10-08",1996,10,282,1110,12900,12200,26210
"AL","1996-10-09",1996,10,283,396,12900,12200,25496
"AL","1996-10-10",1996,10,284,4530,13400,12300,30230
"AL","1996-10-11",1996,10,285,728,13100,12100,25928
"AL","1996-10-12",1996,10,286,0,12900,12100,25000
"AL","1996-10-13",1996,10,287,0,13000,12200,25200
"AL","1996-10-14",1996,10,288,0,12900,12200,25100
"AL","1996-10-15",1996,10,289,1340,13000,12200,26540
"AL","1996-10-16",1996,10,290,2650,13300,12200,28150
"AL","1996-10-17",1996,10,291,17200,16300,12700,46200
"AL","1996-10-18",1996,10,292,35500,20000,20600,76100
"AL","1996-10-19",1996,10,293,4060,15000,14600,33660
"AL","1996-10-20",1996,10,294,0,14000,12200,26200
"AL","1996-10-21",1996,10,295,0,14000,12200,26200
"AL","1996-10-22",1996,10,296,5350,14600,12500,32450
"AL","1996-10-23",1996,10,297,6680,15700,14600,36980
"AL","1996-10-24",1996,10,298,39500,25300,30500,95300
"AL","1996-10-25",1996,10,299,11300,18600,19400,49300
"AL","1996-10-26",1996,10,300,0,15300,13400,28700
"AL","1996-10-27",1996,10,301,0,14800,12900,27700
"AL","1996-10-28",1996,10,302,0,14600,12800,27400
"AL","1996-10-29",1996,10,303,0,14500,12700,27200
"AL","1996-10-30",1996,10,304,44900,17600,16100,78600
"AL","1996-10-31",1996,10,305,44000,17800,17600,79400
"AL","1996-11-01",1996,11,306,243,15100,12800,28143
"AL","1996-11-02",1996,11,307,833,14800,12900,28533
"AL","1996-11-03",1996,11,308,918,14600,13000,28518
"AL","1996-11-04",1996,11,309,0,14500,13000,27500
"AL","1996-11-05",1996,11,310,4170,16600,17600,38370
"AL","1996-11-06",1996,11,311,9380,18200,20300,47880
"AL","1996-11-07",1996,11,312,833,20700,24800,46333
"AL","1996-11-08",1996,11,313,0,21100,22100,43200
"AL","1996-11-09",1996,11,314,0,16000,13800,29800
"AL","1996-11-10",1996,11,315,2250,15500,13500,31250
"AL","1996-11-11",1996,11,316,14100,15300,13300,42700
"AL","1996-11-12",1996,11,317,3440,15100,13400,31940
"AL","1996-11-13",1996,11,318,0,14900,13500,28400
"AL","1996-11-14",1996,11,319,0,14800,13500,28300
"AL","1996-11-15",1996,11,320,0,14700,13500,28200
"AL","1996-11-16",1996,11,321,0,14600,13400,28000
"AL","1996-11-17",1996,11,322,88000,14600,12300,114900
"AL","1996-11-18",1996,11,323,43100,14500,11800,69400
"AL","1996-11-19",1996,11,324,0,14400,12400,26800
"AL","1996-11-20",1996,11,325,0,14300,12900,27200
"AL","1996-11-21",1996,11,326,0,14300,13000,27300
"AL","1996-11-22",1996,11,327,0,14200,13100,27300
"AL","1996-11-23",1996,11,328,0,14100,13100,27200
"AL","1996-11-24",1996,11,329,2480,14100,13100,29680
"AL","1996-11-25",1996,11,330,833,14000,13000,27833
"AL","1996-11-26",1996,11,331,1150,14000,13000,28150
"AL","1996-11-27",1996,11,332,0,13900,13000,26900
"AL","1996-11-28",1996,11,333,0,13900,13000,26900
"AL","1996-11-29",1996,11,334,0,13800,12900,26700
"AL","1996-11-30",1996,11,335,6670,13800,12800,33270
"AL","1996-12-01",1996,12,336,20000,13700,12500,46200
"AL","1996-12-02",1996,12,337,129,13700,12600,26429
"AL","1996-12-03",1996,12,338,129,13700,12700,26529
"AL","1996-12-04",1996,12,339,0,13600,12700,26300
"AL","1996-12-05",1996,12,340,0,13600,12700,26300
"AL","1996-12-06",1996,12,341,2340,13600,12700,28640
"AL","1996-12-07",1996,12,342,5310,13500,12600,31410
"AL","1996-12-08",1996,12,343,4760,13500,12600,30860
"AL","1996-12-09",1996,12,344,129,13500,12600,26229
"AL","1996-12-10",1996,12,345,0,13500,12600,26100
"AL","1996-12-11",1996,12,346,0,13400,12600,26000
"AL","1996-12-12",1996,12,347,0,13400,12600,26000
"AL","1996-12-13",1996,12,348,561,13400,12600,26561
"AL","1996-12-14",1996,12,349,0,13400,12600,26000
"AL","1996-12-15",1996,12,350,0,13300,12600,25900
"AL","1996-12-16",1996,12,351,14300,13300,12300,39900
"AL","1996-12-17",1996,12,352,258,13300,12300,25858
"AL","1996-12-18",1996,12,353,0,13300,12400,25700
"AL","1996-12-19",1996,12,354,11500,13200,12300,37000
"AL","1996-12-20",1996,12,355,2870,13200,12300,28370
"AL","1996-12-21",1996,12,356,784,13200,12300,26284
"AL","1996-12-22",1996,12,357,667,13200,12400,26267
"AL","1996-12-23",1996,12,358,561,13200,12400,26161
"AL","1996-12-24",1996,12,359,6590,13100,12300,31990
"AL","1996-12-25",1996,12,360,4750,13100,12200,30050
"AL","1996-12-26",1996,12,361,0,13100,12300,25400
"AL","1996-12-27",1996,12,362,0,13100,12300,25400
"AL","1996-12-28",1996,12,363,3740,13100,12300,29140
"AL","1996-12-29",1996,12,364,1840,13100,12200,27140
"AL","1996-12-30",1996,12,365,784,13000,12300,26084
"AL","1996-12-31",1996,12,366,19600,13000,12000,44600
"AL","1997-01-01",1997,1,1,5800,13000,12000,30800
"AL","1997-01-02",1997,1,2,0,13000,12100,25100
"AL","1997-01-03",1997,1,3,215,13000,12200,25415
"AL","1997-01-04",1997,1,4,0,13000,12200,25200
"AL","1997-01-05",1997,1,5,509,12900,12200,25609
"AL","1997-01-06",1997,1,6,49900,12900,11500,74300
"AL","1997-01-07",1997,1,7,1410,12900,11700,26010
"AL","1997-01-08",1997,1,8,0,12900,12000,24900
"AL","1997-01-09",1997,1,9,0,12900,12100,25000
"AL","1997-01-10",1997,1,10,0,12900,12100,25000
"AL","1997-01-11",1997,1,11,8400,12800,12000,33200
"AL","1997-01-12",1997,1,12,2640,12800,12000,27440
"AL","1997-01-13",1997,1,13,215,12800,12100,25115
"AL","1997-01-14",1997,1,14,215,12800,12100,25115
"AL","1997-01-15",1997,1,15,0,12700,12100,24800
"AL","1997-01-16",1997,1,16,84.3,12700,12100,24884.3
"AL","1997-01-17",1997,1,17,215,12700,12100,25015
"AL","1997-01-18",1997,1,18,0,12700,12000,24700
"AL","1997-01-19",1997,1,19,2990,12700,12000,27690
"AL","1997-01-20",1997,1,20,0,12600,12000,24600
"AL","1997-01-21",1997,1,21,0,12600,12000,24600
"AL","1997-01-22",1997,1,22,0,12600,12000,24600
"AL","1997-01-23",1997,1,23,16000,12600,11700,40300
"AL","1997-01-24",1997,1,24,4630,12600,11700,28930
"AL","1997-01-25",1997,1,25,18900,12600,11500,43000
"AL","1997-01-26",1997,1,26,26900,12500,11200,50600
"AL","1997-01-27",1997,1,27,0,12500,11500,24000
"AL","1997-01-28",1997,1,28,2250,12500,11700,26450
"AL","1997-01-29",1997,1,29,1800,12500,11700,26000
"AL","1997-01-30",1997,1,30,3850,12500,11700,28050
"AL","1997-01-31",1997,1,31,156,12400,11700,24256
"AL","1997-02-01",1997,2,32,6190,12400,11700,30290
"AL","1997-02-02",1997,2,33,258,12400,11700,24358
"AL","1997-02-03",1997,2,34,0,12400,11800,24200
"AL","1997-02-04",1997,2,35,0,12400,11800,24200
"AL","1997-02-05",1997,2,36,0,12400,11700,24100
"AL","1997-02-06",1997,2,37,0,12300,11800,24100
"AL","1997-02-07",1997,2,38,0,12300,11700,24000
"AL","1997-02-08",1997,2,39,0,12300,11700,24000
"AL","1997-02-09",1997,2,40,0,12300,11700,24000
"AL","1997-02-10",1997,2,41,0,12200,11700,23900
"AL","1997-02-11",1997,2,42,0,12200,11700,23900
"AL","1997-02-12",1997,2,43,2890,12200,11600,26690
"AL","1997-02-13",1997,2,44,0,12200,11600,23800
"AL","1997-02-14",1997,2,45,0,12200,11600,23800
"AL","1997-02-15",1997,2,46,0,12100,11600,23700
"AL","1997-02-16",1997,2,47,93.8,12100,11600,23793.8
"AL","1997-02-17",1997,2,48,9680,12100,11400,33180
"AL","1997-02-18",1997,2,49,0,12100,11400,23500
"AL","1997-02-19",1997,2,50,0,12100,11500,23600
"AL","1997-02-20",1997,2,51,0,12000,11500,23500
"AL","1997-02-21",1997,2,52,0,12000,11500,23500
"AL","1997-02-22",1997,2,53,0,12000,11500,23500
"AL","1997-02-23",1997,2,54,0,12000,11500,23500
"AL","1997-02-24",1997,2,55,0,11900,11500,23400
"AL","1997-02-25",1997,2,56,0,11900,11500,23400
"AL","1997-02-26",1997,2,57,0,11900,11500,23400
"AL","1997-02-27",1997,2,58,0,11900,11400,23300
"AL","1997-02-28",1997,2,59,0,11900,11500,23400
"AL","1997-03-01",1997,3,60,1880,11800,11400,25080
"AL","1997-03-02",1997,3,61,5220,11800,11300,28320
"AL","1997-03-03",1997,3,62,0,11800,11300,23100
"AL","1997-03-04",1997,3,63,1380,11800,11300,24480
"AL","1997-03-05",1997,3,64,2310,11700,11300,25310
"AL","1997-03-06",1997,3,65,0,11700,11300,23000
"AL","1997-03-07",1997,3,66,0,11700,11300,23000
"AL","1997-03-08",1997,3,67,0,11700,11300,23000
"AL","1997-03-09",1997,3,68,0,11600,11300,22900
"AL","1997-03-10",1997,3,69,2580,11600,11300,25480
"AL","1997-03-11",1997,3,70,7670,11600,11100,30370
"AL","1997-03-12",1997,3,71,14200,11600,10900,36700
"AL","1997-03-13",1997,3,72,0,11600,11000,22600
"AL","1997-03-14",1997,3,73,0,11500,11100,22600
"AL","1997-03-15",1997,3,74,29600,11500,10600,51700
"AL","1997-03-16",1997,3,75,8770,11500,10500,30770
"AL","1997-03-17",1997,3,76,0,11500,10700,22200
"AL","1997-03-18",1997,3,77,0,11500,10800,22300
"AL","1997-03-19",1997,3,78,0,11400,10900,22300
"AL","1997-03-20",1997,3,79,0,11400,11000,22400
"AL","1997-03-21",1997,3,80,0,11400,11000,22400
"AL","1997-03-22",1997,3,81,0,11400,11100,22500
"AL","1997-03-23",1997,3,82,0,11400,11100,22500
"AL","1997-03-24",1997,3,83,4220,11300,11000,26520
"AL","1997-03-25",1997,3,84,6550,11300,10900,28750
"AL","1997-03-26",1997,3,85,16200,11300,10700,38200
"AL","1997-03-27",1997,3,86,0,11300,10800,22100
"AL","1997-03-28",1997,3,87,0,11300,10900,22200
"AL","1997-03-29",1997,3,88,12900,11200,10800,34900
"AL","1997-03-30",1997,3,89,33300,11200,10300,54800
"AL","1997-03-31",1997,3,90,345,11200,10400,21945
"AL","1997-04-01",1997,4,91,0,11200,10700,21900
"AL","1997-04-02",1997,4,92,0,11200,10700,21900
"AL","1997-04-03",1997,4,93,0,11200,10800,22000
"AL","1997-04-04",1997,4,94,854,13200,16300,30354
"AL","1997-04-05",1997,4,95,0,14500,18000,32500
"AL","1997-04-06",1997,4,96,7840,107000,140000,254840
"AL","1997-04-07",1997,4,97,9620,23900,23500,57020
"AL","1997-04-08",1997,4,98,3210,15000,13200,31410
"AL","1997-04-09",1997,4,99,1280,13900,11800,26980
"AL","1997-04-10",1997,4,100,0,13700,11900,25600
"AL","1997-04-11",1997,4,101,0,13500,12000,25500
"AL","1997-04-12",1997,4,102,0,13300,12100,25400
"AL","1997-04-13",1997,4,103,0,13100,12100,25200
"AL","1997-04-14",1997,4,104,0,12900,12100,25000
"AL","1997-04-15",1997,4,105,0,12700,12100,24800
"AL","1997-04-16",1997,4,106,0,12700,13800,26500
"AL","1997-04-17",1997,4,107,0,15300,19000,34300
"AL","1997-04-18",1997,4,108,0,12800,12900,25700
"AL","1997-04-19",1997,4,109,0,14100,16000,30100
"AL","1997-04-20",1997,4,110,1940,18800,25000,45740
"AL","1997-04-21",1997,4,111,2120,19600,24500,46220
"AL","1997-04-22",1997,4,112,0,16200,17900,34100
"AL","1997-04-23",1997,4,113,0,16600,19200,35800
"AL","1997-04-24",1997,4,114,0,17300,19700,37000
"AL","1997-04-25",1997,4,115,0,17500,20200,37700
"AL","1997-04-26",1997,4,116,0,17600,20500,38100
"AL","1997-04-27",1997,4,117,0,19200,23400,42600
"AL","1997-04-28",1997,4,118,3790,90000,129000,222790
"AL","1997-04-29",1997,4,119,0,77000,95800,172800
"AL","1997-04-30",1997,4,120,1640,60500,50500,112640
"AL","1997-05-01",1997,5,121,5890,24200,20200,50290
"AL","1997-05-02",1997,5,122,6580,18800,16500,41880
"AL","1997-05-03",1997,5,123,0,17400,15400,32800
"AL","1997-05-04",1997,5,124,0,17300,15600,32900
"AL","1997-05-05",1997,5,125,0,17100,15800,32900
"AL","1997-05-06",1997,5,126,13200,18900,17300,49400
"AL","1997-05-07",1997,5,127,8890,18700,16700,44290
"AL","1997-05-08",1997,5,128,5540,17200,16100,38840
"AL","1997-05-09",1997,5,129,9240,17500,16600,43340
"AL","1997-05-10",1997,5,130,1020,15900,16000,32920
"AL","1997-05-11",1997,5,131,0,15100,15800,30900
"AL","1997-05-12",1997,5,132,1850,15200,15800,32850
"AL","1997-05-13",1997,5,133,13900,16800,15900,46600
"AL","1997-05-14",1997,5,134,7590,16600,16000,40190
"AL","1997-05-15",1997,5,135,5140,16200,16000,37340
"AL","1997-05-16",1997,5,136,5590,16400,16400,38390
"AL","1997-05-17",1997,5,137,3690,15900,16000,35590
"AL","1997-05-18",1997,5,138,9650,17200,17300,44150
"AL","1997-05-19",1997,5,139,19900,20300,22500,62700
"AL","1997-05-20",1997,5,140,24800,23400,25500,73700
"AL","1997-05-21",1997,5,141,415,16500,16100,33015
"AL","1997-05-22",1997,5,142,0,15900,15800,31700
"AL","1997-05-23",1997,5,143,0,15700,15700,31400
"AL","1997-05-24",1997,5,144,12800,16900,16800,46500
"AL","1997-05-25",1997,5,145,4220,16400,15900,36520
"AL","1997-05-26",1997,5,146,3030,15900,15600,34530
"AL","1997-05-27",1997,5,147,0,15300,15400,30700
"AL","1997-05-28",1997,5,148,0,15100,15300,30400
"AL","1997-05-29",1997,5,149,0,14500,15100,29600
"AL","1997-05-30",1997,5,150,14700,15700,15100,45500
"AL","1997-05-31",1997,5,151,35700,22900,24200,82800
"AL","1997-06-01",1997,6,152,1480,16000,15100,32580
"AL","1997-06-02",1997,6,153,0,15100,15100,30200
"AL","1997-06-03",1997,6,154,0,14400,14900,29300
"AL","1997-06-04",1997,6,155,0,14100,14600,28700
"AL","1997-06-05",1997,6,156,11400,15000,14500,40900
"AL","1997-06-06",1997,6,157,27000,18400,15100,60500
"AL","1997-06-07",1997,6,158,24100,20500,18200,62800
"AL","1997-06-08",1997,6,159,1450,16100,14600,32150
"AL","1997-06-09",1997,6,160,1800,15700,14700,32200
"AL","1997-06-10",1997,6,161,0,15000,14600,29600
"AL","1997-06-11",1997,6,162,0,14500,14400,28900
"AL","1997-06-12",1997,6,163,0,14200,14300,28500
"AL","1997-06-13",1997,6,164,6100,14500,14100,34700
"AL","1997-06-14",1997,6,165,0,14000,13900,27900
"AL","1997-06-15",1997,6,166,0,13900,13900,27800
"AL","1997-06-16",1997,6,167,11600,14700,13800,40100
"AL","1997-06-17",1997,6,168,45900,22600,16400,84900
"AL","1997-06-18",1997,6,169,5520,16300,14100,35920
"AL","1997-06-19",1997,6,170,12200,17700,15800,45700
"AL","1997-06-20",1997,6,171,0,15700,14200,29900
"AL","1997-06-21",1997,6,172,2140,15300,14200,31640
"AL","1997-06-22",1997,6,173,0,14700,14100,28800
"AL","1997-06-23",1997,6,174,0,14500,14000,28500
"AL","1997-06-24",1997,6,175,0,14100,13800,27900
"AL","1997-06-25",1997,6,176,17500,15400,13900,46800
"AL","1997-06-26",1997,6,177,18800,17300,14100,50200
"AL","1997-06-27",1997,6,178,0,14800,13700,28500
"AL","1997-06-28",1997,6,179,0,14400,13700,28100
"AL","1997-06-29",1997,6,180,920,14000,13600,28520
"AL","1997-06-30",1997,6,181,20700,16300,13700,50700
"AL","1997-07-01",1997,7,182,31200,20100,17000,68300
"AL","1997-07-02",1997,7,183,1650,15400,13600,30650
"AL","1997-07-03",1997,7,184,23000,18700,16700,58400
"AL","1997-07-04",1997,7,185,11300,16900,15300,43500
"AL","1997-07-05",1997,7,186,15600,18900,18000,52500
"AL","1997-07-06",1997,7,187,583,15600,14000,30183
"AL","1997-07-07",1997,7,188,1120,15000,14000,30120
"AL","1997-07-08",1997,7,189,5600,15100,14000,34700
"AL","1997-07-09",1997,7,190,26500,20300,19500,66300
"AL","1997-07-10",1997,7,191,0,15300,13900,29200
"AL","1997-07-11",1997,7,192,0,14900,14100,29000
"AL","1997-07-12",1997,7,193,0,13900,13900,27800
"AL","1997-07-13",1997,7,194,1750,13700,13700,29150
"AL","1997-07-14",1997,7,195,6730,14200,13500,34430
"AL","1997-07-15",1997,7,196,16700,15800,13300,45800
"AL","1997-07-16",1997,7,197,0,14200,13200,27400
"AL","1997-07-17",1997,7,198,6390,14200,13200,33790
"AL","1997-07-18",1997,7,199,32600,19200,13900,65700
"AL","1997-07-19",1997,7,200,0,14600,13000,27600
"AL","1997-07-20",1997,7,201,0,14200,13200,27400
"AL","1997-07-21",1997,7,202,0,13700,13100,26800
"AL","1997-07-22",1997,7,203,0,13400,13000,26400
"AL","1997-07-23",1997,7,204,0,13300,12900,26200
"AL","1997-07-24",1997,7,205,394,13200,12900,26494
"AL","1997-07-25",1997,7,206,0,13100,12800,25900
"AL","1997-07-26",1997,7,207,0,13000,12800,25800
"AL","1997-07-27",1997,7,208,33700,17300,12800,63800
"AL","1997-07-28",1997,7,209,0,14000,12500,26500
"AL","1997-07-29",1997,7,210,0,13600,12800,26400
"AL","1997-07-30",1997,7,211,0,13000,12700,25700
"AL","1997-07-31",1997,7,212,0,12900,12600,25500
"AL","1997-08-01",1997,8,213,0,12800,12600,25400
"AL","1997-08-02",1997,8,214,13100,13900,12600,39600
"AL","1997-08-03",1997,8,215,0,12900,12600,25500
"AL","1997-08-04",1997,8,216,0,12600,12600,25200
"AL","1997-08-05",1997,8,217,6760,13200,12500,32460
"AL","1997-08-06",1997,8,218,0,12700,12500,25200
"AL","1997-08-07",1997,8,219,3870,12800,12500,29170
"AL","1997-08-08",1997,8,220,0,12400,12400,24800
"AL","1997-08-09",1997,8,221,0,12400,12400,24800
"AL","1997-08-10",1997,8,222,0,12300,12400,24700
"AL","1997-08-11",1997,8,223,1270,12300,12300,25870
"AL","1997-08-12",1997,8,224,0,12200,12300,24500
"AL","1997-08-13",1997,8,225,0,12200,12300,24500
"AL","1997-08-14",1997,8,226,3750,12500,12200,28450
"AL","1997-08-15",1997,8,227,9120,13100,12100,34320
"AL","1997-08-16",1997,8,228,79800,26500,25000,131300
"AL","1997-08-17",1997,8,229,52300,28800,34300,115400
"AL","1997-08-18",1997,8,230,18100,19400,19900,57400
"AL","1997-08-19",1997,8,231,12400,18600,17200,48200
"AL","1997-08-20",1997,8,232,0,15900,13500,29400
"AL","1997-08-21",1997,8,233,52600,29100,34600,116300
"AL","1997-08-22",1997,8,234,9490,18500,16500,44490
"AL","1997-08-23",1997,8,235,0,16500,14300,30800
"AL","1997-08-24",1997,8,236,2630,16200,14500,33330
"AL","1997-08-25",1997,8,237,5250,16400,14600,36250
"AL","1997-08-26",1997,8,238,175,15600,14400,30175
"AL","1997-08-27",1997,8,239,0,15100,14300,29400
"AL","1997-08-28",1997,8,240,0,14800,14200,29000
"AL","1997-08-29",1997,8,241,0,14600,14000,28600
"AL","1997-08-30",1997,8,242,0,14000,13700,27700
"AL","1997-08-31",1997,8,243,14700,15400,13700,43800
"AL","1997-09-01",1997,9,244,26600,19500,15700,61800
"AL","1997-09-02",1997,9,245,3960,15700,13700,33360
"AL","1997-09-03",1997,9,246,13400,17200,15400,46000
"AL","1997-09-04",1997,9,247,0,15200,13600,28800
"AL","1997-09-05",1997,9,248,0,14900,13600,28500
"AL","1997-09-06",1997,9,249,151,14500,13500,28151
"AL","1997-09-07",1997,9,250,0,14200,13400,27600
"AL","1997-09-08",1997,9,251,0,14000,13300,27300
"AL","1997-09-09",1997,9,252,0,13800,13200,27000
"AL","1997-09-10",1997,9,253,17500,15800,13200,46500
"AL","1997-09-11",1997,9,254,0,14400,13000,27400
"AL","1997-09-12",1997,9,255,0,14200,13000,27200
"AL","1997-09-13",1997,9,256,0,13900,13000,26900
"AL","1997-09-14",1997,9,257,1100,13700,12900,27700
"AL","1997-09-15",1997,9,258,3450,13800,12800,30050
"AL","1997-09-16",1997,9,259,549,13500,12800,26849
"AL","1997-09-17",1997,9,260,19800,15300,13200,48300
"AL","1997-09-18",1997,9,261,17000,17100,14300,48400
"AL","1997-09-19",1997,9,262,6040,15000,13300,34340
"AL","1997-09-20",1997,9,263,10300,16000,14200,40500
"AL","1997-09-21",1997,9,264,6250,15200,13400,34850
"AL","1997-09-22",1997,9,265,0,14300,12900,27200
"AL","1997-09-23",1997,9,266,0,14200,12900,27100
"AL","1997-09-24",1997,9,267,0,13900,12900,26800
"AL","1997-09-25",1997,9,268,0,13700,12800,26500
"AL","1997-09-26",1997,9,269,0,13500,12700,26200
"AL","1997-09-27",1997,9,270,0,13400,12700,26100
"AL","1997-09-28",1997,9,271,1320,13300,12600,27220
"AL","1997-09-29",1997,9,272,4150,13700,12600,30450
"AL","1997-09-30",1997,9,273,1870,13500,12500,27870
"AL","1997-10-01",1997,10,274,3890,13800,12500,30190
"AL","1997-10-02",1997,10,275,0,13400,12400,25800
"AL","1997-10-03",1997,10,276,0,13400,12400,25800
"AL","1997-10-04",1997,10,277,0,13100,12300,25400
"AL","1997-10-05",1997,10,278,0,12900,12300,25200
"AL","1997-10-06",1997,10,279,2010,12700,12200,26910
"AL","1997-10-07",1997,10,280,15400,14100,12300,41800
"AL","1997-10-08",1997,10,281,29800,19000,15900,64700
"AL","1997-10-09",1997,10,282,11500,16300,15600,43400
"AL","1997-10-10",1997,10,283,13000,18800,18500,50300
"AL","1997-10-11",1997,10,284,0,15100,13100,28200
"AL","1997-10-12",1997,10,285,0,14700,12600,27300
"AL","1997-10-13",1997,10,286,0,14700,12600,27300
"AL","1997-10-14",1997,10,287,53400,29700,31900,115000
"AL","1997-10-15",1997,10,288,2600,17000,15500,35100
"AL","1997-10-16",1997,10,289,243,15700,13200,29143
"AL","1997-10-17",1997,10,290,0,15600,13100,28700
"AL","1997-10-18",1997,10,291,0,15500,13100,28600
"AL","1997-10-19",1997,10,292,0,15300,13000,28300
"AL","1997-10-20",1997,10,293,5930,15800,13000,34730
"AL","1997-10-21",1997,10,294,7710,16800,14200,38710
"AL","1997-10-22",1997,10,295,705,15400,13400,29505
"AL","1997-10-23",1997,10,296,0,15000,13000,28000
"AL","1997-10-24",1997,10,297,0,14900,13000,27900
"AL","1997-10-25",1997,10,298,0,14900,12900,27800
"AL","1997-10-26",1997,10,299,0,14800,12800,27600
"AL","1997-10-27",1997,10,300,0,14700,12800,27500
"AL","1997-10-28",1997,10,301,0,14600,12700,27300
"AL","1997-10-29",1997,10,302,0,14500,12600,27100
"AL","1997-10-30",1997,10,303,0,14400,12600,27000
"AL","1997-10-31",1997,10,304,4020,14600,12800,31420
"AL","1997-11-01",1997,11,305,5100,15100,12900,33100
"AL","1997-11-02",1997,11,306,21300,20000,20300,61600
"AL","1997-11-03",1997,11,307,773,15100,13500,29373
"AL","1997-11-04",1997,11,308,0,14600,12600,27200
"AL","1997-11-05",1997,11,309,689,14600,12600,27889
"AL","1997-11-06",1997,11,310,0,14500,12500,27000
"AL","1997-11-07",1997,11,311,0,14400,12400,26800
"AL","1997-11-08",1997,11,312,0,14300,12400,26700
"AL","1997-11-09",1997,11,313,0,14300,12300,26600
"AL","1997-11-10",1997,11,314,833,14200,12300,27333
"AL","1997-11-11",1997,11,315,2170,14100,12200,28470
"AL","1997-11-12",1997,11,316,230,14100,12200,26530
"AL","1997-11-13",1997,11,317,689,14000,12200,26889
"AL","1997-11-14",1997,11,318,0,14000,12200,26200
"AL","1997-11-15",1997,11,319,1330,13900,12200,27430
"AL","1997-11-16",1997,11,320,2860,13900,12200,28960
"AL","1997-11-17",1997,11,321,1310,13900,12200,27410
"AL","1997-11-18",1997,11,322,0,13800,12300,26100
"AL","1997-11-19",1997,11,323,0,13800,12300,26100
"AL","1997-11-20",1997,11,324,0,13800,12300,26100
"AL","1997-11-21",1997,11,325,0,13800,12300,26100
"AL","1997-11-22",1997,11,326,0,13700,12200,25900
"AL","1997-11-23",1997,11,327,6060,13700,12100,31860
"AL","1997-11-24",1997,11,328,14200,13700,11900,39800
"AL","1997-11-25",1997,11,329,0,13600,12000,25600
"AL","1997-11-26",1997,11,330,0,13600,12100,25700
"AL","1997-11-27",1997,11,331,0,13600,12200,25800
"AL","1997-11-28",1997,11,332,0,13600,12200,25800
"AL","1997-11-29",1997,11,333,0,13500,12200,25700
"AL","1997-11-30",1997,11,334,0,13500,12200,25700
"AL","1997-12-01",1997,12,335,0,13500,12200,25700
"AL","1997-12-02",1997,12,336,0,13500,12200,25700
"AL","1997-12-03",1997,12,337,0,13400,12200,25600
"AL","1997-12-04",1997,12,338,3170,13400,12100,28670
"AL","1997-12-05",1997,12,339,5300,13400,12000,30700
"AL","1997-12-06",1997,12,340,14900,13300,11800,40000
"AL","1997-12-07",1997,12,341,10500,13300,11700,35500
"AL","1997-12-08",1997,12,342,0,13300,11900,25200
"AL","1997-12-09",1997,12,343,0,13300,12000,25300
"AL","1997-12-10",1997,12,344,0,13200,12000,25200
"AL","1997-12-11",1997,12,345,0,13200,12000,25200
"AL","1997-12-12",1997,12,346,0,13200,12000,25200
"AL","1997-12-13",1997,12,347,0,13200,12000,25200
"AL","1997-12-14",1997,12,348,0,13100,12000,25100
"AL","1997-12-15",1997,12,349,0,13100,12000,25100
"AL","1997-12-16",1997,12,350,0,13100,12000,25100
"AL","1997-12-17",1997,12,351,0,13000,12000,25000
"AL","1997-12-18",1997,12,352,0,13000,12000,25000
"AL","1997-12-19",1997,12,353,0,13000,12000,25000
"AL","1997-12-20",1997,12,354,0,13000,12000,25000
"AL","1997-12-21",1997,12,355,0,12900,12000,24900
"AL","1997-12-22",1997,12,356,0,12900,11900,24800
"AL","1997-12-23",1997,12,357,0,12900,11900,24800
"AL","1997-12-24",1997,12,358,0,12900,11900,24800
"AL","1997-12-25",1997,12,359,0,12800,11900,24700
"AL","1997-12-26",1997,12,360,0,12800,11900,24700
"AL","1997-12-27",1997,12,361,0,12800,11900,24700
"AL","1997-12-28",1997,12,362,0,12800,11900,24700
"AL","1997-12-29",1997,12,363,1770,12700,11800,26270
"AL","1997-12-30",1997,12,364,4460,12700,11700,28860
"AL","1997-12-31",1997,12,365,2810,12700,11700,27210
"AL","1998-01-01",1998,1,1,1870,12700,11600,26170
"AL","1998-01-02",1998,1,2,0,12700,11700,24400
"AL","1998-01-03",1998,1,3,0,12600,11700,24300
"AL","1998-01-04",1998,1,4,0,12600,11700,24300
"AL","1998-01-05",1998,1,5,0,12600,11700,24300
"AL","1998-01-06",1998,1,6,9670,12600,11500,33770
"AL","1998-01-07",1998,1,7,0,12600,11500,24100
"AL","1998-01-08",1998,1,8,0,12500,11600,24100
"AL","1998-01-09",1998,1,9,0,12500,11600,24100
"AL","1998-01-10",1998,1,10,10400,12500,11400,34300
"AL","1998-01-11",1998,1,11,430,12500,11400,24330
"AL","1998-01-12",1998,1,12,0,12400,11500,23900
"AL","1998-01-13",1998,1,13,6150,12400,11400,29950
"AL","1998-01-14",1998,1,14,5680,12400,11300,29380
"AL","1998-01-15",1998,1,15,1970,12400,11300,25670
"AL","1998-01-16",1998,1,16,23800,12400,11000,47200
"AL","1998-01-17",1998,1,17,6090,12400,11000,29490
"AL","1998-01-18",1998,1,18,7070,12300,11100,30470
"AL","1998-01-19",1998,1,19,5720,12300,11100,29120
"AL","1998-01-20",1998,1,20,0,12300,11200,23500
"AL","1998-01-21",1998,1,21,0,12300,11300,23600
"AL","1998-01-22",1998,1,22,0,12300,11300,23600
"AL","1998-01-23",1998,1,23,0,12200,11300,23500
"AL","1998-01-24",1998,1,24,11000,12200,11100,34300
"AL","1998-01-25",1998,1,25,0,12200,11200,23400
"AL","1998-01-26",1998,1,26,1870,12200,11200,25270
"AL","1998-01-27",1998,1,27,5140,12100,11100,28340
"AL","1998-01-28",1998,1,28,1080,12100,11200,24380
"AL","1998-01-29",1998,1,29,0,12100,11200,23300
"AL","1998-01-30",1998,1,30,0,12100,11300,23400
"AL","1998-01-31",1998,1,31,0,12000,11300,23300
"AL","1998-02-01",1998,2,32,0,12000,11300,23300
"AL","1998-02-02",1998,2,33,1880,12000,11200,25080
"AL","1998-02-03",1998,2,34,13500,12000,11000,36500
"AL","1998-02-04",1998,2,35,0,12000,11000,23000
"AL","1998-02-05",1998,2,36,0,11900,11100,23000
"AL","1998-02-06",1998,2,37,0,11900,11100,23000
"AL","1998-02-07",1998,2,38,0,11900,11100,23000
"AL","1998-02-08",1998,2,39,0,11900,11100,23000
"AL","1998-02-09",1998,2,40,0,11900,11200,23100
"AL","1998-02-10",1998,2,41,0,11800,11200,23000
"AL","1998-02-11",1998,2,42,0,11800,11200,23000
"AL","1998-02-12",1998,2,43,0,11800,11200,23000
"AL","1998-02-13",1998,2,44,0,11800,11200,23000
"AL","1998-02-14",1998,2,45,0,11700,11200,22900
"AL","1998-02-15",1998,2,46,0,11700,11100,22800
"AL","1998-02-16",1998,2,47,598,11700,11100,23398
"AL","1998-02-17",1998,2,48,129,11700,11100,22929
"AL","1998-02-18",1998,2,49,295,11700,11400,23395
"AL","1998-02-19",1998,2,50,0,11900,12100,24000
"AL","1998-02-20",1998,2,51,0,12100,12200,24300
"AL","1998-02-21",1998,2,52,0,12100,11800,23900
"AL","1998-02-22",1998,2,53,0,11800,11200,23000
"AL","1998-02-23",1998,2,54,0,11700,11200,22900
"AL","1998-02-24",1998,2,55,295,13200,14500,27995
"AL","1998-02-25",1998,2,56,1850,14100,16200,32150
"AL","1998-02-26",1998,2,57,0,13000,13700,26700
"AL","1998-02-27",1998,2,58,1180,16500,20800,38480
"AL","1998-02-28",1998,2,59,3520,18400,23400,45320
"AL","1998-03-01",1998,3,60,1300,15800,17700,34800
"AL","1998-03-02",1998,3,61,2500,17100,19900,39500
"AL","1998-03-03",1998,3,62,1700,17800,20600,40100
"AL","1998-03-04",1998,3,63,2180,14100,13200,29480
"AL","1998-03-05",1998,3,64,1770,13700,12400,27870
"AL","1998-03-06",1998,3,65,1210,13500,12200,26910
"AL","1998-03-07",1998,3,66,2820,13300,12200,28320
"AL","1998-03-08",1998,3,67,7280,13100,12000,32380
"AL","1998-03-09",1998,3,68,689,13000,12000,25689
"AL","1998-03-10",1998,3,69,3040,12800,12000,27840
"AL","1998-03-11",1998,3,70,991,12700,11900,25591
"AL","1998-03-12",1998,3,71,0,12600,11800,24400
"AL","1998-03-13",1998,3,72,172,12500,11800,24472
"AL","1998-03-14",1998,3,73,4240,12500,11700,28440
"AL","1998-03-15",1998,3,74,10200,12400,11500,34100
"AL","1998-03-16",1998,3,75,0,12400,11500,23900
"AL","1998-03-17",1998,3,76,0,12300,11600,23900
"AL","1998-03-18",1998,3,77,0,12300,11600,23900
"AL","1998-03-19",1998,3,78,1790,12200,11500,25490
"AL","1998-03-20",1998,3,79,10600,12200,11400,34200
"AL","1998-03-21",1998,3,80,0,12100,11400,23500
"AL","1998-03-22",1998,3,81,0,12100,11500,23600
"AL","1998-03-23",1998,3,82,0,12000,11500,23500
"AL","1998-03-24",1998,3,83,0,12000,11500,23500
"AL","1998-03-25",1998,3,84,0,11900,11500,23400
"AL","1998-03-26",1998,3,85,1400,12300,15400,29100
"AL","1998-03-27",1998,3,86,8110,25200,27200,60510
"AL","1998-03-28",1998,3,87,5680,16300,12600,34580
"AL","1998-03-29",1998,3,88,19300,18400,17300,55000
"AL","1998-03-30",1998,3,89,3530,13900,11700,29130
"AL","1998-03-31",1998,3,90,24800,19900,19600,64300
"AL","1998-04-01",1998,4,91,4930,14500,12500,31930
"AL","1998-04-02",1998,4,92,21800,17200,17100,56100
"AL","1998-04-03",1998,4,93,4040,16300,15400,35740
"AL","1998-04-04",1998,4,94,0,14000,12000,26000
"AL","1998-04-05",1998,4,95,0,13800,12000,25800
"AL","1998-04-06",1998,4,96,0,13600,11900,25500
"AL","1998-04-07",1998,4,97,5060,13900,12100,31060
"AL","1998-04-08",1998,4,98,14700,16600,15700,47000
"AL","1998-04-09",1998,4,99,174,13500,11800,25474
"AL","1998-04-10",1998,4,100,0,13400,11900,25300
"AL","1998-04-11",1998,4,101,0,13300,11800,25100
"AL","1998-04-12",1998,4,102,0,13200,11800,25000
"AL","1998-04-13",1998,4,103,379,13200,11700,25279
"AL","1998-04-14",1998,4,104,696,13100,11700,25496
"AL","1998-04-15",1998,4,105,5170,14000,11700,30870
"AL","1998-04-16",1998,4,106,0,12900,11600,24500
"AL","1998-04-17",1998,4,107,0,12900,11500,24400
"AL","1998-04-18",1998,4,108,0,12800,11500,24300
"AL","1998-04-19",1998,4,109,1010,12800,11600,25410
"AL","1998-04-20",1998,4,110,5380,13500,11700,30580
"AL","1998-04-21",1998,4,111,5170,13400,11600,30170
"AL","1998-04-22",1998,4,112,0,12700,11500,24200
"AL","1998-04-23",1998,4,113,0,12600,11500,24100
"AL","1998-04-24",1998,4,114,0,12600,11500,24100
"AL","1998-04-25",1998,4,115,0,12600,11500,24100
"AL","1998-04-26",1998,4,116,0,12500,11600,24100
"AL","1998-04-27",1998,4,117,0,12500,11600,24100
"AL","1998-04-28",1998,4,118,0,12500,11600,24100
"AL","1998-04-29",1998,4,119,0,12500,11600,24100
"AL","1998-04-30",1998,4,120,0,12400,11600,24000
"AL","1998-05-01",1998,5,121,0,12400,11700,24100
"AL","1998-05-02",1998,5,122,0,12400,11700,24100
"AL","1998-05-03",1998,5,123,0,12300,11800,24100
"AL","1998-05-04",1998,5,124,0,12300,11700,24000
"AL","1998-05-05",1998,5,125,369,12300,11800,24469
"AL","1998-05-06",1998,5,126,208,12300,11800,24308
"AL","1998-05-07",1998,5,127,0,12200,11800,24000
"AL","1998-05-08",1998,5,128,0,12200,11900,24100
"AL","1998-05-09",1998,5,129,7600,12100,12000,31700
"AL","1998-05-10",1998,5,130,0,11300,11700,23000
"AL","1998-05-11",1998,5,131,0,11000,11600,22600
"AL","1998-05-12",1998,5,132,0,10700,11500,22200
"AL","1998-05-13",1998,5,133,8120,11100,11300,30520
"AL","1998-05-14",1998,5,134,30600,14600,11600,56800
"AL","1998-05-15",1998,5,135,0,11700,10900,22600
"AL","1998-05-16",1998,5,136,7380,12000,11200,30580
"AL","1998-05-17",1998,5,137,20300,13700,11400,45400
"AL","1998-05-18",1998,5,138,0,11600,10900,22500
"AL","1998-05-19",1998,5,139,0,11400,11100,22500
"AL","1998-05-20",1998,5,140,0,10800,11000,21800
"AL","1998-05-21",1998,5,141,0,10700,11000,21700
"AL","1998-05-22",1998,5,142,0,10600,10900,21500
"AL","1998-05-23",1998,5,143,0,10600,10900,21500
"AL","1998-05-24",1998,5,144,0,10500,10800,21300
"AL","1998-05-25",1998,5,145,0,10500,10800,21300
"AL","1998-05-26",1998,5,146,0,10400,10700,21100
"AL","1998-05-27",1998,5,147,0,10400,10700,21100
"AL","1998-05-28",1998,5,148,9300,11000,10600,30900
"AL","1998-05-29",1998,5,149,17600,12900,10500,41000
"AL","1998-05-30",1998,5,150,0,11200,10400,21600
"AL","1998-05-31",1998,5,151,20300,12200,10500,43000
"AL","1998-06-01",1998,6,152,38500,16900,11500,66900
"AL","1998-06-02",1998,6,153,14900,14100,12000,41000
"AL","1998-06-03",1998,6,154,14200,15500,14500,44200
"AL","1998-06-04",1998,6,155,507,12500,10600,23607
"AL","1998-06-05",1998,6,156,0,12100,10700,22800
"AL","1998-06-06",1998,6,157,0,12000,10700,22700
"AL","1998-06-07",1998,6,158,0,11700,10700,22400
"AL","1998-06-08",1998,6,159,0,11500,10700,22200
"AL","1998-06-09",1998,6,160,0,11300,10700,22000
"AL","1998-06-10",1998,6,161,2390,11200,10700,24290
"AL","1998-06-11",1998,6,162,11800,12400,10700,34900
"AL","1998-06-12",1998,6,163,34200,15300,13400,62900
"AL","1998-06-13",1998,6,164,97100,40900,52200,190200
"AL","1998-06-14",1998,6,165,1240,16700,20900,38840
"AL","1998-06-15",1998,6,166,0,14000,11900,25900
"AL","1998-06-16",1998,6,167,0,13600,11800,25400
"AL","1998-06-17",1998,6,168,0,13200,11700,24900
"AL","1998-06-18",1998,6,169,0,12700,11700,24400
"AL","1998-06-19",1998,6,170,0,12300,11600,23900
"AL","1998-06-20",1998,6,171,0,12000,11400,23400
"AL","1998-06-21",1998,6,172,1010,11800,11300,24110
"AL","1998-06-22",1998,6,173,0,11700,11200,22900
"AL","1998-06-23",1998,6,174,0,11500,11200,22700
"AL","1998-06-24",1998,6,175,7730,11900,11100,30730
"AL","1998-06-25",1998,6,176,30400,15700,11300,57400
"AL","1998-06-26",1998,6,177,22000,15400,11600,49000
"AL","1998-06-27",1998,6,178,10600,13900,11300,35800
"AL","1998-06-28",1998,6,179,16000,14800,11800,42600
"AL","1998-06-29",1998,6,180,27300,18900,18500,64700
"AL","1998-06-30",1998,6,181,12900,14900,13700,41500
"AL","1998-07-01",1998,7,182,9230,14600,12300,36130
"AL","1998-07-02",1998,7,183,0,13100,11600,24700
"AL","1998-07-03",1998,7,184,0,12400,11600,24000
"AL","1998-07-04",1998,7,185,263,12000,11500,23763
"AL","1998-07-05",1998,7,186,131,11800,11400,23331
"AL","1998-07-06",1998,7,187,11000,12500,11300,34800
"AL","1998-07-07",1998,7,188,20300,14500,11400,46200
"AL","1998-07-08",1998,7,189,583,12500,11100,24183
"AL","1998-07-09",1998,7,190,3050,12300,11200,26550
"AL","1998-07-10",1998,7,191,0,11700,11200,22900
"AL","1998-07-11",1998,7,192,0,11500,11300,22800
"AL","1998-07-12",1998,7,193,0,11300,11200,22500
"AL","1998-07-13",1998,7,194,0,11200,11200,22400
"AL","1998-07-14",1998,7,195,0,11100,11200,22300
"AL","1998-07-15",1998,7,196,1520,11000,11100,23620
"AL","1998-07-16",1998,7,197,656,11000,11100,22756
"AL","1998-07-17",1998,7,198,0,10900,11200,22100
"AL","1998-07-18",1998,7,199,0,10900,11100,22000
"AL","1998-07-19",1998,7,200,0,10800,11000,21800
"AL","1998-07-20",1998,7,201,0,10800,11100,21900
"AL","1998-07-21",1998,7,202,0,10700,11000,21700
"AL","1998-07-22",1998,7,203,0,10700,11100,21800
"AL","1998-07-23",1998,7,204,0,10700,11100,21800
"AL","1998-07-24",1998,7,205,0,10600,11000,21600
"AL","1998-07-25",1998,7,206,0,10600,10900,21500
"AL","1998-07-26",1998,7,207,0,10600,10900,21500
"AL","1998-07-27",1998,7,208,6420,10900,10700,28020
"AL","1998-07-28",1998,7,209,4070,11100,10700,25870
"AL","1998-07-29",1998,7,210,0,10500,10800,21300
"AL","1998-07-30",1998,7,211,3150,10500,10800,24450
"AL","1998-07-31",1998,7,212,4890,11000,10700,26590
"AL","1998-08-01",1998,8,213,0,10400,10600,21000
"AL","1998-08-02",1998,8,214,0,10400,10700,21100
"AL","1998-08-03",1998,8,215,0,10300,10700,21000
"AL","1998-08-04",1998,8,216,0,10300,10700,21000
"AL","1998-08-05",1998,8,217,0,10300,10600,20900
"AL","1998-08-06",1998,8,218,2630,10300,10600,23530
"AL","1998-08-07",1998,8,219,2460,10400,10500,23360
"AL","1998-08-08",1998,8,220,3620,10700,10400,24720
"AL","1998-08-09",1998,8,221,9830,11200,10300,31330
"AL","1998-08-10",1998,8,222,834,10600,10300,21734
"AL","1998-08-11",1998,8,223,0,10300,10400,20700
"AL","1998-08-12",1998,8,224,0,10200,10500,20700
"AL","1998-08-13",1998,8,225,0,10100,10400,20500
"AL","1998-08-14",1998,8,226,0,10100,10400,20500
"AL","1998-08-15",1998,8,227,877,10100,10400,21377
"AL","1998-08-16",1998,8,228,4220,10400,10400,25020
"AL","1998-08-17",1998,8,229,12100,11000,10200,33300
"AL","1998-08-18",1998,8,230,41600,16700,9880,68180
"AL","1998-08-19",1998,8,231,0,11600,9600,21200
"AL","1998-08-20",1998,8,232,0,11500,9930,21430
"AL","1998-08-21",1998,8,233,0,11200,10100,21300
"AL","1998-08-22",1998,8,234,0,10700,10300,21000
"AL","1998-08-23",1998,8,235,9300,11100,10200,30600
"AL","1998-08-24",1998,8,236,41300,15700,10500,67500
"AL","1998-08-25",1998,8,237,725,11800,9810,22335
"AL","1998-08-26",1998,8,238,0,11400,10100,21500
"AL","1998-08-27",1998,8,239,0,11200,10200,21400
"AL","1998-08-28",1998,8,240,0,11000,10200,21200
"AL","1998-08-29",1998,8,241,5860,11200,10200,27260
"AL","1998-08-30",1998,8,242,242,10800,10200,21242
"AL","1998-08-31",1998,8,243,0,10500,10200,20700
"AL","1998-09-01",1998,9,244,0,10300,10300,20600
"AL","1998-09-02",1998,9,245,151,10200,10200,20551
"AL","1998-09-03",1998,9,246,2050,10200,10100,22350
"AL","1998-09-04",1998,9,247,0,10100,10100,20200
"AL","1998-09-05",1998,9,248,0,10200,10100,20300
"AL","1998-09-06",1998,9,249,0,10100,10100,20200
"AL","1998-09-07",1998,9,250,0,9980,10100,20080
"AL","1998-09-08",1998,9,251,0,9950,10100,20050
"AL","1998-09-09",1998,9,252,0,9910,10100,20010
"AL","1998-09-10",1998,9,253,0,9890,10000,19890
"AL","1998-09-11",1998,9,254,0,9880,10000,19880
"AL","1998-09-12",1998,9,255,0,9830,10000,19830
"AL","1998-09-13",1998,9,256,330,9800,10000,20130
"AL","1998-09-14",1998,9,257,4060,9920,9990,23970
"AL","1998-09-15",1998,9,258,1810,9890,9950,21650
"AL","1998-09-16",1998,9,259,797,9820,9940,20557
"AL","1998-09-17",1998,9,260,0,9710,9920,19630
"AL","1998-09-18",1998,9,261,0,9760,9920,19680
"AL","1998-09-19",1998,9,262,0,9700,9920,19620
"AL","1998-09-20",1998,9,263,1650,9660,9890,21200
"AL","1998-09-21",1998,9,264,303,9620,9880,19803
"AL","1998-09-22",1998,9,265,0,9590,9850,19440
"AL","1998-09-23",1998,9,266,0,9640,9790,19430
"AL","1998-09-24",1998,9,267,1650,9690,9730,21070
"AL","1998-09-25",1998,9,268,3570,9970,9680,23220
"AL","1998-09-26",1998,9,269,8130,10500,9520,28150
"AL","1998-09-27",1998,9,270,10700,11600,9380,31680
"AL","1998-09-28",1998,9,271,8360,11900,9380,29640
"AL","1998-09-29",1998,9,272,1210,11000,9580,21790
"AL","1998-09-30",1998,9,273,3890,11200,9680,24770
"AL","1998-10-01",1998,10,274,3850,11000,9710,24560
"AL","1998-10-02",1998,10,275,9640,11900,9850,31390
"AL","1998-10-03",1998,10,276,0,11100,9640,20740
"AL","1998-10-04",1998,10,277,0,10900,9740,20640
"AL","1998-10-05",1998,10,278,134,10700,9750,20584
"AL","1998-10-06",1998,10,279,7100,10900,9710,27710
"AL","1998-10-07",1998,10,280,13600,12600,10100,36300
"AL","1998-10-08",1998,10,281,9520,12600,10000,32120
"AL","1998-10-09",1998,10,282,1040,11500,9800,22340
"AL","1998-10-10",1998,10,283,0,11200,9710,20910
"AL","1998-10-11",1998,10,284,0,11200,9730,20930
"AL","1998-10-12",1998,10,285,402,11100,9710,21212
"AL","1998-10-13",1998,10,286,0,11100,9660,20760
"AL","1998-10-14",1998,10,287,184,11000,9670,20854
"AL","1998-10-15",1998,10,288,0,11000,9690,20690
"AL","1998-10-16",1998,10,289,854,11000,9710,21564
"AL","1998-10-17",1998,10,290,5760,11400,9780,26940
"AL","1998-10-18",1998,10,291,8430,12200,10000,30630
"AL","1998-10-19",1998,10,292,12400,14000,12500,38900
"AL","1998-10-20",1998,10,293,729,11600,10100,22429
"AL","1998-10-21",1998,10,294,0,11200,9670,20870
"AL","1998-10-22",1998,10,295,0,11200,9690,20890
"AL","1998-10-23",1998,10,296,0,11200,9670,20870
"AL","1998-10-24",1998,10,297,0,11100,9670,20770
"AL","1998-10-25",1998,10,298,0,11100,9660,20760
"AL","1998-10-26",1998,10,299,0,11000,9630,20630
"AL","1998-10-27",1998,10,300,4090,11400,9650,25140
"AL","1998-10-28",1998,10,301,0,10900,9610,20510
"AL","1998-10-29",1998,10,302,0,10800,9650,20450
"AL","1998-10-30",1998,10,303,1610,10900,9680,22190
"AL","1998-10-31",1998,10,304,5550,11600,9760,26910
"AL","1998-11-01",1998,11,305,1010,11100,9690,21800
"AL","1998-11-02",1998,11,306,0,10800,9690,20490
"AL","1998-11-03",1998,11,307,0,10800,9660,20460
"AL","1998-11-04",1998,11,308,0,10700,9660,20360
"AL","1998-11-05",1998,11,309,0,10700,9670,20370
"AL","1998-11-06",1998,11,310,0,10700,9680,20380
"AL","1998-11-07",1998,11,311,0,10700,9680,20380
"AL","1998-11-08",1998,11,312,0,10700,9690,20390
"AL","1998-11-09",1998,11,313,689,10700,9700,21089
"AL","1998-11-10",1998,11,314,6080,11100,9750,26930
"AL","1998-11-11",1998,11,315,21200,11700,9680,42580
"AL","1998-11-12",1998,11,316,23500,12200,10400,46100
"AL","1998-11-13",1998,11,317,0,11100,9370,20470
"AL","1998-11-14",1998,11,318,0,11000,9390,20390
"AL","1998-11-15",1998,11,319,0,11100,9980,21080
"AL","1998-11-16",1998,11,320,5830,11000,9560,26390
"AL","1998-11-17",1998,11,321,20500,10900,9130,40530
"AL","1998-11-18",1998,11,322,0,10900,9210,20110
"AL","1998-11-19",1998,11,323,4630,10900,9900,25430
"AL","1998-11-20",1998,11,324,10500,12400,12200,35100
"AL","1998-11-21",1998,11,325,1150,11100,9700,21950
"AL","1998-11-22",1998,11,326,0,10900,9470,20370
"AL","1998-11-23",1998,11,327,931,11000,10300,22231
"AL","1998-11-24",1998,11,328,1030,14100,16400,31530
"AL","1998-11-25",1998,11,329,0,12400,12400,24800
"AL","1998-11-26",1998,11,330,0,12400,12400,24800
"AL","1998-11-27",1998,11,331,0,13400,14200,27600
"AL","1998-11-28",1998,11,332,0,12900,12800,25700
"AL","1998-11-29",1998,11,333,0,11900,10100,22000
"AL","1998-11-30",1998,11,334,0,11400,9840,21240
"AL","1998-12-01",1998,12,335,2490,11600,9810,23900
"AL","1998-12-02",1998,12,336,0,11200,9730,20930
"AL","1998-12-03",1998,12,337,0,11100,9720,20820
"AL","1998-12-04",1998,12,338,0,11000,9710,20710
"AL","1998-12-05",1998,12,339,1680,11100,9710,22490
"AL","1998-12-06",1998,12,340,3340,11300,9740,24380
"AL","1998-12-07",1998,12,341,1150,11100,9710,21960
"AL","1998-12-08",1998,12,342,0,10900,9720,20620
"AL","1998-12-09",1998,12,343,0,10800,9730,20530
"AL","1998-12-10",1998,12,344,0,10800,9740,20540
"AL","1998-12-11",1998,12,345,0,10700,9740,20440
"AL","1998-12-12",1998,12,346,0,10700,9730,20430
"AL","1998-12-13",1998,12,347,0,10700,9720,20420
"AL","1998-12-14",1998,12,348,0,10600,9710,20310
"AL","1998-12-15",1998,12,349,0,10600,9710,20310
"AL","1998-12-16",1998,12,350,0,10600,9690,20290
"AL","1998-12-17",1998,12,351,0,10600,9670,20270
"AL","1998-12-18",1998,12,352,0,10500,9660,20160
"AL","1998-12-19",1998,12,353,2990,10500,9590,23080
"AL","1998-12-20",1998,12,354,6020,10500,9490,26010
"AL","1998-12-21",1998,12,355,258,10500,9510,20268
"AL","1998-12-22",1998,12,356,3360,10500,9480,23340
"AL","1998-12-23",1998,12,357,0,10500,9510,20010
"AL","1998-12-24",1998,12,358,0,10400,9530,19930
"AL","1998-12-25",1998,12,359,0,10400,9530,19930
"AL","1998-12-26",1998,12,360,0,10400,9530,19930
"AL","1998-12-27",1998,12,361,1060,10400,9520,20980
"AL","1998-12-28",1998,12,362,2890,10400,9470,22760
"AL","1998-12-29",1998,12,363,0,10300,9480,19780
"AL","1998-12-30",1998,12,364,7140,10300,9360,26800
"AL","1998-12-31",1998,12,365,0,10300,9390,19690
"AL","1999-01-01",1999,1,1,0,10300,9430,19730
"AL","1999-01-02",1999,1,2,0,10300,9440,19740
"AL","1999-01-03",1999,1,3,2970,10300,9390,22660
"AL","1999-01-04",1999,1,4,14800,10200,9140,34140
"AL","1999-01-05",1999,1,5,5140,10200,9090,24430
"AL","1999-01-06",1999,1,6,625,10200,9180,20005
"AL","1999-01-07",1999,1,7,2130,10200,9210,21540
"AL","1999-01-08",1999,1,8,0,10200,9250,19450
"AL","1999-01-09",1999,1,9,0,10200,9280,19480
"AL","1999-01-10",1999,1,10,2750,10200,9250,22200
"AL","1999-01-11",1999,1,11,351,10200,9260,19811
"AL","1999-01-12",1999,1,12,1250,10100,9270,20620
"AL","1999-01-13",1999,1,13,11700,10100,9080,30880
"AL","1999-01-14",1999,1,14,860,10100,9100,20060
"AL","1999-01-15",1999,1,15,0,10100,9180,19280
"AL","1999-01-16",1999,1,16,1090,10100,9190,20380
"AL","1999-01-17",1999,1,17,6350,10100,9110,25560
"AL","1999-01-18",1999,1,18,1410,10100,9130,20640
"AL","1999-01-19",1999,1,19,5310,10100,9080,24490
"AL","1999-01-20",1999,1,20,2460,10000,9080,21540
"AL","1999-01-21",1999,1,21,0,10000,9140,19140
"AL","1999-01-22",1999,1,22,0,10000,9190,19190
"AL","1999-01-23",1999,1,23,0,10000,9210,19210
"AL","1999-01-24",1999,1,24,19900,10000,8870,38770
"AL","1999-01-25",1999,1,25,9400,9990,8750,28140
"AL","1999-01-26",1999,1,26,1390,9980,8870,20240
"AL","1999-01-27",1999,1,27,2190,9970,8940,21100
"AL","1999-01-28",1999,1,28,12100,9960,8780,30840
"AL","1999-01-29",1999,1,29,5880,9950,8740,24570
"AL","1999-01-30",1999,1,30,0,9940,8870,18810
"AL","1999-01-31",1999,1,31,0,9930,8950,18880
"AL","1999-02-01",1999,2,32,0,9910,9020,18930
"AL","1999-02-02",1999,2,33,750,9900,9030,19680
"AL","1999-02-03",1999,2,34,2450,9880,9010,21340
"AL","1999-02-04",1999,2,35,0,9870,9050,18920
"AL","1999-02-05",1999,2,36,1030,9860,9060,19950
"AL","1999-02-06",1999,2,37,0,9840,9080,18920
"AL","1999-02-07",1999,2,38,0,9830,9100,18930
"AL","1999-02-08",1999,2,39,0,9820,9110,18930
"AL","1999-02-09",1999,2,40,0,9800,9120,18920
"AL","1999-02-10",1999,2,41,0,9790,9130,18920
"AL","1999-02-11",1999,2,42,0,9780,9140,18920
"AL","1999-02-12",1999,2,43,7780,9760,9000,26540
"AL","1999-02-13",1999,2,44,22200,9760,8630,40590
"AL","1999-02-14",1999,2,45,646,9750,8690,19086
"AL","1999-02-15",1999,2,46,0,9730,8860,18590
"AL","1999-02-16",1999,2,47,0,9720,8910,18630
"AL","1999-02-17",1999,2,48,2340,9710,8910,20960
"AL","1999-02-18",1999,2,49,9000,9700,8770,27470
"AL","1999-02-19",1999,2,50,129,9690,8830,18649
"AL","1999-02-20",1999,2,51,0,9670,8900,18570
"AL","1999-02-21",1999,2,52,0,9660,8930,18590
"AL","1999-02-22",1999,2,53,0,9650,8950,18600
"AL","1999-02-23",1999,2,54,0,9630,8970,18600
"AL","1999-02-24",1999,2,55,0,9620,8990,18610
"AL","1999-02-25",1999,2,56,1130,9610,8980,19720
"AL","1999-02-26",1999,2,57,5320,9600,8890,23810
"AL","1999-02-27",1999,2,58,0,9580,8920,18500
"AL","1999-02-28",1999,2,59,443,9570,8970,18983
"AL","1999-03-01",1999,3,60,0,9560,8980,18540
"AL","1999-03-02",1999,3,61,949,9550,8990,19489
"AL","1999-03-03",1999,3,62,2430,9540,8980,20950
"AL","1999-03-04",1999,3,63,949,9530,8970,19449
"AL","1999-03-05",1999,3,64,345,9510,8970,18825
"AL","1999-03-06",1999,3,65,1680,9500,8940,20120
"AL","1999-03-07",1999,3,66,0,9490,8950,18440
"AL","1999-03-08",1999,3,67,0,9480,8960,18440
"AL","1999-03-09",1999,3,68,0,9470,8960,18430
"AL","1999-03-10",1999,3,69,3560,9460,8920,21940
"AL","1999-03-11",1999,3,70,0,9440,8930,18370
"AL","1999-03-12",1999,3,71,0,9430,8960,18390
"AL","1999-03-13",1999,3,72,0,9420,8980,18400
"AL","1999-03-14",1999,3,73,0,9410,9000,18410
"AL","1999-03-15",1999,3,74,0,9400,9020,18420
"AL","1999-03-16",1999,3,75,0,9380,9050,18430
"AL","1999-03-17",1999,3,76,0,9370,9050,18420
"AL","1999-03-18",1999,3,77,2760,9360,9020,21140
"AL","1999-03-19",1999,3,78,6530,9390,9250,25170
"AL","1999-03-20",1999,3,79,0,9870,10300,20170
"AL","1999-03-21",1999,3,80,1210,10800,12400,24410
"AL","1999-03-22",1999,3,81,1190,10900,11900,23990
"AL","1999-03-23",1999,3,82,0,9770,9300,19070
"AL","1999-03-24",1999,3,83,0,9660,9080,18740
"AL","1999-03-25",1999,3,84,0,9620,9060,18680
"AL","1999-03-26",1999,3,85,0,9580,9060,18640
"AL","1999-03-27",1999,3,86,0,9550,9060,18610
"AL","1999-03-28",1999,3,87,0,10800,13200,24000
"AL","1999-03-29",1999,3,88,0,11800,14300,26100
"AL","1999-03-30",1999,3,89,5350,12900,16300,34550
"AL","1999-03-31",1999,3,90,0,13200,16200,29400
"AL","1999-04-01",1999,4,91,0,15900,21300,37200
"AL","1999-04-02",1999,4,92,142,22600,20900,43642
"AL","1999-04-03",1999,4,93,3920,12700,10800,27420
"AL","1999-04-04",1999,4,94,13100,14300,13600,41000
"AL","1999-04-05",1999,4,95,5680,12900,10600,29180
"AL","1999-04-06",1999,4,96,23300,16400,18400,58100
"AL","1999-04-07",1999,4,97,31500,15200,14100,60800
"AL","1999-04-08",1999,4,98,8510,16800,20100,45410
"AL","1999-04-09",1999,4,99,2510,15400,12400,30310
"AL","1999-04-10",1999,4,100,0,12500,9810,22310
"AL","1999-04-11",1999,4,101,126,12300,9860,22286
"AL","1999-04-12",1999,4,102,174,12100,9830,22104
"AL","1999-04-13",1999,4,103,0,11900,9790,21690
"AL","1999-04-14",1999,4,104,0,11800,9770,21570
"AL","1999-04-15",1999,4,105,0,11700,9800,21500
"AL","1999-04-16",1999,4,106,0,11500,9820,21320
"AL","1999-04-17",1999,4,107,0,11400,9850,21250
"AL","1999-04-18",1999,4,108,0,11300,9850,21150
"AL","1999-04-19",1999,4,109,372,11300,9860,21532
"AL","1999-04-20",1999,4,110,4650,11500,9990,26140
"AL","1999-04-21",1999,4,111,3250,11400,9840,24490
"AL","1999-04-22",1999,4,112,6260,12000,9900,28160
"AL","1999-04-23",1999,4,113,142,11100,9720,20962
"AL","1999-04-24",1999,4,114,0,10900,9700,20600
"AL","1999-04-25",1999,4,115,0,10900,9710,20610
"AL","1999-04-26",1999,4,116,0,10800,9730,20530
"AL","1999-04-27",1999,4,117,0,10800,9760,20560
"AL","1999-04-28",1999,4,118,0,10800,9780,20580
"AL","1999-04-29",1999,4,119,0,10700,9800,20500
"AL","1999-04-30",1999,4,120,0,10700,9810,20510
"AL","1999-05-01",1999,5,121,0,10600,9830,20430
"AL","1999-05-02",1999,5,122,0,10600,9900,20500
"AL","1999-05-03",1999,5,123,0,10600,9950,20550
"AL","1999-05-04",1999,5,124,0,10500,9990,20490
"AL","1999-05-05",1999,5,125,0,10500,9970,20470
"AL","1999-05-06",1999,5,126,8310,11300,10300,29910
"AL","1999-05-07",1999,5,127,83000,33800,40900,157700
"AL","1999-05-08",1999,5,128,129000,56600,72500,258100
"AL","1999-05-09",1999,5,129,54100,47500,50700,152300
"AL","1999-05-10",1999,5,130,487,18300,24500,43287
"AL","1999-05-11",1999,5,131,0,14700,13300,28000
"AL","1999-05-12",1999,5,132,0,14300,12200,26500
"AL","1999-05-13",1999,5,133,0,14200,12500,26700
"AL","1999-05-14",1999,5,134,0,14100,12600,26700
"AL","1999-05-15",1999,5,135,0,14100,12800,26900
"AL","1999-05-16",1999,5,136,369,13600,12600,26569
"AL","1999-05-17",1999,5,137,2770,13500,12500,28770
"AL","1999-05-18",1999,5,138,52500,23200,19700,95400
"AL","1999-05-19",1999,5,139,45300,29300,30500,105100
"AL","1999-05-20",1999,5,140,0,15400,13500,28900
"AL","1999-05-21",1999,5,141,6650,15700,13200,35550
"AL","1999-05-22",1999,5,142,66800,36800,41000,144600
"AL","1999-05-23",1999,5,143,18100,20700,22700,61500
"AL","1999-05-24",1999,5,144,48700,33700,35200,117600
"AL","1999-05-25",1999,5,145,1640,17600,14700,33940
"AL","1999-05-26",1999,5,146,208,16700,14600,31508
"AL","1999-05-27",1999,5,147,0,16300,14800,31100
"AL","1999-05-28",1999,5,148,0,16100,14900,31000
"AL","1999-05-29",1999,5,149,0,15100,14800,29900
"AL","1999-05-30",1999,5,150,0,14400,14600,29000
"AL","1999-05-31",1999,5,151,0,14200,14200,28400
"AL","1999-06-01",1999,6,152,0,14000,13900,27900
"AL","1999-06-02",1999,6,153,11800,15600,13800,41200
"AL","1999-06-03",1999,6,154,253,14100,13500,27853
"AL","1999-06-04",1999,6,155,0,14000,13500,27500
"AL","1999-06-05",1999,6,156,0,14000,13500,27500
"AL","1999-06-06",1999,6,157,736,13800,13400,27936
"AL","1999-06-07",1999,6,158,85800,33400,27300,146500
"AL","1999-06-08",1999,6,159,19100,20900,19400,59400
"AL","1999-06-09",1999,6,160,0,16300,13900,30200
"AL","1999-06-10",1999,6,161,4230,16200,14200,34630
"AL","1999-06-11",1999,6,162,9230,16900,14300,40430
"AL","1999-06-12",1999,6,163,8420,16800,14300,39520
"AL","1999-06-13",1999,6,164,22100,20200,17300,59600
"AL","1999-06-14",1999,6,165,0,16100,14200,30300
"AL","1999-06-15",1999,6,166,0,15700,14300,30000
"AL","1999-06-16",1999,6,167,0,15200,14200,29400
"AL","1999-06-17",1999,6,168,920,15100,14000,30020
"AL","1999-06-18",1999,6,169,7060,16000,14000,37060
"AL","1999-06-19",1999,6,170,0,15300,13900,29200
"AL","1999-06-20",1999,6,171,184,15100,13800,29084
"AL","1999-06-21",1999,6,172,1240,14800,13700,29740
"AL","1999-06-22",1999,6,173,0,14500,13600,28100
"AL","1999-06-23",1999,6,174,1840,14500,13500,29840
"AL","1999-06-24",1999,6,175,15400,16200,13400,45000
"AL","1999-06-25",1999,6,176,10400,16400,13400,40200
"AL","1999-06-26",1999,6,177,0,15100,13300,28400
"AL","1999-06-27",1999,6,178,0,14700,13300,28000
"AL","1999-06-28",1999,6,179,0,14200,13200,27400
"AL","1999-06-29",1999,6,180,2390,14100,13100,29590
"AL","1999-06-30",1999,6,181,6150,14800,13000,33950
"AL","1999-07-01",1999,7,182,16700,15900,13000,45600
"AL","1999-07-02",1999,7,183,2860,15200,13000,31060
"AL","1999-07-03",1999,7,184,11800,16100,13300,41200
"AL","1999-07-04",1999,7,185,13100,16300,13500,42900
"AL","1999-07-05",1999,7,186,18900,18100,13700,50700
"AL","1999-07-06",1999,7,187,5590,15600,13200,34390
"AL","1999-07-07",1999,7,188,22600,18500,13900,55000
"AL","1999-07-08",1999,7,189,0,15200,13200,28400
"AL","1999-07-09",1999,7,190,38500,19700,18300,76500
"AL","1999-07-10",1999,7,191,68800,37300,41600,147700
"AL","1999-07-11",1999,7,192,0,17900,16700,34600
"AL","1999-07-12",1999,7,193,0,16800,14100,30900
"AL","1999-07-13",1999,7,194,0,16300,14200,30500
"AL","1999-07-14",1999,7,195,1980,15700,14100,31780
"AL","1999-07-15",1999,7,196,583,15200,13900,29683
"AL","1999-07-16",1999,7,197,0,14800,13700,28500
"AL","1999-07-17",1999,7,198,817,14600,13600,29017
"AL","1999-07-18",1999,7,199,3150,14700,13400,31250
"AL","1999-07-19",1999,7,200,5250,14800,13300,33350
"AL","1999-07-20",1999,7,201,2130,14500,13200,29830
"AL","1999-07-21",1999,7,202,0,14000,13100,27100
"AL","1999-07-22",1999,7,203,3820,14200,13000,31020
"AL","1999-07-23",1999,7,204,6180,14400,13000,33580
"AL","1999-07-24",1999,7,205,5460,14500,12900,32860
"AL","1999-07-25",1999,7,206,0,13700,12900,26600
"AL","1999-07-26",1999,7,207,10500,14400,12900,37800
"AL","1999-07-27",1999,7,208,31800,18700,13300,63800
"AL","1999-07-28",1999,7,209,1120,14300,12600,28020
"AL","1999-07-29",1999,7,210,1980,14000,12700,28680
"AL","1999-07-30",1999,7,211,10700,15200,12700,38600
"AL","1999-07-31",1999,7,212,6530,14600,12700,33830
"AL","1999-08-01",1999,8,213,24900,17200,13100,55200
"AL","1999-08-02",1999,8,214,0,13900,12600,26500
"AL","1999-08-03",1999,8,215,9480,14200,12600,36280
"AL","1999-08-04",1999,8,216,17800,16200,12700,46700
"AL","1999-08-05",1999,8,217,10300,15900,12700,38900
"AL","1999-08-06",1999,8,218,11000,16200,12800,40000
"AL","1999-08-07",1999,8,219,6460,15400,12700,34560
"AL","1999-08-08",1999,8,220,3330,14800,12700,30830
"AL","1999-08-09",1999,8,221,2420,14500,12600,29520
"AL","1999-08-10",1999,8,222,4040,14300,12600,30940
"AL","1999-08-11",1999,8,223,7590,15000,12600,35190
"AL","1999-08-12",1999,8,224,175,14100,12500,26775
"AL","1999-08-13",1999,8,225,26800,16900,13500,57200
"AL","1999-08-14",1999,8,226,63200,32000,30800,126000
"AL","1999-08-15",1999,8,227,0,16000,13400,29400
"AL","1999-08-16",1999,8,228,5790,16100,13200,35090
"AL","1999-08-17",1999,8,229,17200,19800,17700,54700
"AL","1999-08-18",1999,8,230,0,15800,13100,28900
"AL","1999-08-19",1999,8,231,1230,15300,13200,29730
"AL","1999-08-20",1999,8,232,4260,15400,13100,32760
"AL","1999-08-21",1999,8,233,0,14700,13000,27700
"AL","1999-08-22",1999,8,234,790,14600,12900,28290
"AL","1999-08-23",1999,8,235,702,14200,12800,27702
"AL","1999-08-24",1999,8,236,8100,15000,12700,35800
"AL","1999-08-25",1999,8,237,1360,14300,12600,28260
"AL","1999-08-26",1999,8,238,0,13900,12600,26500
"AL","1999-08-27",1999,8,239,0,13700,12500,26200
"AL","1999-08-28",1999,8,240,0,13400,12500,25900
"AL","1999-08-29",1999,8,241,0,13100,12500,25600
"AL","1999-08-30",1999,8,242,0,13000,12400,25400
"AL","1999-08-31",1999,8,243,0,12900,12300,25200
"AL","1999-09-01",1999,9,244,0,12900,12200,25100
"AL","1999-09-02",1999,9,245,0,12800,12200,25000
"AL","1999-09-03",1999,9,246,330,12700,12200,25230
"AL","1999-09-04",1999,9,247,220,12600,12200,25020
"AL","1999-09-05",1999,9,248,1350,12500,12100,25950
"AL","1999-09-06",1999,9,249,962,12500,12100,25562
"AL","1999-09-07",1999,9,250,5220,13000,12000,30220
"AL","1999-09-08",1999,9,251,1540,12800,11900,26240
"AL","1999-09-09",1999,9,252,4320,13100,11900,29320
"AL","1999-09-10",1999,9,253,1320,12800,11800,25920
"AL","1999-09-11",1999,9,254,4370,13200,11800,29370
"AL","1999-09-12",1999,9,255,6730,13600,11800,32130
"AL","1999-09-13",1999,9,256,15500,15500,11900,42900
"AL","1999-09-14",1999,9,257,275,13400,11700,25375
"AL","1999-09-15",1999,9,258,673,13200,11800,25673
"AL","1999-09-16",1999,9,259,1350,13100,11800,26250
"AL","1999-09-17",1999,9,260,0,12900,11800,24700
"AL","1999-09-18",1999,9,261,0,12800,11800,24600
"AL","1999-09-19",1999,9,262,10800,13500,11800,36100
"AL","1999-09-20",1999,9,263,3960,13300,11700,28960
"AL","1999-09-21",1999,9,264,13400,14900,12100,40400
"AL","1999-09-22",1999,9,265,558,13400,11600,25558
"AL","1999-09-23",1999,9,266,0,13100,11700,24800
"AL","1999-09-24",1999,9,267,0,13000,11700,24700
"AL","1999-09-25",1999,9,268,0,12800,11700,24500
"AL","1999-09-26",1999,9,269,0,12600,11600,24200
"AL","1999-09-27",1999,9,270,1870,12500,11600,25970
"AL","1999-09-28",1999,9,271,7150,13300,11500,31950
"AL","1999-09-29",1999,9,272,1240,13200,11500,25940
"AL","1999-09-30",1999,9,273,0,12900,11500,24400
"AL","1999-10-01",1999,10,274,0,12800,11500,24300
"AL","1999-10-02",1999,10,275,0,12600,11500,24100
"AL","1999-10-03",1999,10,276,0,12400,11400,23800
"AL","1999-10-04",1999,10,277,0,12300,11300,23600
"AL","1999-10-05",1999,10,278,0,12200,11300,23500
"AL","1999-10-06",1999,10,279,0,12200,11300,23500
"AL","1999-10-07",1999,10,280,881,12100,11300,24281
"AL","1999-10-08",1999,10,281,8420,13000,11400,32820
"AL","1999-10-09",1999,10,282,25000,17100,12200,54300
"AL","1999-10-10",1999,10,283,6300,14600,11300,32200
"AL","1999-10-11",1999,10,284,0,13600,11200,24800
"AL","1999-10-12",1999,10,285,0,13300,11200,24500
"AL","1999-10-13",1999,10,286,134,13300,11200,24634
"AL","1999-10-14",1999,10,287,0,13200,11100,24300
"AL","1999-10-15",1999,10,288,2880,13400,11100,27380
"AL","1999-10-16",1999,10,289,10100,14900,11100,36100
"AL","1999-10-17",1999,10,290,1490,13600,11100,26190
"AL","1999-10-18",1999,10,291,452,13300,11000,24752
"AL","1999-10-19",1999,10,292,2690,13400,11000,27090
"AL","1999-10-20",1999,10,293,5860,14000,11000,30860
"AL","1999-10-21",1999,10,294,1080,13400,11000,25480
"AL","1999-10-22",1999,10,295,0,13000,11000,24000
"AL","1999-10-23",1999,10,296,335,13000,11000,24335
"AL","1999-10-24",1999,10,297,0,13000,11000,24000
"AL","1999-10-25",1999,10,298,0,12900,11000,23900
"AL","1999-10-26",1999,10,299,0,12900,11000,23900
"AL","1999-10-27",1999,10,300,0,12800,10900,23700
"AL","1999-10-28",1999,10,301,0,12800,10900,23700
"AL","1999-10-29",1999,10,302,0,12700,10900,23600
"AL","1999-10-30",1999,10,303,6030,13300,11100,30430
"AL","1999-10-31",1999,10,304,12800,15200,11400,39400
"AL","1999-11-01",1999,11,305,2800,13600,11300,27700
"AL","1999-11-02",1999,11,306,0,12900,10900,23800
"AL","1999-11-03",1999,11,307,0,12900,10900,23800
"AL","1999-11-04",1999,11,308,0,12800,10800,23600
"AL","1999-11-05",1999,11,309,0,12800,10800,23600
"AL","1999-11-06",1999,11,310,0,12700,10700,23400
"AL","1999-11-07",1999,11,311,0,12600,10800,23400
"AL","1999-11-08",1999,11,312,0,12600,10800,23400
"AL","1999-11-09",1999,11,313,0,12500,10800,23300
"AL","1999-11-10",1999,11,314,0,12500,10900,23400
"AL","1999-11-11",1999,11,315,0,12400,10900,23300
"AL","1999-11-12",1999,11,316,0,12400,10900,23300
"AL","1999-11-13",1999,11,317,0,12400,10900,23300
"AL","1999-11-14",1999,11,318,0,12300,10900,23200
"AL","1999-11-15",1999,11,319,0,12300,10900,23200
"AL","1999-11-16",1999,11,320,0,12200,10900,23100
"AL","1999-11-17",1999,11,321,0,12200,10900,23100
"AL","1999-11-18",1999,11,322,0,12200,10900,23100
"AL","1999-11-19",1999,11,323,0,12100,10900,23000
"AL","1999-11-20",1999,11,324,521,12100,10900,23521
"AL","1999-11-21",1999,11,325,105,12100,10800,23005
"AL","1999-11-22",1999,11,326,559,12100,10800,23459
"AL","1999-11-23",1999,11,327,0,12000,10800,22800
"AL","1999-11-24",1999,11,328,14500,13700,11500,39700
"AL","1999-11-25",1999,11,329,47900,13300,11200,72400
"AL","1999-11-26",1999,11,330,0,12400,10200,22600
"AL","1999-11-27",1999,11,331,1000,12700,11300,25000
"AL","1999-11-28",1999,11,332,1360,12400,10800,24560
"AL","1999-11-29",1999,11,333,0,12300,10600,22900
"AL","1999-11-30",1999,11,334,0,12200,10600,22800
"AL","1999-12-01",1999,12,335,0,12200,10600,22800
"AL","1999-12-02",1999,12,336,0,12100,10600,22700
"AL","1999-12-03",1999,12,337,0,12100,10700,22800
"AL","1999-12-04",1999,12,338,0,12100,10700,22800
"AL","1999-12-05",1999,12,339,0,12000,10700,22700
"AL","1999-12-06",1999,12,340,0,12000,10700,22700
"AL","1999-12-07",1999,12,341,0,11900,10600,22500
"AL","1999-12-08",1999,12,342,0,11900,10600,22500
"AL","1999-12-09",1999,12,343,0,11900,10600,22500
"AL","1999-12-10",1999,12,344,0,11800,10600,22400
"AL","1999-12-11",1999,12,345,0,11800,10600,22400
"AL","1999-12-12",1999,12,346,0,11800,10600,22400
"AL","1999-12-13",1999,12,347,655,11800,10600,23055
"AL","1999-12-14",1999,12,348,0,11700,10600,22300
"AL","1999-12-15",1999,12,349,0,11700,10600,22300
"AL","1999-12-16",1999,12,350,6320,11700,10400,28420
"AL","1999-12-17",1999,12,351,4660,11600,10300,26560
"AL","1999-12-18",1999,12,352,0,11600,10400,22000
"AL","1999-12-19",1999,12,353,0,11600,10400,22000
"AL","1999-12-20",1999,12,354,1120,11600,10400,23120
"AL","1999-12-21",1999,12,355,5800,11500,10300,27600
"AL","1999-12-22",1999,12,356,0,11500,10300,21800
"AL","1999-12-23",1999,12,357,0,11500,10300,21800
"AL","1999-12-24",1999,12,358,0,11500,10300,21800
"AL","1999-12-25",1999,12,359,0,11500,10300,21800
"AL","1999-12-26",1999,12,360,0,11400,10300,21700
"AL","1999-12-27",1999,12,361,0,11400,10300,21700
"AL","1999-12-28",1999,12,362,0,11400,10300,21700
"AL","1999-12-29",1999,12,363,3990,11400,10200,25590
"AL","1999-12-30",1999,12,364,2390,11300,10200,23890
"AL","1999-12-31",1999,12,365,0,11300,10200,21500
"AL","2000-01-01",2000,1,1,644,11300,10200,22144
"AL","2000-01-02",2000,1,2,1720,11300,10200,23220
"AL","2000-01-03",2000,1,3,18900,11200,9850,39950
"AL","2000-01-04",2000,1,4,1820,11200,9870,22890
"AL","2000-01-05",2000,1,5,860,11200,9980,22040
"AL","2000-01-06",2000,1,6,937,11200,9990,22127
"AL","2000-01-07",2000,1,7,9950,11200,9840,30990
"AL","2000-01-08",2000,1,8,215,11100,9880,21195
"AL","2000-01-09",2000,1,9,0,11100,9960,21060
"AL","2000-01-10",2000,1,10,10600,11100,9790,31490
"AL","2000-01-11",2000,1,11,4020,11100,9770,24890
"AL","2000-01-12",2000,1,12,430,11100,9850,21380
"AL","2000-01-13",2000,1,13,0,11000,9890,20890
"AL","2000-01-14",2000,1,14,0,11000,9930,20930
"AL","2000-01-15",2000,1,15,0,11000,9950,20950
"AL","2000-01-16",2000,1,16,742,11000,9950,21692
"AL","2000-01-17",2000,1,17,0,11000,9970,20970
"AL","2000-01-18",2000,1,18,1560,10900,9940,22400
"AL","2000-01-19",2000,1,19,5020,10900,9850,25770
"AL","2000-01-20",2000,1,20,2340,10900,9830,23070
"AL","2000-01-21",2000,1,21,1080,10900,9850,21830
"AL","2000-01-22",2000,1,22,0,10900,9880,20780
"AL","2000-01-23",2000,1,23,781,10800,9880,21461
"AL","2000-01-24",2000,1,24,4300,10800,9810,24910
"AL","2000-01-25",2000,1,25,468,10800,9820,21088
"AL","2000-01-26",2000,1,26,0,10800,9850,20650
"AL","2000-01-27",2000,1,27,0,10800,9860,20660
"AL","2000-01-28",2000,1,28,0,10700,9870,20570
"AL","2000-01-29",2000,1,29,0,10700,9870,20570
"AL","2000-01-30",2000,1,30,0,10700,9860,20560
"AL","2000-01-31",2000,1,31,0,10700,9860,20560
"AL","2000-02-01",2000,2,32,468,10700,9850,21018
"AL","2000-02-02",2000,2,33,775,10600,9830,21205
"AL","2000-02-03",2000,2,34,469,10600,9820,20889
"AL","2000-02-04",2000,2,35,4950,10600,9720,25270
"AL","2000-02-05",2000,2,36,1430,10600,9710,21740
"AL","2000-02-06",2000,2,37,0,10600,9730,20330
"AL","2000-02-07",2000,2,38,0,10500,9740,20240
"AL","2000-02-08",2000,2,39,0,10500,9740,20240
"AL","2000-02-09",2000,2,40,0,10500,9740,20240
"AL","2000-02-10",2000,2,41,1780,10500,9700,21980
"AL","2000-02-11",2000,2,42,4970,10500,9620,25090
"AL","2000-02-12",2000,2,43,2870,10500,9570,22940
"AL","2000-02-13",2000,2,44,563,10400,9590,20553
"AL","2000-02-14",2000,2,45,2300,10400,9570,22270
"AL","2000-02-15",2000,2,46,0,10400,9590,19990
"AL","2000-02-16",2000,2,47,4220,10400,9530,24150
"AL","2000-02-17",2000,2,48,12500,10400,9310,32210
"AL","2000-02-18",2000,2,49,0,10300,9360,19660
"AL","2000-02-19",2000,2,50,1180,10300,9430,20910
"AL","2000-02-20",2000,2,51,0,10300,9460,19760
"AL","2000-02-21",2000,2,52,0,10300,9490,19790
"AL","2000-02-22",2000,2,53,0,10300,9510,19810
"AL","2000-02-23",2000,2,54,0,10300,9520,19820
"AL","2000-02-24",2000,2,55,2720,10200,9480,22400
"AL","2000-02-25",2000,2,56,12600,10500,10900,34000
"AL","2000-02-26",2000,2,57,1620,17100,24500,43220
"AL","2000-02-27",2000,2,58,3730,18100,25600,47430
"AL","2000-02-28",2000,2,59,0,14000,15300,29300
"AL","2000-02-29",2000,2,60,0,12300,11200,23500
"AL","2000-03-01",2000,3,61,0,13100,12700,25800
"AL","2000-03-02",2000,3,62,0,13800,13700,27500
"AL","2000-03-03",2000,3,63,0,12300,11100,23400
"AL","2000-03-04",2000,3,64,0,12300,11300,23600
"AL","2000-03-05",2000,3,65,0,13800,14800,28600
"AL","2000-03-06",2000,3,66,0,15200,17700,32900
"AL","2000-03-07",2000,3,67,0,16200,18000,34200
"AL","2000-03-08",2000,3,68,0,15200,11000,26200
"AL","2000-03-09",2000,3,69,4560,12900,10300,27760
"AL","2000-03-10",2000,3,70,22100,16600,13300,52000
"AL","2000-03-11",2000,3,71,237,12800,10500,23537
"AL","2000-03-12",2000,3,72,0,12300,10200,22500
"AL","2000-03-13",2000,3,73,0,12200,10200,22400
"AL","2000-03-14",2000,3,74,0,12100,10100,22200
"AL","2000-03-15",2000,3,75,7060,12000,9960,29020
"AL","2000-03-16",2000,3,76,10400,11900,9760,32060
"AL","2000-03-17",2000,3,77,775,11800,9820,22395
"AL","2000-03-18",2000,3,78,0,11700,9900,21600
"AL","2000-03-19",2000,3,79,0,11700,9950,21650
"AL","2000-03-20",2000,3,80,2650,11600,9980,24230
"AL","2000-03-21",2000,3,81,0,11500,10200,21700
"AL","2000-03-22",2000,3,82,194,12800,12800,25794
"AL","2000-03-23",2000,3,83,209,11800,10100,22109
"AL","2000-03-24",2000,3,84,0,11400,10000,21400
"AL","2000-03-25",2000,3,85,930,11400,9940,22270
"AL","2000-03-26",2000,3,86,1820,11500,9870,23190
"AL","2000-03-27",2000,3,87,4000,11600,9890,25490
"AL","2000-03-28",2000,3,88,20200,14300,11500,46000
"AL","2000-03-29",2000,3,89,3620,12100,9970,25690
"AL","2000-03-30",2000,3,90,0,11500,9710,21210
"AL","2000-03-31",2000,3,91,0,11400,9740,21140
"AL","2000-04-01",2000,4,92,0,11300,9780,21080
"AL","2000-04-02",2000,4,93,0,11300,9690,20990
"AL","2000-04-03",2000,4,94,1390,11300,9670,22360
"AL","2000-04-04",2000,4,95,6700,12300,9720,28720
"AL","2000-04-05",2000,4,96,2980,11500,9690,24170
"AL","2000-04-06",2000,4,97,558,11200,9710,21468
"AL","2000-04-07",2000,4,98,4140,11600,9750,25490
"AL","2000-04-08",2000,4,99,0,11000,9700,20700
"AL","2000-04-09",2000,4,100,0,11000,9720,20720
"AL","2000-04-10",2000,4,101,256,11000,9710,20966
"AL","2000-04-11",2000,4,102,1860,11000,9740,22600
"AL","2000-04-12",2000,4,103,3310,11200,9740,24250
"AL","2000-04-13",2000,4,104,3650,11200,9770,24620
"AL","2000-04-14",2000,4,105,13800,12900,11300,38000
"AL","2000-04-15",2000,4,106,977,11400,9650,22027
"AL","2000-04-16",2000,4,107,3910,11400,9750,25060
"AL","2000-04-17",2000,4,108,30800,11200,9130,51130
"AL","2000-04-18",2000,4,109,8240,11100,9080,28420
"AL","2000-04-19",2000,4,110,3980,11100,9270,24350
"AL","2000-04-20",2000,4,111,506,14400,16400,31306
"AL","2000-04-21",2000,4,112,17500,16900,20700,55100
"AL","2000-04-22",2000,4,113,24600,14500,15300,54400
"AL","2000-04-23",2000,4,114,0,15800,17000,32800
"AL","2000-04-24",2000,4,115,0,14800,11900,26700
"AL","2000-04-25",2000,4,116,0,12600,10100,22700
"AL","2000-04-26",2000,4,117,0,12400,10000,22400
"AL","2000-04-27",2000,4,118,0,12300,10000,22300
"AL","2000-04-28",2000,4,119,0,12100,10000,22100
"AL","2000-04-29",2000,4,120,930,12000,10100,23030
"AL","2000-04-30",2000,4,121,2690,12300,10100,25090
"AL","2000-05-01",2000,5,122,2150,11900,10100,24150
"AL","2000-05-02",2000,5,123,2170,12000,10100,24270
"AL","2000-05-03",2000,5,124,0,11500,10100,21600
"AL","2000-05-04",2000,5,125,0,11500,10200,21700
"AL","2000-05-05",2000,5,126,0,11500,10300,21800
"AL","2000-05-06",2000,5,127,0,11400,10300,21700
"AL","2000-05-07",2000,5,128,0,11400,10300,21700
"AL","2000-05-08",2000,5,129,4800,11000,10400,26200
"AL","2000-05-09",2000,5,130,14300,12300,10600,37200
"AL","2000-05-10",2000,5,131,1430,10700,10000,22130
"AL","2000-05-11",2000,5,132,5540,10900,10100,26540
"AL","2000-05-12",2000,5,133,9070,11500,10100,30670
"AL","2000-05-13",2000,5,134,21300,14100,12400,47800
"AL","2000-05-14",2000,5,135,923,11300,9800,22023
"AL","2000-05-15",2000,5,136,3370,11300,9920,24590
"AL","2000-05-16",2000,5,137,0,10800,9900,20700
"AL","2000-05-17",2000,5,138,2400,10800,9910,23110
"AL","2000-05-18",2000,5,139,0,10300,9830,20130
"AL","2000-05-19",2000,5,140,2030,10300,9780,22110
"AL","2000-05-20",2000,5,141,0,10200,9740,19940
"AL","2000-05-21",2000,5,142,0,10200,9780,19980
"AL","2000-05-22",2000,5,143,1290,9890,9720,20900
"AL","2000-05-23",2000,5,144,2190,9840,9670,21700
"AL","2000-05-24",2000,5,145,5030,10200,9640,24870
"AL","2000-05-25",2000,5,146,2400,10000,9590,21990
"AL","2000-05-26",2000,5,147,5080,10200,9570,24850
"AL","2000-05-27",2000,5,148,0,9810,9560,19370
"AL","2000-05-28",2000,5,149,13200,11100,9540,33840
"AL","2000-05-29",2000,5,150,15300,12200,9570,37070
"AL","2000-05-30",2000,5,151,369,10500,9440,20309
"AL","2000-05-31",2000,5,152,0,10200,9550,19750
"AL","2000-06-01",2000,6,153,508,9980,9580,20068
"AL","2000-06-02",2000,6,154,10300,10500,9560,30360
"AL","2000-06-03",2000,6,155,23600,13000,9940,46540
"AL","2000-06-04",2000,6,156,552,10600,9330,20482
"AL","2000-06-05",2000,6,157,3620,10700,9500,23820
"AL","2000-06-06",2000,6,158,1730,10400,9510,21640
"AL","2000-06-07",2000,6,159,0,10000,9530,19530
"AL","2000-06-08",2000,6,160,1470,9920,9560,20950
"AL","2000-06-09",2000,6,161,6050,10200,9530,25780
"AL","2000-06-10",2000,6,162,0,9660,9570,19230
"AL","2000-06-11",2000,6,163,1840,9500,9590,20930
"AL","2000-06-12",2000,6,164,1290,9520,9520,20330
"AL","2000-06-13",2000,6,165,0,9400,9450,18850
"AL","2000-06-14",2000,6,166,1100,9410,9390,19900
"AL","2000-06-15",2000,6,167,10400,10200,9280,29880
"AL","2000-06-16",2000,6,168,26200,12100,9090,47390
"AL","2000-06-17",2000,6,169,18300,12400,9190,39890
"AL","2000-06-18",2000,6,170,3820,10900,9050,23770
"AL","2000-06-19",2000,6,171,11000,11300,9390,31690
"AL","2000-06-20",2000,6,172,33800,15300,14800,63900
"AL","2000-06-21",2000,6,173,36200,18600,22500,77300
"AL","2000-06-22",2000,6,174,93500,40000,48600,182100
"AL","2000-06-23",2000,6,175,12900,18900,22000,53800
"AL","2000-06-24",2000,6,176,7200,14900,12300,34400
"AL","2000-06-25",2000,6,177,10300,15100,12100,37500
"AL","2000-06-26",2000,6,178,10800,14900,12800,38500
"AL","2000-06-27",2000,6,179,30600,21000,21700,73300
"AL","2000-06-28",2000,6,180,0,13800,11200,25000
"AL","2000-06-29",2000,6,181,5890,13800,11400,31090
"AL","2000-06-30",2000,6,182,5640,14000,11400,31040
"AL","2000-07-01",2000,7,183,0,13000,11300,24300
"AL","2000-07-02",2000,7,184,9330,13300,11300,33930
"AL","2000-07-03",2000,7,185,15100,15000,11900,42000
"AL","2000-07-04",2000,7,186,6110,13700,11200,31010
"AL","2000-07-05",2000,7,187,0,12600,11200,23800
"AL","2000-07-06",2000,7,188,0,12100,11100,23200
"AL","2000-07-07",2000,7,189,2760,11900,11000,25660
"AL","2000-07-08",2000,7,190,31500,14800,12100,58400
"AL","2000-07-09",2000,7,191,65000,32600,35700,133300
"AL","2000-07-10",2000,7,192,66800,35300,40900,143000
"AL","2000-07-11",2000,7,193,0,16300,16000,32300
"AL","2000-07-12",2000,7,194,0,14600,12100,26700
"AL","2000-07-13",2000,7,195,0,14200,12300,26500
"AL","2000-07-14",2000,7,196,4470,14300,12200,30970
"AL","2000-07-15",2000,7,197,1970,13800,12100,27870
"AL","2000-07-16",2000,7,198,0,13100,11900,25000
"AL","2000-07-17",2000,7,199,0,12800,11800,24600
"AL","2000-07-18",2000,7,200,0,12400,11700,24100
"AL","2000-07-19",2000,7,201,0,12300,11600,23900
"AL","2000-07-20",2000,7,202,1170,12100,11500,24770
"AL","2000-07-21",2000,7,203,4600,12500,11500,28600
"AL","2000-07-22",2000,7,204,1930,12100,11400,25430
"AL","2000-07-23",2000,7,205,0,11800,11300,23100
"AL","2000-07-24",2000,7,206,0,11800,11300,23100
"AL","2000-07-25",2000,7,207,0,11600,11400,23000
"AL","2000-07-26",2000,7,208,3500,11600,11300,26400
"AL","2000-07-27",2000,7,209,19800,14100,11200,45100
"AL","2000-07-28",2000,7,210,6890,13400,11100,31390
"AL","2000-07-29",2000,7,211,9560,13700,11200,34460
"AL","2000-07-30",2000,7,212,5710,13300,11200,30210
"AL","2000-07-31",2000,7,213,0,12300,11200,23500
"AL","2000-08-01",2000,8,214,2100,12000,11300,25400
"AL","2000-08-02",2000,8,215,13400,13100,11300,37800
"AL","2000-08-03",2000,8,216,0,12000,11200,23200
"AL","2000-08-04",2000,8,217,0,11800,11300,23100
"AL","2000-08-05",2000,8,218,0,11600,11400,23000
"AL","2000-08-06",2000,8,219,0,11500,11400,22900
"AL","2000-08-07",2000,8,220,1820,11300,11300,24420
"AL","2000-08-08",2000,8,221,3290,11600,11300,26190
"AL","2000-08-09",2000,8,222,20000,13300,11300,44600
"AL","2000-08-10",2000,8,223,23600,16100,11800,51500
"AL","2000-08-11",2000,8,224,0,12700,11200,23900
"AL","2000-08-12",2000,8,225,0,12200,11300,23500
"AL","2000-08-13",2000,8,226,877,11900,11300,24077
"AL","2000-08-14",2000,8,227,5490,12200,11300,28990
"AL","2000-08-15",2000,8,228,26300,14500,11800,52600
"AL","2000-08-16",2000,8,229,81200,33900,34700,149800
"AL","2000-08-17",2000,8,230,6670,15300,13100,35070
"AL","2000-08-18",2000,8,231,16100,17900,16300,50300
"AL","2000-08-19",2000,8,232,2790,15100,12000,29890
"AL","2000-08-20",2000,8,233,0,14600,11900,26500
"AL","2000-08-21",2000,8,234,0,14400,11900,26300
"AL","2000-08-22",2000,8,235,526,13900,11900,26326
"AL","2000-08-23",2000,8,236,197,13600,11800,25597
"AL","2000-08-24",2000,8,237,0,13300,11800,25100
"AL","2000-08-25",2000,8,238,0,12900,11800,24700
"AL","2000-08-26",2000,8,239,8420,13100,11700,33220
"AL","2000-08-27",2000,8,240,3090,13200,11600,27890
"AL","2000-08-28",2000,8,241,0,12700,11600,24300
"AL","2000-08-29",2000,8,242,0,12700,11600,24300
"AL","2000-08-30",2000,8,243,0,12500,11600,24100
"AL","2000-08-31",2000,8,244,877,12300,11500,24677
"AL","2000-09-01",2000,9,245,1560,12200,11500,25260
"AL","2000-09-02",2000,9,246,330,12000,11500,23830
"AL","2000-09-03",2000,9,247,21900,14500,11500,47900
"AL","2000-09-04",2000,9,248,22100,16800,11900,50800
"AL","2000-09-05",2000,9,249,0,13500,11300,24800
"AL","2000-09-06",2000,9,250,0,13300,11500,24800
"AL","2000-09-07",2000,9,251,0,13000,11500,24500
"AL","2000-09-08",2000,9,252,0,12700,11500,24200
"AL","2000-09-09",2000,9,253,303,12500,11400,24203
"AL","2000-09-10",2000,9,254,2970,12500,11400,26870
"AL","2000-09-11",2000,9,255,4080,12800,11400,28280
"AL","2000-09-12",2000,9,256,6790,13100,11400,31290
"AL","2000-09-13",2000,9,257,7940,13600,11400,32940
"AL","2000-09-14",2000,9,258,0,12800,11300,24100
"AL","2000-09-15",2000,9,259,1910,12700,11300,25910
"AL","2000-09-16",2000,9,260,2470,12700,11300,26470
"AL","2000-09-17",2000,9,261,0,12400,11300,23700
"AL","2000-09-18",2000,9,262,0,12400,11300,23700
"AL","2000-09-19",2000,9,263,0,12200,11300,23500
"AL","2000-09-20",2000,9,264,6060,12600,11300,29960
"AL","2000-09-21",2000,9,265,4870,12600,11200,28670
"AL","2000-09-22",2000,9,266,908,12300,11200,24408
"AL","2000-09-23",2000,9,267,7180,13100,11100,31380
"AL","2000-09-24",2000,9,268,5010,13300,11200,29510
"AL","2000-09-25",2000,9,269,605,12900,11100,24605
"AL","2000-09-26",2000,9,270,0,12600,11100,23700
"AL","2000-09-27",2000,9,271,0,12500,11200,23700
"AL","2000-09-28",2000,9,272,0,12300,11200,23500
"AL","2000-09-29",2000,9,273,0,12100,11100,23200
"AL","2000-09-30",2000,9,274,0,11900,11100,23000
"AL","2000-10-01",2000,10,275,124,11800,11100,23024
"AL","2000-10-02",2000,10,276,0,11600,11100,22700
"AL","2000-10-03",2000,10,277,0,11400,11000,22400
"AL","2000-10-04",2000,10,278,0,11300,10900,22200
"AL","2000-10-05",2000,10,279,670,11300,10800,22770
"AL","2000-10-06",2000,10,280,881,11300,10800,22981
"AL","2000-10-07",2000,10,281,21900,11900,10400,44200
"AL","2000-10-08",2000,10,282,10200,12100,10200,32500
"AL","2000-10-09",2000,10,283,0,13200,10900,24100
"AL","2000-10-10",2000,10,284,0,13400,11200,24600
"AL","2000-10-11",2000,10,285,0,12500,10800,23300
"AL","2000-10-12",2000,10,286,0,12500,10800,23300
"AL","2000-10-13",2000,10,287,9760,13700,10800,34260
"AL","2000-10-14",2000,10,288,4770,13400,10800,28970
"AL","2000-10-15",2000,10,289,8100,13900,10900,32900
"AL","2000-10-16",2000,10,290,0,12900,10700,23600
"AL","2000-10-17",2000,10,291,184,12600,10700,23484
"AL","2000-10-18",2000,10,292,0,12600,10700,23300
"AL","2000-10-19",2000,10,293,0,12600,10600,23200
"AL","2000-10-20",2000,10,294,0,12500,10600,23100
"AL","2000-10-21",2000,10,295,0,12500,10600,23100
"AL","2000-10-22",2000,10,296,0,12400,10600,23000
"AL","2000-10-23",2000,10,297,7600,13400,10600,31600
"AL","2000-10-24",2000,10,298,4930,13200,10700,28830
"AL","2000-10-25",2000,10,299,369,12500,10500,23369
"AL","2000-10-26",2000,10,300,0,12400,10500,22900
"AL","2000-10-27",2000,10,301,1470,12400,10500,24370
"AL","2000-10-28",2000,10,302,922,12400,10400,23722
"AL","2000-10-29",2000,10,303,0,12200,10400,22600
"AL","2000-10-30",2000,10,304,0,12200,10500,22700
"AL","2000-10-31",2000,10,305,0,12100,10500,22600
"AL","2000-11-01",2000,11,306,1340,12200,10500,24040
"AL","2000-11-02",2000,11,307,2140,12200,10500,24840
"AL","2000-11-03",2000,11,308,3930,12500,10600,27030
"AL","2000-11-04",2000,11,309,0,12000,10400,22400
"AL","2000-11-05",2000,11,310,0,11900,10500,22400
"AL","2000-11-06",2000,11,311,745,11900,10500,23145
"AL","2000-11-07",2000,11,312,6670,12600,10600,29870
"AL","2000-11-08",2000,11,313,14000,14500,11000,39500
"AL","2000-11-09",2000,11,314,1960,12600,10500,25060
"AL","2000-11-10",2000,11,315,333,12200,10300,22833
"AL","2000-11-11",2000,11,316,0,12100,10400,22500
"AL","2000-11-12",2000,11,317,1830,12200,10300,24330
"AL","2000-11-13",2000,11,318,5780,12700,10300,28780
"AL","2000-11-14",2000,11,319,13300,12300,10200,35800
"AL","2000-11-15",2000,11,320,21600,12100,9790,43490
"AL","2000-11-16",2000,11,321,2330,12100,9900,24330
"AL","2000-11-17",2000,11,322,6610,12000,9950,28560
"AL","2000-11-18",2000,11,323,2520,12000,10000,24520
"AL","2000-11-19",2000,11,324,521,11900,10100,22521
"AL","2000-11-20",2000,11,325,5840,11900,10000,27740
"AL","2000-11-21",2000,11,326,5690,11900,9980,27570
"AL","2000-11-22",2000,11,327,2690,11800,10000,24490
"AL","2000-11-23",2000,11,328,230,11800,10100,22130
"AL","2000-11-24",2000,11,329,0,11800,10200,22000
"AL","2000-11-25",2000,11,330,0,11700,10200,21900
"AL","2000-11-26",2000,11,331,0,11700,10200,21900
"AL","2000-11-27",2000,11,332,0,11700,10300,22000
"AL","2000-11-28",2000,11,333,0,11700,10300,22000
"AL","2000-11-29",2000,11,334,918,11600,10300,22818
"AL","2000-11-30",2000,11,335,230,11600,10300,22130
"AL","2000-12-01",2000,12,336,0,11600,10300,21900
"AL","2000-12-02",2000,12,337,0,11600,10300,21900
"AL","2000-12-03",2000,12,338,0,11500,10300,21800
"AL","2000-12-04",2000,12,339,0,11500,10300,21800
"AL","2000-12-05",2000,12,340,374,11500,10300,22174
"AL","2000-12-06",2000,12,341,211,11500,10200,21911
"AL","2000-12-07",2000,12,342,0,11400,10200,21600
"AL","2000-12-08",2000,12,343,2270,11400,10200,23870
"AL","2000-12-09",2000,12,344,3690,11400,10100,25190
"AL","2000-12-10",2000,12,345,187,11400,10100,21687
"AL","2000-12-11",2000,12,346,2470,11300,10100,23870
"AL","2000-12-12",2000,12,347,0,11300,10100,21400
"AL","2000-12-13",2000,12,348,0,11300,10100,21400
"AL","2000-12-14",2000,12,349,1120,11300,10100,22520
"AL","2000-12-15",2000,12,350,2470,11200,10000,23670
"AL","2000-12-16",2000,12,351,2620,11200,10000,23820
"AL","2000-12-17",2000,12,352,3070,11200,9970,24240
"AL","2000-12-18",2000,12,353,3950,11200,9920,25070
"AL","2000-12-19",2000,12,354,1220,11100,9930,22250
"AL","2000-12-20",2000,12,355,1930,11100,9920,22950
"AL","2000-12-21",2000,12,356,1310,11100,9920,22330
"AL","2000-12-22",2000,12,357,5090,11100,9840,26030
"AL","2000-12-23",2000,12,358,773,11000,9850,21623
"AL","2000-12-24",2000,12,359,187,11000,9890,21077
"AL","2000-12-25",2000,12,360,644,11000,9890,21534
"AL","2000-12-26",2000,12,361,935,11000,9880,21815
"AL","2000-12-27",2000,12,362,0,10900,9890,20790
"AL","2000-12-28",2000,12,363,129,10900,9890,20919
"AL","2000-12-29",2000,12,364,468,10900,9880,21248
"AL","2000-12-30",2000,12,365,773,10900,9870,21543
"AL","2000-12-31",2000,12,366,2310,10800,9840,22950
"AL","2001-01-01",2001,1,1,655,10800,9840,21295
"AL","2001-01-02",2001,1,2,0,10800,9850,20650
"AL","2001-01-03",2001,1,3,0,10800,9850,20650
"AL","2001-01-04",2001,1,4,645,10800,9830,21275
"AL","2001-01-05",2001,1,5,312,10700,9820,20832
"AL","2001-01-06",2001,1,6,1620,10700,9810,22130
"AL","2001-01-07",2001,1,7,1290,10700,9780,21770
"AL","2001-01-08",2001,1,8,4410,10700,9710,24820
"AL","2001-01-09",2001,1,9,645,10600,9710,20955
"AL","2001-01-10",2001,1,10,0,10600,9740,20340
"AL","2001-01-11",2001,1,11,0,10600,9750,20350
"AL","2001-01-12",2001,1,12,0,10600,9750,20350
"AL","2001-01-13",2001,1,13,0,10600,9750,20350
"AL","2001-01-14",2001,1,14,0,10500,9770,20270
"AL","2001-01-15",2001,1,15,5780,10500,9640,25920
"AL","2001-01-16",2001,1,16,12600,10500,9410,32510
"AL","2001-01-17",2001,1,17,3930,10500,9410,23840
"AL","2001-01-18",2001,1,18,0,10500,9490,19990
"AL","2001-01-19",2001,1,19,1090,10400,9510,21000
"AL","2001-01-20",2001,1,20,0,10400,9540,19940
"AL","2001-01-21",2001,1,21,0,10400,9550,19950
"AL","2001-01-22",2001,1,22,0,10400,9560,19960
"AL","2001-01-23",2001,1,23,0,10400,9570,19970
"AL","2001-01-24",2001,1,24,3340,10300,9510,23150
"AL","2001-01-25",2001,1,25,2130,10300,9480,21910
"AL","2001-01-26",2001,1,26,0,10300,9510,19810
"AL","2001-01-27",2001,1,27,2500,10300,9470,22270
"AL","2001-01-28",2001,1,28,6250,10300,9380,25930
"AL","2001-01-29",2001,1,29,0,10300,9400,19700
"AL","2001-01-30",2001,1,30,4220,10200,9360,23780
"AL","2001-01-31",2001,1,31,12700,10200,9170,32070
"AL","2001-02-01",2001,2,32,1210,10200,9210,20620
"AL","2001-02-02",2001,2,33,727,10200,9300,20227
"AL","2001-02-03",2001,2,34,129,10200,9330,19659
"AL","2001-02-04",2001,2,35,0,10200,9350,19550
"AL","2001-02-05",2001,2,36,2280,10100,9320,21700
"AL","2001-02-06",2001,2,37,0,10100,9350,19450
"AL","2001-02-07",2001,2,38,0,10100,9370,19470
"AL","2001-02-08",2001,2,39,2440,10100,9340,21880
"AL","2001-02-09",2001,2,40,9690,10100,9160,28950
"AL","2001-02-10",2001,2,41,8040,10100,9060,27200
"AL","2001-02-11",2001,2,42,387,10100,9130,19617
"AL","2001-02-12",2001,2,43,656,10000,9200,19856
"AL","2001-02-13",2001,2,44,0,10000,9220,19220
"AL","2001-02-14",2001,2,45,2660,10000,9200,21860
"AL","2001-02-15",2001,2,46,0,9990,9230,19220
"AL","2001-02-16",2001,2,47,0,9980,9250,19230
"AL","2001-02-17",2001,2,48,0,9960,9260,19220
"AL","2001-02-18",2001,2,49,0,9940,9260,19200
"AL","2001-02-19",2001,2,50,0,9930,9270,19200
"AL","2001-02-20",2001,2,51,0,9910,9280,19190
"AL","2001-02-21",2001,2,52,0,9890,9270,19160
"AL","2001-02-22",2001,2,53,563,9880,9260,19703
"AL","2001-02-23",2001,2,54,646,9860,9240,19746
"AL","2001-02-24",2001,2,55,3620,9840,9180,22640
"AL","2001-02-25",2001,2,56,4000,9830,9130,22960
"AL","2001-02-26",2001,2,57,5270,9820,9050,24140
"AL","2001-02-27",2001,2,58,2860,9800,9050,21710
"AL","2001-02-28",2001,2,59,0,9790,9100,18890
"AL","2001-03-01",2001,3,60,0,9770,9120,18890
"AL","2001-03-02",2001,3,61,0,9760,9130,18890
"AL","2001-03-03",2001,3,62,0,9740,9180,18920
"AL","2001-03-04",2001,3,63,0,9730,9200,18930
"AL","2001-03-05",2001,3,64,0,9710,9210,18920
"AL","2001-03-06",2001,3,65,0,9690,9200,18890
"AL","2001-03-07",2001,3,66,0,9680,9200,18880
"AL","2001-03-08",2001,3,67,1380,9660,9170,20210
"AL","2001-03-09",2001,3,68,2050,9650,9130,20830
"AL","2001-03-10",2001,3,69,712,9630,9130,19472
"AL","2001-03-11",2001,3,70,1030,9620,9130,19780
"AL","2001-03-12",2001,3,71,2500,9610,9080,21190
"AL","2001-03-13",2001,3,72,9090,9590,8920,27600
"AL","2001-03-14",2001,3,73,20700,9580,8600,38880
"AL","2001-03-15",2001,3,74,0,9570,8700,18270
"AL","2001-03-16",2001,3,75,0,9560,8880,18440
"AL","2001-03-17",2001,3,76,0,9550,8930,18480
"AL","2001-03-18",2001,3,77,0,9540,8980,18520
"AL","2001-03-19",2001,3,78,0,9520,9020,18540
"AL","2001-03-20",2001,3,79,0,9510,9060,18570
"AL","2001-03-21",2001,3,80,0,9500,9090,18590
"AL","2001-03-22",2001,3,81,1660,9480,9070,20210
"AL","2001-03-23",2001,3,82,0,9470,9110,18580
"AL","2001-03-24",2001,3,83,237,9450,9090,18777
"AL","2001-03-25",2001,3,84,3450,9440,9000,21890
"AL","2001-03-26",2001,3,85,926,9430,8970,19326
"AL","2001-03-27",2001,3,86,0,9420,8980,18400
"AL","2001-03-28",2001,3,87,0,9400,8990,18390
"AL","2001-03-29",2001,3,88,0,9390,9010,18400
"AL","2001-03-30",2001,3,89,0,9380,9030,18410
"AL","2001-03-31",2001,3,90,0,9360,9050,18410
"AL","2001-04-01",2001,4,91,1380,9350,9030,19760
"AL","2001-04-02",2001,4,92,13200,9340,8780,31320
"AL","2001-04-03",2001,4,93,0,9330,8790,18120
"AL","2001-04-04",2001,4,94,6840,9320,8830,24990
"AL","2001-04-05",2001,4,95,0,9310,9640,18950
"AL","2001-04-06",2001,4,96,4050,12500,15700,32250
"AL","2001-04-07",2001,4,97,14200,18000,28300,60500
"AL","2001-04-08",2001,4,98,18600,25000,31900,75500
"AL","2001-04-09",2001,4,99,13500,20100,27900,61500
"AL","2001-04-10",2001,4,100,0,16500,20300,36800
"AL","2001-04-11",2001,4,101,2530,18300,24900,45730
"AL","2001-04-12",2001,4,102,18200,30500,29700,78400
"AL","2001-04-13",2001,4,103,30200,23100,24400,77700
"AL","2001-04-14",2001,4,104,13800,18200,17300,49300
"AL","2001-04-15",2001,4,105,3340,14700,12500,30540
"AL","2001-04-16",2001,4,106,5020,14500,12500,32020
"AL","2001-04-17",2001,4,107,11800,15700,14500,42000
"AL","2001-04-18",2001,4,108,1020,14300,12000,27320
"AL","2001-04-19",2001,4,109,0,14000,11700,25700
"AL","2001-04-20",2001,4,110,1010,13700,11600,26310
"AL","2001-04-21",2001,4,111,4560,14000,11600,30160
"AL","2001-04-22",2001,4,112,11400,15700,13700,40800
"AL","2001-04-23",2001,4,113,37400,24900,26600,88900
"AL","2001-04-24",2001,4,114,18400,19900,18800,57100
"AL","2001-04-25",2001,4,115,20100,20600,19700,60400
"AL","2001-04-26",2001,4,116,0,14800,11700,26500
"AL","2001-04-27",2001,4,117,0,14500,11700,26200
"AL","2001-04-28",2001,4,118,0,14200,11700,25900
"AL","2001-04-29",2001,4,119,0,14000,11600,25600
"AL","2001-04-30",2001,4,120,0,13800,11500,25300
"AL","2001-05-01",2001,5,121,1140,13700,11500,26340
"AL","2001-05-02",2001,5,122,22300,18400,15300,56000
"AL","2001-05-03",2001,5,123,12000,16600,14100,42700
"AL","2001-05-04",2001,5,124,4320,14600,11600,30520
"AL","2001-05-05",2001,5,125,19700,20400,17700,57800
"AL","2001-05-06",2001,5,126,369,14300,11500,26169
"AL","2001-05-07",2001,5,127,5860,14800,11600,32260
"AL","2001-05-08",2001,5,128,9450,15500,12700,37650
"AL","2001-05-09",2001,5,129,10900,16400,13600,40900
"AL","2001-05-10",2001,5,130,13500,16100,15500,45100
"AL","2001-05-11",2001,5,131,41500,26400,27400,95300
"AL","2001-05-12",2001,5,132,0,14200,11700,25900
"AL","2001-05-13",2001,5,133,369,13600,11700,25669
"AL","2001-05-14",2001,5,134,0,13400,11700,25100
"AL","2001-05-15",2001,5,135,623,13100,11700,25423
"AL","2001-05-16",2001,5,136,2210,12900,11600,26710
"AL","2001-05-17",2001,5,137,4990,13300,11600,29890
"AL","2001-05-18",2001,5,138,0,12200,11400,23600
"AL","2001-05-19",2001,5,139,0,12000,11400,23400
"AL","2001-05-20",2001,5,140,0,11900,11300,23200
"AL","2001-05-21",2001,5,141,1850,11900,11200,24950
"AL","2001-05-22",2001,5,142,12200,12900,11000,36100
"AL","2001-05-23",2001,5,143,39400,18900,11700,70000
"AL","2001-05-24",2001,5,144,14400,15500,11400,41300
"AL","2001-05-25",2001,5,145,20400,18000,16100,54500
"AL","2001-05-26",2001,5,146,18100,18700,17700,54500
"AL","2001-05-27",2001,5,147,17700,18800,17800,54300
"AL","2001-05-28",2001,5,148,12400,18000,15600,46000
"AL","2001-05-29",2001,5,149,208,14800,11900,26908
"AL","2001-05-30",2001,5,150,0,14200,12000,26200
"AL","2001-05-31",2001,5,151,0,13800,12000,25800
"AL","2001-06-01",2001,6,152,2580,13200,11800,27580
"AL","2001-06-02",2001,6,153,11900,14500,11800,38200
"AL","2001-06-03",2001,6,154,1860,13700,11700,27260
"AL","2001-06-04",2001,6,155,0,13300,11700,25000
"AL","2001-06-05",2001,6,156,0,13300,11700,25000
"AL","2001-06-06",2001,6,157,0,13000,11600,24600
"AL","2001-06-07",2001,6,158,0,12800,11600,24400
"AL","2001-06-08",2001,6,159,0,12500,11500,24000
"AL","2001-06-09",2001,6,160,1450,12400,11400,25250
"AL","2001-06-10",2001,6,161,14000,13600,11400,39000
"AL","2001-06-11",2001,6,162,10700,13900,11300,35900
"AL","2001-06-12",2001,6,163,38400,19600,12700,70700
"AL","2001-06-13",2001,6,164,16800,16500,12900,46200
"AL","2001-06-14",2001,6,165,2830,14200,11500,28530
"AL","2001-06-15",2001,6,166,989,13500,11600,26089
"AL","2001-06-16",2001,6,167,621,13100,11500,25221
"AL","2001-06-17",2001,6,168,4050,13200,11400,28650
"AL","2001-06-18",2001,6,169,5940,13400,11400,30740
"AL","2001-06-19",2001,6,170,89400,32900,38500,160800
"AL","2001-06-20",2001,6,171,28800,24900,25000,78700
"AL","2001-06-21",2001,6,172,10400,17400,15200,43000
"AL","2001-06-22",2001,6,173,4530,16400,12800,33730
"AL","2001-06-23",2001,6,174,0,15400,12700,28100
"AL","2001-06-24",2001,6,175,0,15100,12800,27900
"AL","2001-06-25",2001,6,176,0,14500,12700,27200
"AL","2001-06-26",2001,6,177,0,14000,12500,26500
"AL","2001-06-27",2001,6,178,0,13600,12300,25900
"AL","2001-06-28",2001,6,179,17400,14900,12300,44600
"AL","2001-06-29",2001,6,180,1040,13900,12100,27040
"AL","2001-06-30",2001,6,181,8240,14200,12100,34540
"AL","2001-07-01",2001,7,182,1450,13600,12000,27050
"AL","2001-07-02",2001,7,183,0,13000,12000,25000
"AL","2001-07-03",2001,7,184,3850,13000,11900,28750
"AL","2001-07-04",2001,7,185,6610,13600,11800,32010
"AL","2001-07-05",2001,7,186,2840,13400,11700,27940
"AL","2001-07-06",2001,7,187,0,12900,11800,24700
"AL","2001-07-07",2001,7,188,0,12600,11800,24400
"AL","2001-07-08",2001,7,189,0,12500,11800,24300
"AL","2001-07-09",2001,7,190,0,12400,11800,24200
"AL","2001-07-10",2001,7,191,0,12400,11900,24300
"AL","2001-07-11",2001,7,192,0,12300,11900,24200
"AL","2001-07-12",2001,7,193,0,12200,11800,24000
"AL","2001-07-13",2001,7,194,0,12200,11700,23900
"AL","2001-07-14",2001,7,195,0,12100,11800,23900
"AL","2001-07-15",2001,7,196,0,12100,11800,23900
"AL","2001-07-16",2001,7,197,0,12000,11800,23800
"AL","2001-07-17",2001,7,198,7700,12900,11600,32200
"AL","2001-07-18",2001,7,199,2040,12300,11400,25740
"AL","2001-07-19",2001,7,200,13700,13400,11300,38400
"AL","2001-07-20",2001,7,201,10300,13400,11100,34800
"AL","2001-07-21",2001,7,202,22900,16100,11000,50000
"AL","2001-07-22",2001,7,203,919,13100,10900,24919
"AL","2001-07-23",2001,7,204,0,12500,11100,23600
"AL","2001-07-24",2001,7,205,1930,12200,11200,25330
"AL","2001-07-25",2001,7,206,0,12000,11200,23200
"AL","2001-07-26",2001,7,207,0,11900,11200,23100
"AL","2001-07-27",2001,7,208,0,11800,11200,23000
"AL","2001-07-28",2001,7,209,14700,12900,11000,38600
"AL","2001-07-29",2001,7,210,16900,14400,10800,42100
"AL","2001-07-30",2001,7,211,2600,13000,10900,26500
"AL","2001-07-31",2001,7,212,3380,12700,11000,27080
"AL","2001-08-01",2001,8,213,24800,15200,11200,51200
"AL","2001-08-02",2001,8,214,0,12700,10900,23600
"AL","2001-08-03",2001,8,215,47000,20300,14000,81300
"AL","2001-08-04",2001,8,216,0,13500,10800,24300
"AL","2001-08-05",2001,8,217,0,13300,11100,24400
"AL","2001-08-06",2001,8,218,0,12900,11200,24100
"AL","2001-08-07",2001,8,219,0,12500,11200,23700
"AL","2001-08-08",2001,8,220,2420,12200,11100,25720
"AL","2001-08-09",2001,8,221,0,12100,11100,23200
"AL","2001-08-10",2001,8,222,0,12000,11100,23100
"AL","2001-08-11",2001,8,223,0,11900,11100,23000
"AL","2001-08-12",2001,8,224,0,11800,11100,22900
"AL","2001-08-13",2001,8,225,5260,12000,11000,28260
"AL","2001-08-14",2001,8,226,26400,15600,11000,53000
"AL","2001-08-15",2001,8,227,351,12600,10800,23751
"AL","2001-08-16",2001,8,228,1230,12400,11000,24630
"AL","2001-08-17",2001,8,229,9310,13200,11000,33510
"AL","2001-08-18",2001,8,230,3670,12900,10900,27470
"AL","2001-08-19",2001,8,231,0,12300,11000,23300
"AL","2001-08-20",2001,8,232,11400,13200,11100,35700
"AL","2001-08-21",2001,8,233,0,12100,11000,23100
"AL","2001-08-22",2001,8,234,0,11700,11100,22800
"AL","2001-08-23",2001,8,235,0,11400,11100,22500
"AL","2001-08-24",2001,8,236,0,11300,11000,22300
"AL","2001-08-25",2001,8,237,0,11300,11000,22300
"AL","2001-08-26",2001,8,238,0,11200,11000,22200
"AL","2001-08-27",2001,8,239,1600,11200,10900,23700
"AL","2001-08-28",2001,8,240,7250,11800,10900,29950
"AL","2001-08-29",2001,8,241,0,11100,10900,22000
"AL","2001-08-30",2001,8,242,3510,11100,10900,25510
"AL","2001-08-31",2001,8,243,3870,11400,10800,26070
"AL","2001-09-01",2001,9,244,0,11100,10800,21900
"AL","2001-09-02",2001,9,245,0,10900,10800,21700
"AL","2001-09-03",2001,9,246,0,10900,10700,21600
"AL","2001-09-04",2001,9,247,0,10800,10700,21500
"AL","2001-09-05",2001,9,248,0,10800,10700,21500
"AL","2001-09-06",2001,9,249,0,10700,10700,21400
"AL","2001-09-07",2001,9,250,6590,11100,10600,28290
"AL","2001-09-08",2001,9,251,55800,19800,11500,87100
"AL","2001-09-09",2001,9,252,23100,17000,15500,55600
"AL","2001-09-10",2001,9,253,5700,13600,10700,30000
"AL","2001-09-11",2001,9,254,10300,15500,12800,38600
"AL","2001-09-12",2001,9,255,0,13200,10400,23600
"AL","2001-09-13",2001,9,256,303,13000,10600,23903
"AL","2001-09-14",2001,9,257,0,12700,10600,23300
"AL","2001-09-15",2001,9,258,0,12500,10600,23100
"AL","2001-09-16",2001,9,259,0,12300,10600,22900
"AL","2001-09-17",2001,9,260,1100,12100,10600,23800
"AL","2001-09-18",2001,9,261,303,11900,10600,22803
"AL","2001-09-19",2001,9,262,0,11800,10600,22400
"AL","2001-09-20",2001,9,263,454,11700,10500,22654
"AL","2001-09-21",2001,9,264,303,11600,10500,22403
"AL","2001-09-22",2001,9,265,0,11500,10500,22000
"AL","2001-09-23",2001,9,266,7140,11800,10500,29440
"AL","2001-09-24",2001,9,267,24200,15000,10800,50000
"AL","2001-09-25",2001,9,268,3530,13100,10400,27030
"AL","2001-09-26",2001,9,269,0,12400,10400,22800
"AL","2001-09-27",2001,9,270,0,12300,10400,22700
"AL","2001-09-28",2001,9,271,0,12100,10500,22600
"AL","2001-09-29",2001,9,272,0,11900,10500,22400
"AL","2001-09-30",2001,9,273,0,11700,10400,22100
"AL","2001-10-01",2001,10,274,0,11600,10400,22000
"AL","2001-10-02",2001,10,275,0,11400,10400,21800
"AL","2001-10-03",2001,10,276,0,11200,10400,21600
"AL","2001-10-04",2001,10,277,17700,12900,10300,40900
"AL","2001-10-05",2001,10,278,670,12100,10200,22970
"AL","2001-10-06",2001,10,279,0,11700,10300,22000
"AL","2001-10-07",2001,10,280,2530,11700,10300,24530
"AL","2001-10-08",2001,10,281,0,11600,10200,21800
"AL","2001-10-09",2001,10,282,0,11600,10200,21800
"AL","2001-10-10",2001,10,283,1890,11800,10200,23890
"AL","2001-10-11",2001,10,284,28300,16200,11000,55500
"AL","2001-10-12",2001,10,285,5080,13100,10500,28680
"AL","2001-10-13",2001,10,286,0,12400,10100,22500
"AL","2001-10-14",2001,10,287,0,12200,10100,22300
"AL","2001-10-15",2001,10,288,21900,16100,12500,50500
"AL","2001-10-16",2001,10,289,2630,13300,10800,26730
"AL","2001-10-17",2001,10,290,937,12600,10000,23537
"AL","2001-10-18",2001,10,291,970,12600,10100,23670
"AL","2001-10-19",2001,10,292,0,12400,10100,22500
"AL","2001-10-20",2001,10,293,1480,12400,10100,23980
"AL","2001-10-21",2001,10,294,369,12300,10100,22769
"AL","2001-10-22",2001,10,295,536,12200,10000,22736
"AL","2001-10-23",2001,10,296,0,12100,10000,22100
"AL","2001-10-24",2001,10,297,4360,12400,10100,26860
"AL","2001-10-25",2001,10,298,5560,13000,10000,28560
"AL","2001-10-26",2001,10,299,5690,12900,10300,28890
"AL","2001-10-27",2001,10,300,32300,13600,10400,56300
"AL","2001-10-28",2001,10,301,3090,12500,9740,25330
"AL","2001-10-29",2001,10,302,0,12300,9850,22150
"AL","2001-10-30",2001,10,303,0,14400,14400,28800
"AL","2001-10-31",2001,10,304,0,13700,13200,26900
"AL","2001-11-01",2001,11,305,9620,16200,17300,43120
"AL","2001-11-02",2001,11,306,0,13100,11000,24100
"AL","2001-11-03",2001,11,307,0,12600,10100,22700
"AL","2001-11-04",2001,11,308,0,12500,10100,22600
"AL","2001-11-05",2001,11,309,0,12400,10000,22400
"AL","2001-11-06",2001,11,310,0,12400,10000,22400
"AL","2001-11-07",2001,11,311,0,12300,10100,22400
"AL","2001-11-08",2001,11,312,0,12200,10100,22300
"AL","2001-11-09",2001,11,313,5190,12700,10100,27990
"AL","2001-11-10",2001,11,314,230,12200,10100,22530
"AL","2001-11-11",2001,11,315,0,11900,10100,22000
"AL","2001-11-12",2001,11,316,0,11900,10100,22000
"AL","2001-11-13",2001,11,317,0,11900,10100,22000
"AL","2001-11-14",2001,11,318,3690,12100,10100,25890
"AL","2001-11-15",2001,11,319,0,11800,10000,21800
"AL","2001-11-16",2001,11,320,349,11700,10100,22149
"AL","2001-11-17",2001,11,321,0,11700,10100,21800
"AL","2001-11-18",2001,11,322,0,11700,10100,21800
"AL","2001-11-19",2001,11,323,0,11700,10100,21800
"AL","2001-11-20",2001,11,324,10100,13100,10400,33600
"AL","2001-11-21",2001,11,325,0,11900,10000,21900
"AL","2001-11-22",2001,11,326,0,11700,10000,21700
"AL","2001-11-23",2001,11,327,0,11600,10000,21600
"AL","2001-11-24",2001,11,328,0,11600,9970,21570
"AL","2001-11-25",2001,11,329,11800,13300,10200,35300
"AL","2001-11-26",2001,11,330,17800,16700,16600,51100
"AL","2001-11-27",2001,11,331,2570,12900,11000,26470
"AL","2001-11-28",2001,11,332,31000,12100,9200,52300
"AL","2001-11-29",2001,11,333,14600,12100,9120,35820
"AL","2001-11-30",2001,11,334,0,12000,9400,21400
"AL","2001-12-01",2001,12,335,0,12000,9620,21620
"AL","2001-12-02",2001,12,336,4640,11900,9590,26130
"AL","2001-12-03",2001,12,337,0,11900,9650,21550
"AL","2001-12-04",2001,12,338,0,11800,9730,21530
"AL","2001-12-05",2001,12,339,5140,11800,9710,26650
"AL","2001-12-06",2001,12,340,24500,16500,18300,59300
"AL","2001-12-07",2001,12,341,20900,15400,14800,51100
"AL","2001-12-08",2001,12,342,0,12800,10300,23100
"AL","2001-12-09",2001,12,343,0,12600,10000,22600
"AL","2001-12-10",2001,12,344,0,12400,10000,22400
"AL","2001-12-11",2001,12,345,0,12300,10000,22300
"AL","2001-12-12",2001,12,346,0,12200,10000,22200
"AL","2001-12-13",2001,12,347,0,12100,10100,22200
"AL","2001-12-14",2001,12,348,0,12000,10100,22100
"AL","2001-12-15",2001,12,349,0,12000,10100,22100
"AL","2001-12-16",2001,12,350,0,11900,10100,22000
"AL","2001-12-17",2001,12,351,374,11800,10100,22274
"AL","2001-12-18",2001,12,352,808,11800,10100,22708
"AL","2001-12-19",2001,12,353,0,11800,10100,21900
"AL","2001-12-20",2001,12,354,0,11700,10100,21800
"AL","2001-12-21",2001,12,355,129,11700,10100,21929
"AL","2001-12-22",2001,12,356,0,11600,10100,21700
"AL","2001-12-23",2001,12,357,1870,11600,10000,23470
"AL","2001-12-24",2001,12,358,3030,11600,9980,24610
"AL","2001-12-25",2001,12,359,7010,11600,9860,28470
"AL","2001-12-26",2001,12,360,1630,11500,9860,22990
"AL","2001-12-27",2001,12,361,632,11500,9890,22022
"AL","2001-12-28",2001,12,362,258,11500,9910,21668
"AL","2001-12-29",2001,12,363,409,11400,9910,21719
"AL","2001-12-30",2001,12,364,0,11400,9910,21310
"AL","2001-12-31",2001,12,365,0,11400,9920,21320
"AL","2002-01-01",2002,1,1,0,11400,9910,21310
"AL","2002-01-02",2002,1,2,0,11300,9910,21210
"AL","2002-01-03",2002,1,3,0,11300,9900,21200
"AL","2002-01-04",2002,1,4,0,11300,9890,21190
"AL","2002-01-05",2002,1,5,0,11300,9890,21190
"AL","2002-01-06",2002,1,6,312,11300,9880,21492
"AL","2002-01-07",2002,1,7,625,11200,9870,21695
"AL","2002-01-08",2002,1,8,1080,11200,9850,22130
"AL","2002-01-09",2002,1,9,0,11200,9850,21050
"AL","2002-01-10",2002,1,10,0,11200,9860,21060
"AL","2002-01-11",2002,1,11,0,11100,9870,20970
"AL","2002-01-12",2002,1,12,1540,11100,9840,22480
"AL","2002-01-13",2002,1,13,1510,11100,9810,22420
"AL","2002-01-14",2002,1,14,625,11100,9800,21525
"AL","2002-01-15",2002,1,15,3010,11100,9740,23850
"AL","2002-01-16",2002,1,16,3110,11000,9690,23800
"AL","2002-01-17",2002,1,17,468,11000,9700,21168
"AL","2002-01-18",2002,1,18,645,11000,9700,21345
"AL","2002-01-19",2002,1,19,0,11000,9700,20700
"AL","2002-01-20",2002,1,20,0,11000,9700,20700
"AL","2002-01-21",2002,1,21,1410,10900,9680,21990
"AL","2002-01-22",2002,1,22,0,10900,9680,20580
"AL","2002-01-23",2002,1,23,0,10900,9690,20590
"AL","2002-01-24",2002,1,24,0,10900,9700,20600
"AL","2002-01-25",2002,1,25,0,10900,9700,20600
"AL","2002-01-26",2002,1,26,0,10800,9690,20490
"AL","2002-01-27",2002,1,27,0,10800,9700,20500
"AL","2002-01-28",2002,1,28,0,10800,9700,20500
"AL","2002-01-29",2002,1,29,0,10800,9690,20490
"AL","2002-01-30",2002,1,30,312,10800,9670,20782
"AL","2002-01-31",2002,1,31,215,10800,9650,20665
"AL","2002-02-01",2002,2,32,4680,10700,9560,24940
"AL","2002-02-02",2002,2,33,11000,10700,9360,31060
"AL","2002-02-03",2002,2,34,281,10700,9390,20371
"AL","2002-02-04",2002,2,35,598,10700,9440,20738
"AL","2002-02-05",2002,2,36,0,10700,9460,20160
"AL","2002-02-06",2002,2,37,0,10700,9470,20170
"AL","2002-02-07",2002,2,38,0,10700,9480,20180
"AL","2002-02-08",2002,2,39,0,10600,9500,20100
"AL","2002-02-09",2002,2,40,0,10600,9500,20100
"AL","2002-02-10",2002,2,41,375,10600,9490,20465
"AL","2002-02-11",2002,2,42,129,10600,9490,20219
"AL","2002-02-12",2002,2,43,0,10600,9480,20080
"AL","2002-02-13",2002,2,44,188,10600,9470,20258
"AL","2002-02-14",2002,2,45,0,10500,9460,19960
"AL","2002-02-15",2002,2,46,0,10500,9470,19970
"AL","2002-02-16",2002,2,47,281,10500,9460,20241
"AL","2002-02-17",2002,2,48,1070,10500,9440,21010
"AL","2002-02-18",2002,2,49,4350,10500,9350,24200
"AL","2002-02-19",2002,2,50,1310,10500,9340,21150
"AL","2002-02-20",2002,2,51,7860,10500,9230,27590
"AL","2002-02-21",2002,2,52,16300,10400,8960,35660
"AL","2002-02-22",2002,2,53,5470,10400,8940,24810
"AL","2002-02-23",2002,2,54,0,10400,9060,19460
"AL","2002-02-24",2002,2,55,281,10400,9140,19821
"AL","2002-02-25",2002,2,56,1950,10400,9150,21500
"AL","2002-02-26",2002,2,57,2500,10400,9130,22030
"AL","2002-02-27",2002,2,58,2690,10400,9120,22210
"AL","2002-02-28",2002,2,59,387,10300,9160,19847
"AL","2002-03-01",2002,3,60,0,10300,9190,19490
"AL","2002-03-02",2002,3,61,0,10300,9210,19510
"AL","2002-03-03",2002,3,62,0,10300,9230,19530
"AL","2002-03-04",2002,3,63,474,10300,9230,20004
"AL","2002-03-05",2002,3,64,1720,10300,9200,21220
"AL","2002-03-06",2002,3,65,0,10200,9220,19420
"AL","2002-03-07",2002,3,66,0,10200,9230,19430
"AL","2002-03-08",2002,3,67,10300,10200,9040,29540
"AL","2002-03-09",2002,3,68,40400,10200,8420,59020
"AL","2002-03-10",2002,3,69,24800,10200,8150,43150
"AL","2002-03-11",2002,3,70,11300,10200,8240,29740
"AL","2002-03-12",2002,3,71,949,10200,8460,19609
"AL","2002-03-13",2002,3,72,861,10200,8640,19701
"AL","2002-03-14",2002,3,73,0,10100,8800,18900
"AL","2002-03-15",2002,3,74,9990,10100,8680,28770
"AL","2002-03-16",2002,3,75,45300,10100,8070,63470
"AL","2002-03-17",2002,3,76,0,10100,8220,18320
"AL","2002-03-18",2002,3,77,861,10100,8550,19511
"AL","2002-03-19",2002,3,78,0,10100,8700,18800
"AL","2002-03-20",2002,3,79,689,10100,8810,19599
"AL","2002-03-21",2002,3,80,5300,10100,8790,24190
"AL","2002-03-22",2002,3,81,9220,10000,8690,27910
"AL","2002-03-23",2002,3,82,0,10000,8780,18780
"AL","2002-03-24",2002,3,83,0,10000,8890,18890
"AL","2002-03-25",2002,3,84,0,10000,8950,18950
"AL","2002-03-26",2002,3,85,0,9980,8990,18970
"AL","2002-03-27",2002,3,86,0,9970,9030,19000
"AL","2002-03-28",2002,3,87,0,9950,9100,19050
"AL","2002-03-29",2002,3,88,1890,9930,9110,20930
"AL","2002-03-30",2002,3,89,4740,9920,9070,23730
"AL","2002-03-31",2002,3,90,3920,9900,9050,22870
"AL","2002-04-01",2002,4,91,0,9890,9110,19000
"AL","2002-04-02",2002,4,92,0,9870,9140,19010
"AL","2002-04-03",2002,4,93,2810,9860,9090,21760
"AL","2002-04-04",2002,4,94,18400,9850,8790,37040
"AL","2002-04-05",2002,4,95,512,9830,8820,19162
"AL","2002-04-06",2002,4,96,0,9820,8950,18770
"AL","2002-04-07",2002,4,97,0,9810,9010,18820
"AL","2002-04-08",2002,4,98,4330,9790,8950,23070
"AL","2002-04-09",2002,4,99,4780,9780,8910,23470
"AL","2002-04-10",2002,4,100,6880,9770,8860,25510
"AL","2002-04-11",2002,4,101,23900,9760,11300,44960
"AL","2002-04-12",2002,4,102,53300,162000,226000,441300
"AL","2002-04-13",2002,4,103,40000,87400,17600,145000
"AL","2002-04-14",2002,4,104,0,16200,14400,30600
"AL","2002-04-15",2002,4,105,2480,21500,32500,56480
"AL","2002-04-16",2002,4,106,6100,76100,123000,205200
"AL","2002-04-17",2002,4,107,0,24100,28600,52700
"AL","2002-04-18",2002,4,108,3570,129000,253000,385570
"AL","2002-04-19",2002,4,109,20600,33500,27400,81500
"AL","2002-04-20",2002,4,110,19500,23100,19400,62000
"AL","2002-04-21",2002,4,111,0,16200,11000,27200
"AL","2002-04-22",2002,4,112,4650,16100,11600,32350
"AL","2002-04-23",2002,4,113,11600,18800,15800,46200
"AL","2002-04-24",2002,4,114,632,15900,12400,28932
"AL","2002-04-25",2002,4,115,11100,19100,15800,46000
"AL","2002-04-26",2002,4,116,7280,17800,14900,39980
"AL","2002-04-27",2002,4,117,256,16100,13000,29356
"AL","2002-04-28",2002,4,118,1860,15900,13300,31060
"AL","2002-04-29",2002,4,119,17400,18300,17100,52800
"AL","2002-04-30",2002,4,120,4460,17900,16600,38960
"AL","2002-05-01",2002,5,121,5890,17000,15200,38090
"AL","2002-05-02",2002,5,122,0,15300,13700,29000
"AL","2002-05-03",2002,5,123,0,15100,13800,28900
"AL","2002-05-04",2002,5,124,974,15000,13800,29774
"AL","2002-05-05",2002,5,125,3690,15100,13900,32690
"AL","2002-05-06",2002,5,126,16100,17300,15200,48600
"AL","2002-05-07",2002,5,127,24300,22000,21300,67600
"AL","2002-05-08",2002,5,128,22500,20400,22500,65400
"AL","2002-05-09",2002,5,129,56900,32800,38600,128300
"AL","2002-05-10",2002,5,130,30100,27100,28900,86100
"AL","2002-05-11",2002,5,131,0,17100,15800,32900
"AL","2002-05-12",2002,5,132,2770,16500,15000,34270
"AL","2002-05-13",2002,5,133,14100,19800,19200,53100
"AL","2002-05-14",2002,5,134,2500,16600,15300,34400
"AL","2002-05-15",2002,5,135,0,15800,15100,30900
"AL","2002-05-16",2002,5,136,185,15500,15100,30785
"AL","2002-05-17",2002,5,137,1340,15100,14900,31340
"AL","2002-05-18",2002,5,138,0,14700,14700,29400
"AL","2002-05-19",2002,5,139,0,14600,14500,29100
"AL","2002-05-20",2002,5,140,0,14500,14300,28800
"AL","2002-05-21",2002,5,141,0,14400,14200,28600
"AL","2002-05-22",2002,5,142,0,14300,14000,28300
"AL","2002-05-23",2002,5,143,0,13900,13900,27800
"AL","2002-05-24",2002,5,144,0,13500,13700,27200
"AL","2002-05-25",2002,5,145,0,13300,13500,26800
"AL","2002-05-26",2002,5,146,0,13200,13200,26400
"AL","2002-05-27",2002,5,147,0,13300,13100,26400
"AL","2002-05-28",2002,5,148,3830,13600,13000,30430
"AL","2002-05-29",2002,5,149,0,13300,12900,26200
"AL","2002-05-30",2002,5,150,3140,13100,12800,29040
"AL","2002-05-31",2002,5,151,17100,15300,12800,45200
"AL","2002-06-01",2002,6,152,1040,13700,12700,27440
"AL","2002-06-02",2002,6,153,0,12800,12700,25500
"AL","2002-06-03",2002,6,154,0,12800,12600,25400
"AL","2002-06-04",2002,6,155,1310,12700,12500,26510
"AL","2002-06-05",2002,6,156,6630,13300,12400,32330
"AL","2002-06-06",2002,6,157,14300,15100,12400,41800
"AL","2002-06-07",2002,6,158,2020,14000,12300,28320
"AL","2002-06-08",2002,6,159,19400,15800,12800,48000
"AL","2002-06-09",2002,6,160,2720,14300,12400,29420
"AL","2002-06-10",2002,6,161,0,13500,12500,26000
"AL","2002-06-11",2002,6,162,21000,15300,13000,49300
"AL","2002-06-12",2002,6,163,30400,19400,13700,63500
"AL","2002-06-13",2002,6,164,0,14500,12600,27100
"AL","2002-06-14",2002,6,165,27200,17400,14600,59200
"AL","2002-06-15",2002,6,166,31800,23700,23800,79300
"AL","2002-06-16",2002,6,167,13400,18400,17000,48800
"AL","2002-06-17",2002,6,168,2090,15900,13300,31290
"AL","2002-06-18",2002,6,169,1270,15400,13400,30070
"AL","2002-06-19",2002,6,170,0,14700,13400,28100
"AL","2002-06-20",2002,6,171,5150,14700,13300,33150
"AL","2002-06-21",2002,6,172,12000,16000,13300,41300
"AL","2002-06-22",2002,6,173,2830,14800,13200,30830
"AL","2002-06-23",2002,6,174,5430,14900,13200,33530
"AL","2002-06-24",2002,6,175,6070,14600,13100,33770
"AL","2002-06-25",2002,6,176,6820,14700,13000,34520
"AL","2002-06-26",2002,6,177,4970,14200,12900,32070
"AL","2002-06-27",2002,6,178,25500,18400,14000,57900
"AL","2002-06-28",2002,6,179,0,14500,12800,27300
"AL","2002-06-29",2002,6,180,0,14000,12800,26800
"AL","2002-06-30",2002,6,181,0,13500,12700,26200
"AL","2002-07-01",2002,7,182,0,13200,12600,25800
"AL","2002-07-02",2002,7,183,0,13100,12600,25700
"AL","2002-07-03",2002,7,184,0,13000,12500,25500
"AL","2002-07-04",2002,7,185,131,12900,12500,25531
"AL","2002-07-05",2002,7,186,0,12800,12500,25300
"AL","2002-07-06",2002,7,187,0,12700,12400,25100
"AL","2002-07-07",2002,7,188,0,12700,12300,25000
"AL","2002-07-08",2002,7,189,7000,13000,12200,32200
"AL","2002-07-09",2002,7,190,14300,14100,12000,40400
"AL","2002-07-10",2002,7,191,34700,19100,11900,65700
"AL","2002-07-11",2002,7,192,0,13900,11700,25600
"AL","2002-07-12",2002,7,193,0,13500,12000,25500
"AL","2002-07-13",2002,7,194,0,13100,12100,25200
"AL","2002-07-14",2002,7,195,0,12600,12100,24700
"AL","2002-07-15",2002,7,196,0,12500,12100,24600
"AL","2002-07-16",2002,7,197,0,12400,12000,24400
"AL","2002-07-17",2002,7,198,0,12300,12000,24300
"AL","2002-07-18",2002,7,199,6530,12600,11900,31030
"AL","2002-07-19",2002,7,200,18000,14900,11800,44700
"AL","2002-07-20",2002,7,201,0,12500,11700,24200
"AL","2002-07-21",2002,7,202,18100,13700,11700,43500
"AL","2002-07-22",2002,7,203,46500,19700,12700,78900
"AL","2002-07-23",2002,7,204,23000,18800,15400,57200
"AL","2002-07-24",2002,7,205,0,13600,11500,25100
"AL","2002-07-25",2002,7,206,1400,13200,11600,26200
"AL","2002-07-26",2002,7,207,2360,13100,11600,27060
"AL","2002-07-27",2002,7,208,9560,14000,11600,35160
"AL","2002-07-28",2002,7,209,2100,13200,11600,26900
"AL","2002-07-29",2002,7,210,13800,14500,11600,39900
"AL","2002-07-30",2002,7,211,6800,14000,11500,32300
"AL","2002-07-31",2002,7,212,1750,13100,11600,26450
"AL","2002-08-01",2002,8,213,4900,12900,11600,29400
"AL","2002-08-02",2002,8,214,28900,16100,12200,57200
"AL","2002-08-03",2002,8,215,13000,15400,11800,40200
"AL","2002-08-04",2002,8,216,7720,14300,11800,33820
"AL","2002-08-05",2002,8,217,26900,19200,17100,63200
"AL","2002-08-06",2002,8,218,0,14000,11500,25500
"AL","2002-08-07",2002,8,219,0,13600,11700,25300
"AL","2002-08-08",2002,8,220,0,13100,11700,24800
"AL","2002-08-09",2002,8,221,0,12800,11600,24400
"AL","2002-08-10",2002,8,222,0,12600,11600,24200
"AL","2002-08-11",2002,8,223,0,12300,11600,23900
"AL","2002-08-12",2002,8,224,526,12200,11500,24226
"AL","2002-08-13",2002,8,225,9640,12900,11500,34040
"AL","2002-08-14",2002,8,226,12800,13900,11400,38100
"AL","2002-08-15",2002,8,227,7250,13700,11300,32250
"AL","2002-08-16",2002,8,228,4910,13300,11400,29610
"AL","2002-08-17",2002,8,229,23200,15700,12100,51000
"AL","2002-08-18",2002,8,230,31500,19500,16100,67100
"AL","2002-08-19",2002,8,231,0,13700,11300,25000
"AL","2002-08-20",2002,8,232,0,13500,11500,25000
"AL","2002-08-21",2002,8,233,21600,15800,14800,52200
"AL","2002-08-22",2002,8,234,56000,30700,34700,121400
"AL","2002-08-23",2002,8,235,18600,19800,19300,57700
"AL","2002-08-24",2002,8,236,0,15100,12400,27500
"AL","2002-08-25",2002,8,237,0,14800,12400,27200
"AL","2002-08-26",2002,8,238,0,14300,12400,26700
"AL","2002-08-27",2002,8,239,0,13800,12200,26000
"AL","2002-08-28",2002,8,240,0,13400,12100,25500
"AL","2002-08-29",2002,8,241,0,13000,12000,25000
"AL","2002-08-30",2002,8,242,0,12800,11900,24700
"AL","2002-08-31",2002,8,243,0,12600,11800,24400
"AL","2002-09-01",2002,9,244,0,12500,11800,24300
"AL","2002-09-02",2002,9,245,7360,12800,11700,31860
"AL","2002-09-03",2002,9,246,29900,17100,12100,59100
"AL","2002-09-04",2002,9,247,2460,13900,11500,27860
"AL","2002-09-05",2002,9,248,769,13300,11600,25669
"AL","2002-09-06",2002,9,249,21300,15800,12300,49400
"AL","2002-09-07",2002,9,250,37000,21900,19000,77900
"AL","2002-09-08",2002,9,251,2430,14700,12000,29130
"AL","2002-09-09",2002,9,252,0,14100,11800,25900
"AL","2002-09-10",2002,9,253,4610,14000,11800,30410
"AL","2002-09-11",2002,9,254,3440,13900,11800,29140
"AL","2002-09-12",2002,9,255,1060,13400,11600,26060
"AL","2002-09-13",2002,9,256,0,13100,11600,24700
"AL","2002-09-14",2002,9,257,1100,13000,11600,25700
"AL","2002-09-15",2002,9,258,0,12800,11500,24300
"AL","2002-09-16",2002,9,259,10400,14000,11500,35900
"AL","2002-09-17",2002,9,260,0,13200,11400,24600
"AL","2002-09-18",2002,9,261,0,13100,11500,24600
"AL","2002-09-19",2002,9,262,13300,13900,11600,38800
"AL","2002-09-20",2002,9,263,10600,14300,11700,36600
"AL","2002-09-21",2002,9,264,12300,14900,12000,39200
"AL","2002-09-22",2002,9,265,13000,15800,12700,41500
"AL","2002-09-23",2002,9,266,220,13600,11300,25120
"AL","2002-09-24",2002,9,267,4050,13800,11500,29350
"AL","2002-09-25",2002,9,268,1510,13500,11400,26410
"AL","2002-09-26",2002,9,269,10400,14400,12600,37400
"AL","2002-09-27",2002,9,270,22300,20500,20700,63500
"AL","2002-09-28",2002,9,271,10400,17700,16700,44800
"AL","2002-09-29",2002,9,272,439,14900,12400,27739
"AL","2002-09-30",2002,9,273,2120,14500,11800,28420
"AL","2002-10-01",2002,10,274,8010,15600,13600,37210
"AL","2002-10-02",2002,10,275,20900,20900,21300,63100
"AL","2002-10-03",2002,10,276,1060,15400,12900,29360
"AL","2002-10-04",2002,10,277,12100,16400,15400,43900
"AL","2002-10-05",2002,10,278,39700,27200,30600,97500
"AL","2002-10-06",2002,10,279,33900,26200,30700,90800
"AL","2002-10-07",2002,10,280,51600,33700,38000,123300
"AL","2002-10-08",2002,10,281,13600,22000,22500,58100
"AL","2002-10-09",2002,10,282,7300,20000,18600,45900
"AL","2002-10-10",2002,10,283,2670,18400,16400,37470
"AL","2002-10-11",2002,10,284,0,17200,14600,31800
"AL","2002-10-12",2002,10,285,268,17100,14700,32068
"AL","2002-10-13",2002,10,286,3520,17200,14800,35520
"AL","2002-10-14",2002,10,287,12800,19500,16300,48600
"AL","2002-10-15",2002,10,288,0,17000,15000,32000
"AL","2002-10-16",2002,10,289,0,16600,14500,31100
"AL","2002-10-17",2002,10,290,0,16400,14300,30700
"AL","2002-10-18",2002,10,291,0,16200,14200,30400
"AL","2002-10-19",2002,10,292,6170,16700,14600,37470
"AL","2002-10-20",2002,10,293,19300,16800,14500,50600
"AL","2002-10-21",2002,10,294,2640,17500,16600,36740
"AL","2002-10-22",2002,10,295,6430,16500,14600,37530
"AL","2002-10-23",2002,10,296,24400,16100,13800,54300
"AL","2002-10-24",2002,10,297,1700,16000,13800,31500
"AL","2002-10-25",2002,10,298,0,15900,13900,29800
"AL","2002-10-26",2002,10,299,1340,15800,14000,31140
"AL","2002-10-27",2002,10,300,8290,16400,15200,39890
"AL","2002-10-28",2002,10,301,1460,16600,15500,33560
"AL","2002-10-29",2002,10,302,0,16300,15300,31600
"AL","2002-10-30",2002,10,303,0,16600,15700,32300
"AL","2002-10-31",2002,10,304,0,16500,15400,31900
"AL","2002-11-01",2002,11,305,485,16200,14100,30785
"AL","2002-11-02",2002,11,306,0,15900,14000,29900
"AL","2002-11-03",2002,11,307,0,15800,13900,29700
"AL","2002-11-04",2002,11,308,0,15700,13900,29600
"AL","2002-11-05",2002,11,309,0,15700,13800,29500
"AL","2002-11-06",2002,11,310,0,15600,13800,29400
"AL","2002-11-07",2002,11,311,1380,15500,13700,30580
"AL","2002-11-08",2002,11,312,230,15600,14900,30730
"AL","2002-11-09",2002,11,313,0,17600,17600,35200
"AL","2002-11-10",2002,11,314,2510,17700,15100,35310
"AL","2002-11-11",2002,11,315,8980,18000,15700,42680
"AL","2002-11-12",2002,11,316,0,16000,13800,29800
"AL","2002-11-13",2002,11,317,0,15600,13400,29000
"AL","2002-11-14",2002,11,318,500,15600,13300,29400
"AL","2002-11-15",2002,11,319,689,15500,13200,29389
"AL","2002-11-16",2002,11,320,333,15500,13200,29033
"AL","2002-11-17",2002,11,321,605,15400,13200,29205
"AL","2002-11-18",2002,11,322,0,15400,13200,28600
"AL","2002-11-19",2002,11,323,0,15300,13100,28400
"AL","2002-11-20",2002,11,324,0,15300,13000,28300
"AL","2002-11-21",2002,11,325,833,15200,13000,29033
"AL","2002-11-22",2002,11,326,896,15200,12900,28996
"AL","2002-11-23",2002,11,327,2460,15100,12800,30360
"AL","2002-11-24",2002,11,328,0,15100,13000,28100
"AL","2002-11-25",2002,11,329,500,15000,12900,28400
"AL","2002-11-26",2002,11,330,230,15000,12900,28130
"AL","2002-11-27",2002,11,331,0,15000,12900,27900
"AL","2002-11-28",2002,11,332,0,14900,12900,27800
"AL","2002-11-29",2002,11,333,0,14900,12900,27800
"AL","2002-11-30",2002,11,334,2500,14800,12800,30100
"AL","2002-12-01",2002,12,335,3300,14800,12800,30900
"AL","2002-12-02",2002,12,336,2950,14800,12800,30550
"AL","2002-12-03",2002,12,337,889,14700,12800,28389
"AL","2002-12-04",2002,12,338,0,14700,12800,27500
"AL","2002-12-05",2002,12,339,0,14700,12900,27600
"AL","2002-12-06",2002,12,340,0,14600,12800,27400
"AL","2002-12-07",2002,12,341,0,14600,12900,27500
"AL","2002-12-08",2002,12,342,93.5,14600,12800,27493.5
"AL","2002-12-09",2002,12,343,0,14500,12800,27300
"AL","2002-12-10",2002,12,344,0,14500,12800,27300
"AL","2002-12-11",2002,12,345,0,14500,12800,27300
"AL","2002-12-12",2002,12,346,0,14400,12800,27200
"AL","2002-12-13",2002,12,347,0,14400,12800,27200
"AL","2002-12-14",2002,12,348,0,14400,12800,27200
"AL","2002-12-15",2002,12,349,0,14300,12800,27100
"AL","2002-12-16",2002,12,350,0,14300,12800,27100
"AL","2002-12-17",2002,12,351,93.5,14300,12700,27093.5
"AL","2002-12-18",2002,12,352,1920,14200,12700,28820
"AL","2002-12-19",2002,12,353,13900,14200,12500,40600
"AL","2002-12-20",2002,12,354,3300,14900,13500,31700
"AL","2002-12-21",2002,12,355,258,14300,12800,27358
"AL","2002-12-22",2002,12,356,0,14200,12700,26900
"AL","2002-12-23",2002,12,357,0,14200,12700,26900
"AL","2002-12-24",2002,12,358,0,14100,12700,26800
"AL","2002-12-25",2002,12,359,0,14100,12700,26800
"AL","2002-12-26",2002,12,360,0,14100,12600,26700
"AL","2002-12-27",2002,12,361,0,14000,12600,26600
"AL","2002-12-28",2002,12,362,0,14000,12600,26600
"AL","2002-12-29",2002,12,363,0,13900,12600,26500
"AL","2002-12-30",2002,12,364,0,13900,12600,26500
"AL","2002-12-31",2002,12,365,0,13900,12500,26400
"AL","2003-01-01",2003,1,1,0,13800,12500,26300
"AL","2003-01-02",2003,1,2,0,13800,12500,26300
"AL","2003-01-03",2003,1,3,0,13800,12400,26200
"AL","2003-01-04",2003,1,4,0,13700,12400,26100
"AL","2003-01-05",2003,1,5,1560,13700,12400,27660
"AL","2003-01-06",2003,1,6,4000,13700,12300,30000
"AL","2003-01-07",2003,1,7,1580,13600,12300,27480
"AL","2003-01-08",2003,1,8,0,13600,12300,25900
"AL","2003-01-09",2003,1,9,781,13900,13100,27781
"AL","2003-01-10",2003,1,10,0,13600,12300,25900
"AL","2003-01-11",2003,1,11,215,13500,12300,26015
"AL","2003-01-12",2003,1,12,0,13500,12300,25800
"AL","2003-01-13",2003,1,13,0,13500,12200,25700
"AL","2003-01-14",2003,1,14,0,13400,12200,25600
"AL","2003-01-15",2003,1,15,0,13400,12200,25600
"AL","2003-01-16",2003,1,16,0,13300,12100,25400
"AL","2003-01-17",2003,1,17,468,13300,12100,25868
"AL","2003-01-18",2003,1,18,468,13300,12100,25868
"AL","2003-01-19",2003,1,19,2340,13200,12000,27540
"AL","2003-01-20",2003,1,20,0,13200,12000,25200
"AL","2003-01-21",2003,1,21,0,13100,12000,25100
"AL","2003-01-22",2003,1,22,0,13100,12000,25100
"AL","2003-01-23",2003,1,23,0,13100,12000,25100
"AL","2003-01-24",2003,1,24,0,13000,11900,24900
"AL","2003-01-25",2003,1,25,0,13000,11900,24900
"AL","2003-01-26",2003,1,26,1310,13000,11900,26210
"AL","2003-01-27",2003,1,27,4080,12900,11800,28780
"AL","2003-01-28",2003,1,28,781,12900,11800,25481
"AL","2003-01-29",2003,1,29,3380,12900,11700,27980
"AL","2003-01-30",2003,1,30,703,12900,11700,25303
"AL","2003-01-31",2003,1,31,0,12800,11700,24500
"AL","2003-02-01",2003,2,32,0,12800,11700,24500
"AL","2003-02-02",2003,2,33,0,12800,11700,24500
"AL","2003-02-03",2003,2,34,3090,12700,11700,27490
"AL","2003-02-04",2003,2,35,12500,12700,11500,36700
"AL","2003-02-05",2003,2,36,5540,12700,11400,29640
"AL","2003-02-06",2003,2,37,0,12700,11500,24200
"AL","2003-02-07",2003,2,38,0,12600,11500,24100
"AL","2003-02-08",2003,2,39,1130,12600,11500,25230
"AL","2003-02-09",2003,2,40,739,12600,11500,24839
"AL","2003-02-10",2003,2,41,258,12500,11500,24258
"AL","2003-02-11",2003,2,42,258,12500,11500,24258
"AL","2003-02-12",2003,2,43,1880,12500,11500,25880
"AL","2003-02-13",2003,2,44,0,12500,11500,24000
"AL","2003-02-14",2003,2,45,0,12400,11500,23900
"AL","2003-02-15",2003,2,46,0,12400,11500,23900
"AL","2003-02-16",2003,2,47,0,12400,11500,23900
"AL","2003-02-17",2003,2,48,0,12400,11500,23900
"AL","2003-02-18",2003,2,49,0,12300,11500,23800
"AL","2003-02-19",2003,2,50,0,12300,11500,23800
"AL","2003-02-20",2003,2,51,0,12300,11400,23700
"AL","2003-02-21",2003,2,52,10600,12300,11200,34100
"AL","2003-02-22",2003,2,53,0,12200,11200,23400
"AL","2003-02-23",2003,2,54,0,12200,11300,23500
"AL","2003-02-24",2003,2,55,0,12200,11300,23500
"AL","2003-02-25",2003,2,56,0,12200,11300,23500
"AL","2003-02-26",2003,2,57,0,12200,11300,23500
"AL","2003-02-27",2003,2,58,0,12100,11300,23400
"AL","2003-02-28",2003,2,59,0,12100,11300,23400
"AL","2003-03-01",2003,3,60,0,12100,11300,23400
"AL","2003-03-02",2003,3,61,861,12100,11300,24261
"AL","2003-03-03",2003,3,62,0,12000,11300,23300
"AL","2003-03-04",2003,3,63,8610,12000,11100,31710
"AL","2003-03-05",2003,3,64,5470,12000,11000,28470
"AL","2003-03-06",2003,3,65,0,12000,11100,23100
"AL","2003-03-07",2003,3,66,1210,11900,11100,24210
"AL","2003-03-08",2003,3,67,1270,11900,11100,24270
"AL","2003-03-09",2003,3,68,10900,11900,10900,33700
"AL","2003-03-10",2003,3,69,2950,11900,10900,25750
"AL","2003-03-11",2003,3,70,517,11900,10900,23317
"AL","2003-03-12",2003,3,71,1400,11800,11000,24200
"AL","2003-03-13",2003,3,72,582,11800,11000,23382
"AL","2003-03-14",2003,3,73,0,11800,11000,22800
"AL","2003-03-15",2003,3,74,0,11800,11100,22900
"AL","2003-03-16",2003,3,75,0,11800,11100,22900
"AL","2003-03-17",2003,3,76,0,12300,12300,24600
"AL","2003-03-18",2003,3,77,0,15800,19000,34800
"AL","2003-03-19",2003,3,78,0,15100,17100,32200
"AL","2003-03-20",2003,3,79,0,15000,16600,31600
"AL","2003-03-21",2003,3,80,9480,18800,21800,50080
"AL","2003-03-22",2003,3,81,15300,17500,17600,50400
"AL","2003-03-23",2003,3,82,3600,15400,13400,32400
"AL","2003-03-24",2003,3,83,0,13600,11500,25100
"AL","2003-03-25",2003,3,84,0,13300,11400,24700
"AL","2003-03-26",2003,3,85,0,13100,11200,24300
"AL","2003-03-27",2003,3,86,0,12900,11200,24100
"AL","2003-03-28",2003,3,87,10900,13900,11300,36100
"AL","2003-03-29",2003,3,88,37400,12800,10500,60700
"AL","2003-03-30",2003,3,89,6870,12600,10600,30070
"AL","2003-03-31",2003,3,90,0,12500,10900,23400
"AL","2003-04-01",2003,4,91,0,12400,11000,23400
"AL","2003-04-02",2003,4,92,6090,12700,11800,30590
"AL","2003-04-03",2003,4,93,558,15700,17400,33658
"AL","2003-04-04",2003,4,94,4280,12900,11700,28880
"AL","2003-04-05",2003,4,95,12200,12700,11200,36100
"AL","2003-04-06",2003,4,96,13700,12600,11000,37300
"AL","2003-04-07",2003,4,97,0,12500,11200,23700
"AL","2003-04-08",2003,4,98,0,12400,11200,23600
"AL","2003-04-09",2003,4,99,0,12400,11300,23700
"AL","2003-04-10",2003,4,100,0,12300,11300,23600
"AL","2003-04-11",2003,4,101,0,13800,15900,29700
"AL","2003-04-12",2003,4,102,0,16300,19400,35700
"AL","2003-04-13",2003,4,103,0,16600,15300,31900
"AL","2003-04-14",2003,4,104,0,13200,11500,24700
"AL","2003-04-15",2003,4,105,1360,13000,11300,25660
"AL","2003-04-16",2003,4,106,0,12800,11200,24000
"AL","2003-04-17",2003,4,107,38300,22500,21700,82500
"AL","2003-04-18",2003,4,108,36100,13600,10800,60500
"AL","2003-04-19",2003,4,109,37500,13400,10400,61300
"AL","2003-04-20",2003,4,110,13800,13300,11100,38200
"AL","2003-04-21",2003,4,111,23400,82700,108000,214100
"AL","2003-04-22",2003,4,112,14700,20400,20100,55200
"AL","2003-04-23",2003,4,113,1540,17700,17600,36840
"AL","2003-04-24",2003,4,114,0,17800,18600,36400
"AL","2003-04-25",2003,4,115,0,17000,16200,33200
"AL","2003-04-26",2003,4,116,0,14900,12900,27800
"AL","2003-04-27",2003,4,117,0,14800,13100,27900
"AL","2003-04-28",2003,4,118,174,14600,13100,27874
"AL","2003-04-29",2003,4,119,0,14400,13000,27400
"AL","2003-04-30",2003,4,120,0,14200,12900,27100
"AL","2003-05-01",2003,5,121,0,14000,12900,26900
"AL","2003-05-02",2003,5,122,0,13900,12900,26800
"AL","2003-05-03",2003,5,123,0,13800,12800,26600
"AL","2003-05-04",2003,5,124,0,13700,12800,26500
"AL","2003-05-05",2003,5,125,0,13600,12700,26300
"AL","2003-05-06",2003,5,126,6640,14200,12900,33740
"AL","2003-05-07",2003,5,127,19700,17900,15800,53400
"AL","2003-05-08",2003,5,128,4200,14200,12800,31200
"AL","2003-05-09",2003,5,129,17400,17300,17800,52500
"AL","2003-05-10",2003,5,130,17400,17900,18900,54200
"AL","2003-05-11",2003,5,131,55700,29800,36900,122400
"AL","2003-05-12",2003,5,132,104000,48100,62600,214700
"AL","2003-05-13",2003,5,133,61300,41200,54400,156900
"AL","2003-05-14",2003,5,134,0,21400,27700,49100
"AL","2003-05-15",2003,5,135,0,17800,17100,34900
"AL","2003-05-16",2003,5,136,0,16400,15200,31600
"AL","2003-05-17",2003,5,137,0,16100,15300,31400
"AL","2003-05-18",2003,5,138,0,15800,15400,31200
"AL","2003-05-19",2003,5,139,0,15500,15400,30900
"AL","2003-05-20",2003,5,140,16600,16700,15600,48900
"AL","2003-05-21",2003,5,141,27400,20700,16700,64800
"AL","2003-05-22",2003,5,142,0,16400,15500,31900
"AL","2003-05-23",2003,5,143,0,16100,15800,31900
"AL","2003-05-24",2003,5,144,0,15400,15700,31100
"AL","2003-05-25",2003,5,145,0,15000,15600,30600
"AL","2003-05-26",2003,5,146,0,14500,15400,29900
"AL","2003-05-27",2003,5,147,0,14200,15100,29300
"AL","2003-05-28",2003,5,148,4060,14200,14900,33160
"AL","2003-05-29",2003,5,149,462,14000,14600,29062
"AL","2003-05-30",2003,5,150,6050,14600,14500,35150
"AL","2003-05-31",2003,5,151,5540,14800,14500,34840
"AL","2003-06-01",2003,6,152,3000,14300,14300,31600
"AL","2003-06-02",2003,6,153,0,14100,14300,28400
"AL","2003-06-03",2003,6,154,0,14100,14300,28400
"AL","2003-06-04",2003,6,155,0,13600,14200,27800
"AL","2003-06-05",2003,6,156,0,13500,14100,27600
"AL","2003-06-06",2003,6,157,0,13500,14000,27500
"AL","2003-06-07",2003,6,158,10700,14300,13900,38900
"AL","2003-06-08",2003,6,159,26100,17800,14100,58000
"AL","2003-06-09",2003,6,160,507,14800,13800,29107
"AL","2003-06-10",2003,6,161,24500,17900,14900,57300
"AL","2003-06-11",2003,6,162,24900,19500,16700,61100
"AL","2003-06-12",2003,6,163,20300,20900,20200,61400
"AL","2003-06-13",2003,6,164,0,16100,14600,30700
"AL","2003-06-14",2003,6,165,0,15700,14600,30300
"AL","2003-06-15",2003,6,166,0,15200,14500,29700
"AL","2003-06-16",2003,6,167,0,14500,14400,28900
"AL","2003-06-17",2003,6,168,0,14300,14200,28500
"AL","2003-06-18",2003,6,169,0,14200,14000,28200
"AL","2003-06-19",2003,6,170,0,14100,13800,27900
"AL","2003-06-20",2003,6,171,0,14000,13700,27700
"AL","2003-06-21",2003,6,172,0,13900,13600,27500
"AL","2003-06-22",2003,6,173,0,13800,13500,27300
"AL","2003-06-23",2003,6,174,4780,14000,13400,32180
"AL","2003-06-24",2003,6,175,1840,13900,13200,28940
"AL","2003-06-25",2003,6,176,33000,18300,13200,64500
"AL","2003-06-26",2003,6,177,11000,16300,13100,40400
"AL","2003-06-27",2003,6,178,507,15000,13200,28707
"AL","2003-06-28",2003,6,179,1770,14600,13200,29570
"AL","2003-06-29",2003,6,180,4230,14700,13300,32230
"AL","2003-06-30",2003,6,181,2990,14600,13200,30790
"AL","2003-07-01",2003,7,182,0,14200,13200,27400
"AL","2003-07-02",2003,7,183,0,14000,13300,27300
"AL","2003-07-03",2003,7,184,6420,14000,13300,33720
"AL","2003-07-04",2003,7,185,8030,14600,13200,35830
"AL","2003-07-05",2003,7,186,0,13700,13100,26800
"AL","2003-07-06",2003,7,187,0,13500,13200,26700
"AL","2003-07-07",2003,7,188,0,13400,13200,26600
"AL","2003-07-08",2003,7,189,0,13300,13200,26500
"AL","2003-07-09",2003,7,190,0,13200,13100,26300
"AL","2003-07-10",2003,7,191,1400,13200,13000,27600
"AL","2003-07-11",2003,7,192,10300,14100,12800,37200
"AL","2003-07-12",2003,7,193,12100,15000,12600,39700
"AL","2003-07-13",2003,7,194,0,13800,12600,26400
"AL","2003-07-14",2003,7,195,0,13600,12700,26300
"AL","2003-07-15",2003,7,196,2450,13200,12700,28350
"AL","2003-07-16",2003,7,197,2040,13100,12700,27840
"AL","2003-07-17",2003,7,198,3030,13100,12600,28730
"AL","2003-07-18",2003,7,199,5870,13500,12700,32070
"AL","2003-07-19",2003,7,200,0,12700,12700,25400
"AL","2003-07-20",2003,7,201,3030,12700,12700,28430
"AL","2003-07-21",2003,7,202,14100,14300,12600,41000
"AL","2003-07-22",2003,7,203,15300,14800,12400,42500
"AL","2003-07-23",2003,7,204,700,13400,12300,26400
"AL","2003-07-24",2003,7,205,643,13100,12300,26043
"AL","2003-07-25",2003,7,206,0,12700,12400,25100
"AL","2003-07-26",2003,7,207,233,12600,12400,25233
"AL","2003-07-27",2003,7,208,2310,12500,12500,27310
"AL","2003-07-28",2003,7,209,643,12400,12500,25543
"AL","2003-07-29",2003,7,210,0,12300,12400,24700
"AL","2003-07-30",2003,7,211,12400,13100,12200,37700
"AL","2003-07-31",2003,7,212,4300,12800,12200,29300
"AL","2003-08-01",2003,8,213,19100,14700,12100,45900
"AL","2003-08-02",2003,8,214,2920,13400,11900,28220
"AL","2003-08-03",2003,8,215,3160,13100,12100,28360
"AL","2003-08-04",2003,8,216,14000,14300,12100,40400
"AL","2003-08-05",2003,8,217,1510,13300,12000,26810
"AL","2003-08-06",2003,8,218,0,12700,12100,24800
"AL","2003-08-07",2003,8,219,0,12500,12100,24600
"AL","2003-08-08",2003,8,220,3140,12400,12100,27640
"AL","2003-08-09",2003,8,221,483,12100,12100,24683
"AL","2003-08-10",2003,8,222,0,11900,12100,24000
"AL","2003-08-11",2003,8,223,0,11900,12200,24100
"AL","2003-08-12",2003,8,224,0,11800,12200,24000
"AL","2003-08-13",2003,8,225,0,11700,12200,23900
"AL","2003-08-14",2003,8,226,0,11700,12200,23900
"AL","2003-08-15",2003,8,227,0,11600,12200,23800
"AL","2003-08-16",2003,8,228,0,11600,12100,23700
"AL","2003-08-17",2003,8,229,0,11500,12000,23500
"AL","2003-08-18",2003,8,230,0,11500,11900,23400
"AL","2003-08-19",2003,8,231,0,11400,11900,23300
"AL","2003-08-20",2003,8,232,702,11400,11800,23902
"AL","2003-08-21",2003,8,233,1050,11400,11700,24150
"AL","2003-08-22",2003,8,234,21100,13900,11500,46500
"AL","2003-08-23",2003,8,235,0,12200,11400,23600
"AL","2003-08-24",2003,8,236,5970,12100,11400,29470
"AL","2003-08-25",2003,8,237,21900,14600,11200,47700
"AL","2003-08-26",2003,8,238,1750,12600,11200,25550
"AL","2003-08-27",2003,8,239,1450,12100,11500,25050
"AL","2003-08-28",2003,8,240,0,11500,11500,23000
"AL","2003-08-29",2003,8,241,4040,11500,11500,27040
"AL","2003-08-30",2003,8,242,6610,12100,11400,30110
"AL","2003-08-31",2003,8,243,0,11600,11300,22900
"AL","2003-09-01",2003,9,244,0,11600,11400,23000
"AL","2003-09-02",2003,9,245,0,11200,11400,22600
"AL","2003-09-03",2003,9,246,0,11100,11400,22500
"AL","2003-09-04",2003,9,247,0,11000,11300,22300
"AL","2003-09-05",2003,9,248,247,11000,11300,22547
"AL","2003-09-06",2003,9,249,0,10900,11300,22200
"AL","2003-09-07",2003,9,250,0,10900,11300,22200
"AL","2003-09-08",2003,9,251,0,10800,11300,22100
"AL","2003-09-09",2003,9,252,0,10800,11300,22100
"AL","2003-09-10",2003,9,253,0,10700,11200,21900
"AL","2003-09-11",2003,9,254,0,10700,11200,21900
"AL","2003-09-12",2003,9,255,0,10700,11200,21900
"AL","2003-09-13",2003,9,256,4280,10800,11100,26180
"AL","2003-09-14",2003,9,257,24100,13900,10900,48900
"AL","2003-09-15",2003,9,258,11800,13400,10800,36000
"AL","2003-09-16",2003,9,259,1870,12200,10800,24870
"AL","2003-09-17",2003,9,260,0,11800,10900,22700
"AL","2003-09-18",2003,9,261,0,11700,11000,22700
"AL","2003-09-19",2003,9,262,4390,11700,11000,27090
"AL","2003-09-20",2003,9,263,6760,12200,11000,29960
"AL","2003-09-21",2003,9,264,0,11600,11000,22600
"AL","2003-09-22",2003,9,265,2750,11600,11000,25350
"AL","2003-09-23",2003,9,266,7330,12300,11000,30630
"AL","2003-09-24",2003,9,267,4070,12100,11000,27170
"AL","2003-09-25",2003,9,268,2940,11900,11000,25840
"AL","2003-09-26",2003,9,269,2060,11800,11000,24860
"AL","2003-09-27",2003,9,270,4840,12000,11000,27840
"AL","2003-09-28",2003,9,271,9890,12800,11100,33790
"AL","2003-09-29",2003,9,272,6320,12900,11100,30320
"AL","2003-09-30",2003,9,273,2200,12300,11000,25500
"AL","2003-10-01",2003,10,274,2930,12200,11000,26130
"AL","2003-10-02",2003,10,275,5130,12700,11000,28830
"AL","2003-10-03",2003,10,276,2640,12400,11000,26040
"AL","2003-10-04",2003,10,277,2560,12300,10900,25760
"AL","2003-10-05",2003,10,278,485,12000,10900,23385
"AL","2003-10-06",2003,10,279,0,11700,10800,22500
"AL","2003-10-07",2003,10,280,0,11700,10800,22500
"AL","2003-10-08",2003,10,281,0,11700,10800,22500
"AL","2003-10-09",2003,10,282,0,11700,10700,22400
"AL","2003-10-10",2003,10,283,0,11700,10800,22500
"AL","2003-10-11",2003,10,284,0,11700,10800,22500
"AL","2003-10-12",2003,10,285,6830,12300,10800,29930
"AL","2003-10-13",2003,10,286,14700,14300,11300,40300
"AL","2003-10-14",2003,10,287,0,12200,10700,22900
"AL","2003-10-15",2003,10,288,0,11900,10700,22600
"AL","2003-10-16",2003,10,289,0,11900,10700,22600
"AL","2003-10-17",2003,10,290,0,11900,10600,22500
"AL","2003-10-18",2003,10,291,0,11800,10600,22400
"AL","2003-10-19",2003,10,292,0,11800,10600,22400
"AL","2003-10-20",2003,10,293,0,11800,10600,22400
"AL","2003-10-21",2003,10,294,0,11700,10600,22300
"AL","2003-10-22",2003,10,295,0,11700,10600,22300
"AL","2003-10-23",2003,10,296,1610,11700,10600,23910
"AL","2003-10-24",2003,10,297,4870,12300,10600,27770
"AL","2003-10-25",2003,10,298,3260,12100,10700,26060
"AL","2003-10-26",2003,10,299,1060,11700,10600,23360
"AL","2003-10-27",2003,10,300,1700,11700,10600,24000
"AL","2003-10-28",2003,10,301,10900,11600,10300,32800
"AL","2003-10-29",2003,10,302,22200,11600,9930,43730
"AL","2003-10-30",2003,10,303,2570,12700,11300,26570
"AL","2003-10-31",2003,10,304,5780,15200,13700,34680
"AL","2003-11-01",2003,11,305,8800,15900,14800,39500
"AL","2003-11-02",2003,11,306,1210,13700,14700,29610
"AL","2003-11-03",2003,11,307,0,12500,10600,23100
"AL","2003-11-04",2003,11,308,3330,12500,10600,26430
"AL","2003-11-05",2003,11,309,19200,12500,10200,41900
"AL","2003-11-06",2003,11,310,4920,12300,10200,27420
"AL","2003-11-07",2003,11,311,0,12200,10400,22600
"AL","2003-11-08",2003,11,312,0,12100,10400,22500
"AL","2003-11-09",2003,11,313,0,12000,10500,22500
"AL","2003-11-10",2003,11,314,0,11900,10500,22400
"AL","2003-11-11",2003,11,315,230,11900,10500,22630
"AL","2003-11-12",2003,11,316,1060,12600,13100,26760
"AL","2003-11-13",2003,11,317,833,15400,14800,31033
"AL","2003-11-14",2003,11,318,1210,12300,10600,24110
"AL","2003-11-15",2003,11,319,0,12000,10500,22500
"AL","2003-11-16",2003,11,320,1020,12000,10500,23520
"AL","2003-11-17",2003,11,321,6630,12200,10400,29230
"AL","2003-11-18",2003,11,322,12800,15600,16000,44400
"AL","2003-11-19",2003,11,323,38000,17000,18700,73700
"AL","2003-11-20",2003,11,324,689,17200,18800,36689
"AL","2003-11-21",2003,11,325,0,13400,11500,24900
"AL","2003-11-22",2003,11,326,0,13000,10800,23800
"AL","2003-11-23",2003,11,327,2330,12800,10700,25830
"AL","2003-11-24",2003,11,328,11100,12700,10500,34300
"AL","2003-11-25",2003,11,329,11300,12500,10400,34200
"AL","2003-11-26",2003,11,330,1110,12400,10600,24110
"AL","2003-11-27",2003,11,331,1000,12300,10600,23900
"AL","2003-11-28",2003,11,332,1190,12200,10700,24090
"AL","2003-11-29",2003,11,333,459,12200,10700,23359
"AL","2003-11-30",2003,11,334,563,12100,10700,23363
"AL","2003-12-01",2003,12,335,0,12000,10700,22700
"AL","2003-12-02",2003,12,336,0,12000,10700,22700
"AL","2003-12-03",2003,12,337,0,11900,10700,22600
"AL","2003-12-04",2003,12,338,0,11900,10700,22600
"AL","2003-12-05",2003,12,339,0,11800,10700,22500
"AL","2003-12-06",2003,12,340,0,11800,10700,22500
"AL","2003-12-07",2003,12,341,0,11700,10600,22300
"AL","2003-12-08",2003,12,342,0,11700,10600,22300
"AL","2003-12-09",2003,12,343,3210,11700,10600,25510
"AL","2003-12-10",2003,12,344,9300,11600,10400,31300
"AL","2003-12-11",2003,12,345,9280,11600,10300,31180
"AL","2003-12-12",2003,12,346,5300,11600,10200,27100
"AL","2003-12-13",2003,12,347,129,11600,10300,22029
"AL","2003-12-14",2003,12,348,0,11500,10400,21900
"AL","2003-12-15",2003,12,349,0,11500,10400,21900
"AL","2003-12-16",2003,12,350,935,11500,10400,22835
"AL","2003-12-17",2003,12,351,6050,11400,10300,27750
"AL","2003-12-18",2003,12,352,1230,11400,10300,22930
"AL","2003-12-19",2003,12,353,281,11400,10300,21981
"AL","2003-12-20",2003,12,354,0,11400,10300,21700
"AL","2003-12-21",2003,12,355,0,11400,10400,21800
"AL","2003-12-22",2003,12,356,0,11300,10400,21700
"AL","2003-12-23",2003,12,357,374,11300,10400,22074
"AL","2003-12-24",2003,12,358,1090,11300,10300,22690
"AL","2003-12-25",2003,12,359,760,11300,10300,22360
"AL","2003-12-26",2003,12,360,0,11300,10300,21600
"AL","2003-12-27",2003,12,361,0,11200,10300,21500
"AL","2003-12-28",2003,12,362,963,11200,10300,22463
"AL","2003-12-29",2003,12,363,1680,11300,10300,23280
"AL","2003-12-30",2003,12,364,281,12000,11000,23281
"AL","2003-12-31",2003,12,365,644,11400,10300,22344
"AL","2004-01-01",2004,1,1,0,11300,10300,21600
"AL","2004-01-02",2004,1,2,312,11300,10300,21912
"AL","2004-01-03",2004,1,3,1800,11200,10200,23200
"AL","2004-01-04",2004,1,4,2150,11200,10200,23550
"AL","2004-01-05",2004,1,5,781,11200,10200,22181
"AL","2004-01-06",2004,1,6,430,11200,10200,21830
"AL","2004-01-07",2004,1,7,0,11100,10200,21300
"AL","2004-01-08",2004,1,8,0,11100,10200,21300
"AL","2004-01-09",2004,1,9,0,11100,10200,21300
"AL","2004-01-10",2004,1,10,156,11100,10200,21456
"AL","2004-01-11",2004,1,11,625,11100,10200,21925
"AL","2004-01-12",2004,1,12,3090,11000,10100,24190
"AL","2004-01-13",2004,1,13,1760,11000,10100,22860
"AL","2004-01-14",2004,1,14,8140,11000,9940,29080
"AL","2004-01-15",2004,1,15,23300,11000,9550,43850
"AL","2004-01-16",2004,1,16,1620,11000,9610,22230
"AL","2004-01-17",2004,1,17,4200,11000,9690,24890
"AL","2004-01-18",2004,1,18,1310,10900,9750,21960
"AL","2004-01-19",2004,1,19,0,10900,9810,20710
"AL","2004-01-20",2004,1,20,0,10900,9860,20760
"AL","2004-01-21",2004,1,21,781,10900,9870,21551
"AL","2004-01-22",2004,1,22,1760,10900,9860,22520
"AL","2004-01-23",2004,1,23,4280,10900,9810,24990
"AL","2004-01-24",2004,1,24,781,10800,9820,21401
"AL","2004-01-25",2004,1,25,1080,10800,9850,21730
"AL","2004-01-26",2004,1,26,0,10800,9870,20670
"AL","2004-01-27",2004,1,27,937,10800,9880,21617
"AL","2004-01-28",2004,1,28,3910,10800,9820,24530
"AL","2004-01-29",2004,1,29,567,10700,9830,21097
"AL","2004-01-30",2004,1,30,0,10700,9860,20560
"AL","2004-01-31",2004,1,31,0,10700,9880,20580
"AL","2004-02-01",2004,2,32,468,10700,9880,21048
"AL","2004-02-02",2004,2,33,1590,10700,9870,22160
"AL","2004-02-03",2004,2,34,5680,10700,9770,26150
"AL","2004-02-04",2004,2,35,8540,10700,9630,28870
"AL","2004-02-05",2004,2,36,0,10600,9690,20290
"AL","2004-02-06",2004,2,37,844,10600,9740,21184
"AL","2004-02-07",2004,2,38,1160,10600,9740,21500
"AL","2004-02-08",2004,2,39,0,10600,9780,20380
"AL","2004-02-09",2004,2,40,188,10600,9800,20588
"AL","2004-02-10",2004,2,41,3910,10600,9730,24240
"AL","2004-02-11",2004,2,42,762,10500,9730,20992
"AL","2004-02-12",2004,2,43,844,10500,9750,21094
"AL","2004-02-13",2004,2,44,2000,10500,9730,22230
"AL","2004-02-14",2004,2,45,0,10500,9750,20250
"AL","2004-02-15",2004,2,46,0,10500,9780,20280
"AL","2004-02-16",2004,2,47,0,10500,9770,20270
"AL","2004-02-17",2004,2,48,0,10400,9780,20180
"AL","2004-02-18",2004,2,49,0,10400,9790,20190
"AL","2004-02-19",2004,2,50,0,10400,9790,20190
"AL","2004-02-20",2004,2,51,3850,10400,9720,23970
"AL","2004-02-21",2004,2,52,11700,10400,9510,31610
"AL","2004-02-22",2004,2,53,5200,10400,9460,25060
"AL","2004-02-23",2004,2,54,3380,10300,9490,23170
"AL","2004-02-24",2004,2,55,10200,10300,9360,29860
"AL","2004-02-25",2004,2,56,0,10300,9440,19740
"AL","2004-02-26",2004,2,57,0,10300,9530,19830
"AL","2004-02-27",2004,2,58,0,10300,9560,19860
"AL","2004-02-28",2004,2,59,0,10300,9600,19900
"AL","2004-02-29",2004,2,60,0,10300,9620,19920
"AL","2004-03-01",2004,3,61,281,10200,9630,20111
"AL","2004-03-02",2004,3,62,744,10200,9670,20614
"AL","2004-03-03",2004,3,63,15300,10200,9500,35000
"AL","2004-03-04",2004,3,64,2430,10700,10400,23530
"AL","2004-03-05",2004,3,65,4910,11400,12100,28410
"AL","2004-03-06",2004,3,66,16300,10800,10000,37100
"AL","2004-03-07",2004,3,67,15700,10400,9110,35210
"AL","2004-03-08",2004,3,68,15100,10400,8920,34420
"AL","2004-03-09",2004,3,69,2130,10400,9080,21610
"AL","2004-03-10",2004,3,70,0,10300,9260,19560
"AL","2004-03-11",2004,3,71,3790,10300,9310,23400
"AL","2004-03-12",2004,3,72,10500,10300,9160,29960
"AL","2004-03-13",2004,3,73,4160,10300,9160,23620
"AL","2004-03-14",2004,3,74,5510,10200,9170,24880
"AL","2004-03-15",2004,3,75,28500,10200,8760,47460
"AL","2004-03-16",2004,3,76,1420,10200,8880,20500
"AL","2004-03-17",2004,3,77,689,10200,9110,19999
"AL","2004-03-18",2004,3,78,1190,10200,9210,20600
"AL","2004-03-19",2004,3,79,474,10100,9280,19854
"AL","2004-03-20",2004,3,80,0,10100,9380,19480
"AL","2004-03-21",2004,3,81,517,10100,9420,20037
"AL","2004-03-22",2004,3,82,237,10100,9480,19817
"AL","2004-03-23",2004,3,83,0,10100,9480,19580
"AL","2004-03-24",2004,3,84,0,10100,9530,19630
"AL","2004-03-25",2004,3,85,0,10000,9560,19560
"AL","2004-03-26",2004,3,86,1490,10000,9580,21070
"AL","2004-03-27",2004,3,87,20900,10000,9230,40130
"AL","2004-03-28",2004,3,88,1050,10100,10900,22050
"AL","2004-03-29",2004,3,89,7780,14800,20100,42680
"AL","2004-03-30",2004,3,90,11800,15500,20400,47700
"AL","2004-03-31",2004,3,91,0,12300,12100,24400
"AL","2004-04-01",2004,4,92,0,11400,10000,21400
"AL","2004-04-02",2004,4,93,0,11300,10500,21800
"AL","2004-04-03",2004,4,94,0,12500,13400,25900
"AL","2004-04-04",2004,4,95,0,13000,14000,27000
"AL","2004-04-05",2004,4,96,0,11700,11400,23100
"AL","2004-04-06",2004,4,97,0,12200,12900,25100
"AL","2004-04-07",2004,4,98,871,16600,22200,39671
"AL","2004-04-08",2004,4,99,2910,20000,29500,52410
"AL","2004-04-09",2004,4,100,8730,21300,27600,57630
"AL","2004-04-10",2004,4,101,3510,15700,18100,37310
"AL","2004-04-11",2004,4,102,372,15600,17400,33372
"AL","2004-04-12",2004,4,103,1280,13800,12900,27980
"AL","2004-04-13",2004,4,104,0,13500,12200,25700
"AL","2004-04-14",2004,4,105,0,13400,12700,26100
"AL","2004-04-15",2004,4,106,0,15700,17900,33600
"AL","2004-04-16",2004,4,107,0,17100,20200,37300
"AL","2004-04-17",2004,4,108,0,19300,22000,41300
"AL","2004-04-18",2004,4,109,7800,21600,17600,47000
"AL","2004-04-19",2004,4,110,35800,23600,27300,86700
"AL","2004-04-20",2004,4,111,44600,29800,32300,106700
"AL","2004-04-21",2004,4,112,2400,15900,13300,31600
"AL","2004-04-22",2004,4,113,12500,18100,16900,47500
"AL","2004-04-23",2004,4,114,5680,16600,14800,37080
"AL","2004-04-24",2004,4,115,0,15200,13400,28600
"AL","2004-04-25",2004,4,116,6070,15700,13800,35570
"AL","2004-04-26",2004,4,117,13400,18500,17600,49500
"AL","2004-04-27",2004,4,118,7820,17000,15500,40320
"AL","2004-04-28",2004,4,119,4610,15800,14400,34810
"AL","2004-04-29",2004,4,120,5070,16100,14600,35770
"AL","2004-04-30",2004,4,121,2910,15100,13300,31310
"AL","2004-05-01",2004,5,122,14000,18200,16900,49100
"AL","2004-05-02",2004,5,123,0,14700,13000,27700
"AL","2004-05-03",2004,5,124,0,14600,13000,27600
"AL","2004-05-04",2004,5,125,0,14400,12900,27300
"AL","2004-05-05",2004,5,126,0,14300,12800,27100
"AL","2004-05-06",2004,5,127,0,14200,12700,26900
"AL","2004-05-07",2004,5,128,0,14100,12700,26800
"AL","2004-05-08",2004,5,129,0,13400,12700,26100
"AL","2004-05-09",2004,5,130,1530,13000,12500,27030
"AL","2004-05-10",2004,5,131,1850,13000,12400,27250
"AL","2004-05-11",2004,5,132,15200,15100,12600,42900
"AL","2004-05-12",2004,5,133,0,13000,12300,25300
"AL","2004-05-13",2004,5,134,0,12500,12300,24800
"AL","2004-05-14",2004,5,135,44500,19100,14600,78200
"AL","2004-05-15",2004,5,136,15600,16700,16200,48500
"AL","2004-05-16",2004,5,137,7590,15900,14800,38290
"AL","2004-05-17",2004,5,138,1480,14400,12600,28480
"AL","2004-05-18",2004,5,139,0,13800,12600,26400
"AL","2004-05-19",2004,5,140,763,13400,12500,26663
"AL","2004-05-20",2004,5,141,3510,13000,12400,28910
"AL","2004-05-21",2004,5,142,3560,13000,12300,28860
"AL","2004-05-22",2004,5,143,2950,12700,12200,27850
"AL","2004-05-23",2004,5,144,7870,13400,12100,33370
"AL","2004-05-24",2004,5,145,18300,15200,12500,46000
"AL","2004-05-25",2004,5,146,33900,22100,20300,76300
"AL","2004-05-26",2004,5,147,0,14500,12300,26800
"AL","2004-05-27",2004,5,148,0,14300,12400,26700
"AL","2004-05-28",2004,5,149,17800,16800,15400,50000
"AL","2004-05-29",2004,5,150,0,14100,12400,26500
"AL","2004-05-30",2004,5,151,0,13900,12500,26400
"AL","2004-05-31",2004,5,152,4890,14000,12500,31390
"AL","2004-06-01",2004,6,153,64800,31400,36200,132400
"AL","2004-06-02",2004,6,154,3680,15900,14200,33780
"AL","2004-06-03",2004,6,155,2790,15300,13000,31090
"AL","2004-06-04",2004,6,156,0,14600,13000,27600
"AL","2004-06-05",2004,6,157,0,14400,13100,27500
"AL","2004-06-06",2004,6,158,0,13700,12900,26600
"AL","2004-06-07",2004,6,159,25000,16900,13800,55700
"AL","2004-06-08",2004,6,160,0,14200,12800,27000
"AL","2004-06-09",2004,6,161,0,13700,12900,26600
"AL","2004-06-10",2004,6,162,15500,14900,12900,43300
"AL","2004-06-11",2004,6,163,4560,14100,12700,31360
"AL","2004-06-12",2004,6,164,0,13400,12700,26100
"AL","2004-06-13",2004,6,165,18600,15800,13300,47700
"AL","2004-06-14",2004,6,166,1570,14000,12600,28170
"AL","2004-06-15",2004,6,167,16600,15800,13800,46200
"AL","2004-06-16",2004,6,168,507,13800,12500,26807
"AL","2004-06-17",2004,6,169,0,13300,12500,25800
"AL","2004-06-18",2004,6,170,0,13000,12400,25400
"AL","2004-06-19",2004,6,171,0,12700,12300,25000
"AL","2004-06-20",2004,6,172,0,12500,12200,24700
"AL","2004-06-21",2004,6,173,0,12500,12100,24600
"AL","2004-06-22",2004,6,174,0,12400,12000,24400
"AL","2004-06-23",2004,6,175,989,12300,11900,25189
"AL","2004-06-24",2004,6,176,13400,13700,11800,38900
"AL","2004-06-25",2004,6,177,12800,14400,11700,38900
"AL","2004-06-26",2004,6,178,368,13300,11600,25268
"AL","2004-06-27",2004,6,179,7870,13800,11700,33370
"AL","2004-06-28",2004,6,180,0,13000,11700,24700
"AL","2004-06-29",2004,6,181,0,12800,11700,24500
"AL","2004-06-30",2004,6,182,0,12500,11700,24200
"AL","2004-07-01",2004,7,183,0,12200,11700,23900
"AL","2004-07-02",2004,7,184,7310,12700,11800,31810
"AL","2004-07-03",2004,7,185,0,11900,11800,23700
"AL","2004-07-04",2004,7,186,0,11800,11800,23600
"AL","2004-07-05",2004,7,187,2190,11800,11700,25690
"AL","2004-07-06",2004,7,188,9250,12900,11600,33750
"AL","2004-07-07",2004,7,189,233,12200,11500,23933
"AL","2004-07-08",2004,7,190,12300,13400,11500,37200
"AL","2004-07-09",2004,7,191,496,12500,11400,24396
"AL","2004-07-10",2004,7,192,0,12100,11500,23600
"AL","2004-07-11",2004,7,193,0,12000,11600,23600
"AL","2004-07-12",2004,7,194,0,11700,11600,23300
"AL","2004-07-13",2004,7,195,1230,11600,11600,24430
"AL","2004-07-14",2004,7,196,700,11500,11600,23800
"AL","2004-07-15",2004,7,197,9760,12600,11500,33860
"AL","2004-07-16",2004,7,198,0,11700,11400,23100
"AL","2004-07-17",2004,7,199,4620,12000,11500,28120
"AL","2004-07-18",2004,7,200,0,11400,11400,22800
"AL","2004-07-19",2004,7,201,0,11300,11500,22800
"AL","2004-07-20",2004,7,202,0,11300,11500,22800
"AL","2004-07-21",2004,7,203,3280,11500,11400,26180
"AL","2004-07-22",2004,7,204,0,11200,11400,22600
"AL","2004-07-23",2004,7,205,10400,12100,11300,33800
"AL","2004-07-24",2004,7,206,0,11300,11200,22500
"AL","2004-07-25",2004,7,207,0,11200,11300,22500
"AL","2004-07-26",2004,7,208,0,11100,11300,22400
"AL","2004-07-27",2004,7,209,0,11000,11300,22300
"AL","2004-07-28",2004,7,210,0,11000,11300,22300
"AL","2004-07-29",2004,7,211,0,10900,11300,22200
"AL","2004-07-30",2004,7,212,10100,11800,11100,33000
"AL","2004-07-31",2004,7,213,2410,11400,11000,24810
"AL","2004-08-01",2004,8,214,25300,13900,10800,50000
"AL","2004-08-02",2004,8,215,0,11800,10700,22500
"AL","2004-08-03",2004,8,216,0,11600,10900,22500
"AL","2004-08-04",2004,8,217,29900,15400,10800,56100
"AL","2004-08-05",2004,8,218,1930,12300,10700,24930
"AL","2004-08-06",2004,8,219,0,11800,11000,22800
"AL","2004-08-07",2004,8,220,0,11500,11000,22500
"AL","2004-08-08",2004,8,221,0,11300,11100,22400
"AL","2004-08-09",2004,8,222,197,11100,11100,22397
"AL","2004-08-10",2004,8,223,23800,13400,11000,48200
"AL","2004-08-11",2004,8,224,23000,14800,11200,49000
"AL","2004-08-12",2004,8,225,14300,13900,11200,39400
"AL","2004-08-13",2004,8,226,17200,15100,12500,44800
"AL","2004-08-14",2004,8,227,0,12800,10800,23600
"AL","2004-08-15",2004,8,228,242,12600,11100,23942
"AL","2004-08-16",2004,8,229,0,12100,11100,23200
"AL","2004-08-17",2004,8,230,2900,11700,11000,25600
"AL","2004-08-18",2004,8,231,12300,13000,11000,36300
"AL","2004-08-19",2004,8,232,0,12100,11000,23100
"AL","2004-08-20",2004,8,233,3750,12100,11100,26950
"AL","2004-08-21",2004,8,234,0,11500,11000,22500
"AL","2004-08-22",2004,8,235,0,11500,11000,22500
"AL","2004-08-23",2004,8,236,593,11400,11000,22993
"AL","2004-08-24",2004,8,237,1210,11200,11000,23410
"AL","2004-08-25",2004,8,238,483,10900,10900,22283
"AL","2004-08-26",2004,8,239,8600,11800,10900,31300
"AL","2004-08-27",2004,8,240,0,11100,10800,21900
"AL","2004-08-28",2004,8,241,1940,11000,10800,23740
"AL","2004-08-29",2004,8,242,0,10800,10800,21600
"AL","2004-08-30",2004,8,243,0,10700,10800,21500
"AL","2004-08-31",2004,8,244,2550,10800,10700,24050
"AL","2004-09-01",2004,9,245,0,10700,10700,21400
"AL","2004-09-02",2004,9,246,110,10600,10800,21510
"AL","2004-09-03",2004,9,247,0,10500,10800,21300
"AL","2004-09-04",2004,9,248,0,10400,10800,21200
"AL","2004-09-05",2004,9,249,0,10300,10800,21100
"AL","2004-09-06",2004,9,250,0,10300,10700,21000
"AL","2004-09-07",2004,9,251,20900,12300,10600,43800
"AL","2004-09-08",2004,9,252,0,11100,10400,21500
"AL","2004-09-09",2004,9,253,0,10900,10500,21400
"AL","2004-09-10",2004,9,254,0,10800,10500,21300
"AL","2004-09-11",2004,9,255,0,10600,10500,21100
"AL","2004-09-12",2004,9,256,0,10400,10600,21000
"AL","2004-09-13",2004,9,257,0,10300,10500,20800
"AL","2004-09-14",2004,9,258,0,10200,10500,20700
"AL","2004-09-15",2004,9,259,0,10100,10500,20600
"AL","2004-09-16",2004,9,260,28800,13300,10400,52500
"AL","2004-09-17",2004,9,261,34100,16100,11400,61600
"AL","2004-09-18",2004,9,262,0,11700,10100,21800
"AL","2004-09-19",2004,9,263,0,11700,10300,22000
"AL","2004-09-20",2004,9,264,0,11400,10400,21800
"AL","2004-09-21",2004,9,265,0,11200,10400,21600
"AL","2004-09-22",2004,9,266,0,11000,10400,21400
"AL","2004-09-23",2004,9,267,0,10800,10400,21200
"AL","2004-09-24",2004,9,268,0,10600,10400,21000
"AL","2004-09-25",2004,9,269,6860,11000,10200,28060
"AL","2004-09-26",2004,9,270,549,11000,10200,21749
"AL","2004-09-27",2004,9,271,0,10800,10300,21100
"AL","2004-09-28",2004,9,272,0,10700,10300,21000
"AL","2004-09-29",2004,9,273,439,10600,10300,21339
"AL","2004-09-30",2004,9,274,0,10500,10200,20700
"AL","2004-10-01",2004,10,275,0,10400,10200,20600
"AL","2004-10-02",2004,10,276,670,10400,10200,21270
"AL","2004-10-03",2004,10,277,38900,15100,10900,64900
"AL","2004-10-04",2004,10,278,0,11600,9790,21390
"AL","2004-10-05",2004,10,279,184,11400,10000,21584
"AL","2004-10-06",2004,10,280,0,11100,10000,21100
"AL","2004-10-07",2004,10,281,0,11200,10100,21300
"AL","2004-10-08",2004,10,282,0,11200,10100,21300
"AL","2004-10-09",2004,10,283,5780,11800,9970,27550
"AL","2004-10-10",2004,10,284,1340,11500,9970,22810
"AL","2004-10-11",2004,10,285,0,11200,9980,21180
"AL","2004-10-12",2004,10,286,0,11200,10000,21200
"AL","2004-10-13",2004,10,287,0,11200,10000,21200
"AL","2004-10-14",2004,10,288,0,11100,10100,21200
"AL","2004-10-15",2004,10,289,268,11100,10100,21468
"AL","2004-10-16",2004,10,290,0,11100,10100,21200
"AL","2004-10-17",2004,10,291,8560,12200,10300,31060
"AL","2004-10-18",2004,10,292,0,11300,10000,21300
"AL","2004-10-19",2004,10,293,0,11100,10000,21100
"AL","2004-10-20",2004,10,294,0,11000,10000,21000
"AL","2004-10-21",2004,10,295,0,11000,9980,20980
"AL","2004-10-22",2004,10,296,0,11000,9950,20950
"AL","2004-10-23",2004,10,297,0,11000,9960,20960
"AL","2004-10-24",2004,10,298,43700,20000,16600,80300
"AL","2004-10-25",2004,10,299,13100,15700,15800,44600
"AL","2004-10-26",2004,10,300,184,12500,10300,22984
"AL","2004-10-27",2004,10,301,0,12200,9760,21960
"AL","2004-10-28",2004,10,302,926,12200,9800,22926
"AL","2004-10-29",2004,10,303,0,12100,9800,21900
"AL","2004-10-30",2004,10,304,47100,23500,26600,97200
"AL","2004-10-31",2004,10,305,32200,22500,26100,80800
"AL","2004-11-01",2004,11,306,9060,16500,16000,41560
"AL","2004-11-02",2004,11,307,0,14200,11200,25400
"AL","2004-11-03",2004,11,308,0,13600,10700,24300
"AL","2004-11-04",2004,11,309,282,13400,10700,24382
"AL","2004-11-05",2004,11,310,0,13200,10600,23800
"AL","2004-11-06",2004,11,311,0,13100,10500,23600
"AL","2004-11-07",2004,11,312,0,12900,10400,23300
"AL","2004-11-08",2004,11,313,0,12800,10400,23200
"AL","2004-11-09",2004,11,314,0,12700,10400,23100
"AL","2004-11-10",2004,11,315,0,12600,10400,23000
"AL","2004-11-11",2004,11,316,712,12500,10400,23612
"AL","2004-11-12",2004,11,317,3840,12800,10500,27140
"AL","2004-11-13",2004,11,318,0,12300,10400,22700
"AL","2004-11-14",2004,11,319,0,12200,10400,22600
"AL","2004-11-15",2004,11,320,0,12200,10400,22600
"AL","2004-11-16",2004,11,321,0,12100,10400,22500
"AL","2004-11-17",2004,11,322,0,12100,10400,22500
"AL","2004-11-18",2004,11,323,872,12100,10400,23372
"AL","2004-11-19",2004,11,324,157,12000,10400,22557
"AL","2004-11-20",2004,11,325,0,11900,10400,22300
"AL","2004-11-21",2004,11,326,11100,13600,10800,35500
"AL","2004-11-22",2004,11,327,188,12100,10300,22588
"AL","2004-11-23",2004,11,328,0,11800,10300,22100
"AL","2004-11-24",2004,11,329,0,11800,10200,22000
"AL","2004-11-25",2004,11,330,0,11800,10200,22000
"AL","2004-11-26",2004,11,331,0,11800,10100,21900
"AL","2004-11-27",2004,11,332,0,11700,10100,21800
"AL","2004-11-28",2004,11,333,19400,11800,9750,40950
"AL","2004-11-29",2004,11,334,19500,11700,9430,40630
"AL","2004-11-30",2004,11,335,0,11700,9590,21290
"AL","2004-12-01",2004,12,336,0,11600,9760,21360
"AL","2004-12-02",2004,12,337,0,11600,9810,21410
"AL","2004-12-03",2004,12,338,0,11600,9850,21450
"AL","2004-12-04",2004,12,339,4530,11500,9790,25820
"AL","2004-12-05",2004,12,340,2790,11500,9770,24060
"AL","2004-12-06",2004,12,341,0,11500,9820,21320
"AL","2004-12-07",2004,12,342,3940,11500,9780,25220
"AL","2004-12-08",2004,12,343,258,11500,9810,21568
"AL","2004-12-09",2004,12,344,468,11400,9880,21748
"AL","2004-12-10",2004,12,345,129,11400,9900,21429
"AL","2004-12-11",2004,12,346,7490,11600,10100,29190
"AL","2004-12-12",2004,12,347,995,11500,9850,22345
"AL","2004-12-13",2004,12,348,9880,11400,9680,30960
"AL","2004-12-14",2004,12,349,3150,11400,9660,24210
"AL","2004-12-15",2004,12,350,1330,11400,9720,22450
"AL","2004-12-16",2004,12,351,0,11300,9760,21060
"AL","2004-12-17",2004,12,352,0,11300,9800,21100
"AL","2004-12-18",2004,12,353,258,11300,9810,21368
"AL","2004-12-19",2004,12,354,0,11300,9820,21120
"AL","2004-12-20",2004,12,355,1010,11300,9810,22120
"AL","2004-12-21",2004,12,356,6750,11200,9700,27650
"AL","2004-12-22",2004,12,357,258,11200,9710,21168
"AL","2004-12-23",2004,12,358,948,11200,9740,21888
"AL","2004-12-24",2004,12,359,0,11200,9760,20960
"AL","2004-12-25",2004,12,360,0,11200,9780,20980
"AL","2004-12-26",2004,12,361,316,11100,9770,21186
"AL","2004-12-27",2004,12,362,0,11100,9780,20880
"AL","2004-12-28",2004,12,363,0,11100,9780,20880
"AL","2004-12-29",2004,12,364,93.5,11100,9790,20983.5
"AL","2004-12-30",2004,12,365,0,11100,9780,20880
"AL","2004-12-31",2004,12,366,0,11000,9790,20790
"AL","2005-01-01",2005,1,1,15600,11000,9500,36100
"AL","2005-01-02",2005,1,2,0,11000,9530,20530
"AL","2005-01-03",2005,1,3,13700,11000,9370,34070
"AL","2005-01-04",2005,1,4,0,11000,9430,20430
"AL","2005-01-05",2005,1,5,0,11000,9520,20520
"AL","2005-01-06",2005,1,6,0,10900,9560,20460
"AL","2005-01-07",2005,1,7,7210,10900,9440,27550
"AL","2005-01-08",2005,1,8,0,10900,9480,20380
"AL","2005-01-09",2005,1,9,0,10900,9540,20440
"AL","2005-01-10",2005,1,10,0,10900,9570,20470
"AL","2005-01-11",2005,1,11,2710,10900,9530,23140
"AL","2005-01-12",2005,1,12,1910,10800,9520,22230
"AL","2005-01-13",2005,1,13,2700,10800,9500,23000
"AL","2005-01-14",2005,1,14,1080,10800,9530,21410
"AL","2005-01-15",2005,1,15,0,10800,9540,20340
"AL","2005-01-16",2005,1,16,0,10800,9560,20360
"AL","2005-01-17",2005,1,17,0,10700,9560,20260
"AL","2005-01-18",2005,1,18,0,10700,9570,20270
"AL","2005-01-19",2005,1,19,0,10700,9570,20270
"AL","2005-01-20",2005,1,20,17800,10700,9260,37760
"AL","2005-01-21",2005,1,21,5160,10700,9190,25050
"AL","2005-01-22",2005,1,22,0,10700,9320,20020
"AL","2005-01-23",2005,1,23,22100,10700,9000,41800
"AL","2005-01-24",2005,1,24,0,10600,9060,19660
"AL","2005-01-25",2005,1,25,0,10600,9230,19830
"AL","2005-01-26",2005,1,26,860,10600,9270,20730
"AL","2005-01-27",2005,1,27,0,10600,9330,19930
"AL","2005-01-28",2005,1,28,0,10600,9350,19950
"AL","2005-01-29",2005,1,29,0,10600,9380,19980
"AL","2005-01-30",2005,1,30,0,10500,9410,19910
"AL","2005-01-31",2005,1,31,0,10500,9430,19930
"AL","2005-02-01",2005,2,32,0,10500,9450,19950
"AL","2005-02-02",2005,2,33,0,10500,9450,19950
"AL","2005-02-03",2005,2,34,0,10500,9460,19960
"AL","2005-02-04",2005,2,35,0,10500,9480,19980
"AL","2005-02-05",2005,2,36,0,10400,9470,19870
"AL","2005-02-06",2005,2,37,0,10400,9480,19880
"AL","2005-02-07",2005,2,38,4800,10400,9400,24600
"AL","2005-02-08",2005,2,39,11500,10400,9190,31090
"AL","2005-02-09",2005,2,40,211,10400,9230,19841
"AL","2005-02-10",2005,2,41,0,10400,9310,19710
"AL","2005-02-11",2005,2,42,0,10300,9330,19630
"AL","2005-02-12",2005,2,43,704,10300,9340,20344
"AL","2005-02-13",2005,2,44,0,10300,9350,19650
"AL","2005-02-14",2005,2,45,0,10300,9370,19670
"AL","2005-02-15",2005,2,46,9140,10300,9190,28630
"AL","2005-02-16",2005,2,47,469,10200,9210,19879
"AL","2005-02-17",2005,2,48,0,10200,9280,19480
"AL","2005-02-18",2005,2,49,0,10200,9290,19490
"AL","2005-02-19",2005,2,50,0,10200,9300,19500
"AL","2005-02-20",2005,2,51,0,10200,9310,19510
"AL","2005-02-21",2005,2,52,2140,10200,9270,21610
"AL","2005-02-22",2005,2,53,4830,10100,9190,24120
"AL","2005-02-23",2005,2,54,0,10100,9220,19320
"AL","2005-02-24",2005,2,55,317,10100,9240,19657
"AL","2005-02-25",2005,2,56,0,10100,9260,19360
"AL","2005-02-26",2005,2,57,775,10100,9250,20125
"AL","2005-02-27",2005,2,58,0,10100,9250,19350
"AL","2005-02-28",2005,2,59,2460,10000,9210,21670
"AL","2005-03-01",2005,3,60,6010,10000,9110,25120
"AL","2005-03-02",2005,3,61,819,10000,9140,19959
"AL","2005-03-03",2005,3,62,0,9990,9170,19160
"AL","2005-03-04",2005,3,63,0,9970,9190,19160
"AL","2005-03-05",2005,3,64,1380,9950,9180,20510
"AL","2005-03-06",2005,3,65,4980,9940,9120,24040
"AL","2005-03-07",2005,3,66,0,9920,9150,19070
"AL","2005-03-08",2005,3,67,2760,9910,9190,21860
"AL","2005-03-09",2005,3,68,237,9890,9190,19317
"AL","2005-03-10",2005,3,69,0,9880,9190,19070
"AL","2005-03-11",2005,3,70,3880,9860,9110,22850
"AL","2005-03-12",2005,3,71,4240,9850,9050,23140
"AL","2005-03-13",2005,3,72,1700,9830,9060,20590
"AL","2005-03-14",2005,3,73,0,9820,9090,18910
"AL","2005-03-15",2005,3,74,0,9800,9120,18920
"AL","2005-03-16",2005,3,75,1340,9790,9120,20250
"AL","2005-03-17",2005,3,76,0,9770,9120,18890
"AL","2005-03-18",2005,3,77,5560,9760,9020,24340
"AL","2005-03-19",2005,3,78,0,9750,9050,18800
"AL","2005-03-20",2005,3,79,5090,9730,8990,23810
"AL","2005-03-21",2005,3,80,3680,9720,8960,22360
"AL","2005-03-22",2005,3,81,0,9700,9030,18730
"AL","2005-03-23",2005,3,82,0,9690,9080,18770
"AL","2005-03-24",2005,3,83,0,9680,9120,18800
"AL","2005-03-25",2005,3,84,0,9660,9150,18810
"AL","2005-03-26",2005,3,85,0,9650,9170,18820
"AL","2005-03-27",2005,3,86,0,9630,9180,18810
"AL","2005-03-28",2005,3,87,0,9620,9180,18800
"AL","2005-03-29",2005,3,88,0,9600,9190,18790
"AL","2005-03-30",2005,3,89,0,9590,9220,18810
"AL","2005-03-31",2005,3,90,0,12900,16500,29400
"AL","2005-04-01",2005,4,91,21000,160000,188000,369000
"AL","2005-04-02",2005,4,92,930,15600,14100,30630
"AL","2005-04-03",2005,4,93,0,13200,10900,24100
"AL","2005-04-04",2005,4,94,0,13800,13300,27100
"AL","2005-04-05",2005,4,95,0,15100,16200,31300
"AL","2005-04-06",2005,4,96,0,16000,18400,34400
"AL","2005-04-07",2005,4,97,6550,22100,21900,50550
"AL","2005-04-08",2005,4,98,12100,16500,14400,43000
"AL","2005-04-09",2005,4,99,0,13100,10200,23300
"AL","2005-04-10",2005,4,100,0,12700,10300,23000
"AL","2005-04-11",2005,4,101,0,12500,10300,22800
"AL","2005-04-12",2005,4,102,0,12200,10200,22400
"AL","2005-04-13",2005,4,103,0,12100,10100,22200
"AL","2005-04-14",2005,4,104,0,11900,10000,21900
"AL","2005-04-15",2005,4,105,0,11800,9980,21780
"AL","2005-04-16",2005,4,106,0,11700,9980,21680
"AL","2005-04-17",2005,4,107,0,11500,9980,21480
"AL","2005-04-18",2005,4,108,10300,13000,10300,33600
"AL","2005-04-19",2005,4,109,0,11400,9830,21230
"AL","2005-04-20",2005,4,110,0,11300,9830,21130
"AL","2005-04-21",2005,4,111,14100,13100,10200,37400
"AL","2005-04-22",2005,4,112,0,11300,9650,20950
"AL","2005-04-23",2005,4,113,0,11200,9680,20880
"AL","2005-04-24",2005,4,114,0,11200,9630,20830
"AL","2005-04-25",2005,4,115,0,11100,9590,20690
"AL","2005-04-26",2005,4,116,0,11100,9600,20700
"AL","2005-04-27",2005,4,117,1900,11200,9630,22730
"AL","2005-04-28",2005,4,118,6680,11600,9800,28080
"AL","2005-04-29",2005,4,119,1840,11100,9610,22550
"AL","2005-04-30",2005,4,120,0,10800,9620,20420
"AL","2005-05-01",2005,5,121,0,10800,9610,20410
"AL","2005-05-02",2005,5,122,0,10700,9640,20340
"AL","2005-05-03",2005,5,123,1460,10800,9660,21920
"AL","2005-05-04",2005,5,124,0,10600,9630,20230
"AL","2005-05-05",2005,5,125,0,10600,9670,20270
"AL","2005-05-06",2005,5,126,0,10600,9740,20340
"AL","2005-05-07",2005,5,127,11200,12200,10200,33600
"AL","2005-05-08",2005,5,128,0,10600,9620,20220
"AL","2005-05-09",2005,5,129,3350,10100,9600,23050
"AL","2005-05-10",2005,5,130,4370,10300,9570,24240
"AL","2005-05-11",2005,5,131,18600,12000,9890,40490
"AL","2005-05-12",2005,5,132,5290,10800,9420,25510
"AL","2005-05-13",2005,5,133,0,10100,9430,19530
"AL","2005-05-14",2005,5,134,26200,12300,15800,54300
"AL","2005-05-15",2005,5,135,12700,15200,13800,41700
"AL","2005-05-16",2005,5,136,14300,14400,14400,43100
"AL","2005-05-17",2005,5,137,5590,12000,10200,27790
"AL","2005-05-18",2005,5,138,554,11200,9350,21104
"AL","2005-05-19",2005,5,139,1780,11000,9450,22230
"AL","2005-05-20",2005,5,140,7480,11500,9530,28510
"AL","2005-05-21",2005,5,141,9400,11700,9890,30990
"AL","2005-05-22",2005,5,142,1780,10900,9460,22140
"AL","2005-05-23",2005,5,143,6880,11400,9550,27830
"AL","2005-05-24",2005,5,144,6210,11200,9540,26950
"AL","2005-05-25",2005,5,145,0,10400,9460,19860
"AL","2005-05-26",2005,5,146,0,10200,9550,19750
"AL","2005-05-27",2005,5,147,3920,9890,9460,23270
"AL","2005-05-28",2005,5,148,1430,9730,9410,20570
"AL","2005-05-29",2005,5,149,2590,9750,9390,21730
"AL","2005-05-30",2005,5,150,2490,9830,9360,21680
"AL","2005-05-31",2005,5,151,7580,10200,9360,27140
"AL","2005-06-01",2005,6,152,0,9540,9340,18880
"AL","2005-06-02",2005,6,153,0,9360,9440,18800
"AL","2005-06-03",2005,6,154,0,9210,9420,18630
"AL","2005-06-04",2005,6,155,0,9170,9430,18600
"AL","2005-06-05",2005,6,156,0,9130,9410,18540
"AL","2005-06-06",2005,6,157,46000,13900,9310,69210
"AL","2005-06-07",2005,6,158,44000,17400,19100,80500
"AL","2005-06-08",2005,6,159,0,10900,8760,19660
"AL","2005-06-09",2005,6,160,552,10700,9090,20342
"AL","2005-06-10",2005,6,161,0,10200,9170,19370
"AL","2005-06-11",2005,6,162,0,9910,9230,19140
"AL","2005-06-12",2005,6,163,17500,11500,9180,38180
"AL","2005-06-13",2005,6,164,20100,12900,9380,42380
"AL","2005-06-14",2005,6,165,0,10400,9070,19470
"AL","2005-06-15",2005,6,166,39600,17000,16500,73100
"AL","2005-06-16",2005,6,167,8190,12200,9760,30150
"AL","2005-06-17",2005,6,168,0,11000,9160,20160
"AL","2005-06-18",2005,6,169,0,10700,9280,19980
"AL","2005-06-19",2005,6,170,0,10400,9330,19730
"AL","2005-06-20",2005,6,171,0,10100,9300,19400
"AL","2005-06-21",2005,6,172,0,9860,9340,19200
"AL","2005-06-22",2005,6,173,0,9720,9340,19060
"AL","2005-06-23",2005,6,174,0,9610,9350,18960
"AL","2005-06-24",2005,6,175,0,9530,9360,18890
"AL","2005-06-25",2005,6,176,0,9480,9410,18890
"AL","2005-06-26",2005,6,177,0,9430,9390,18820
"AL","2005-06-27",2005,6,178,0,9400,9380,18780
"AL","2005-06-28",2005,6,179,0,9360,9370,18730
"AL","2005-06-29",2005,6,180,96500,25300,24200,146000
"AL","2005-06-30",2005,6,181,0,11300,8460,19760
"AL","2005-07-01",2005,7,182,39800,19400,21000,80200
"AL","2005-07-02",2005,7,183,3750,12700,9760,26210
"AL","2005-07-03",2005,7,184,0,11900,9420,21320
"AL","2005-07-04",2005,7,185,0,11600,9560,21160
"AL","2005-07-05",2005,7,186,4030,11400,9590,25020
"AL","2005-07-06",2005,7,187,1740,10900,9600,22240
"AL","2005-07-07",2005,7,188,0,10500,9640,20140
"AL","2005-07-08",2005,7,189,1710,10400,9670,21780
"AL","2005-07-09",2005,7,190,0,10200,9720,19920
"AL","2005-07-10",2005,7,191,0,10100,9780,19880
"AL","2005-07-11",2005,7,192,0,9960,9820,19780
"AL","2005-07-12",2005,7,193,0,9890,9910,19800
"AL","2005-07-13",2005,7,194,0,9830,9960,19790
"AL","2005-07-14",2005,7,195,0,9770,10000,19770
"AL","2005-07-15",2005,7,196,0,9720,10000,19720
"AL","2005-07-16",2005,7,197,0,9670,10100,19770
"AL","2005-07-17",2005,7,198,0,9630,10000,19630
"AL","2005-07-18",2005,7,199,0,9590,9980,19570
"AL","2005-07-19",2005,7,200,7820,10000,9910,27730
"AL","2005-07-20",2005,7,201,350,9560,9820,19730
"AL","2005-07-21",2005,7,202,0,9490,9810,19300
"AL","2005-07-22",2005,7,203,0,9450,9830,19280
"AL","2005-07-23",2005,7,204,0,9420,9920,19340
"AL","2005-07-24",2005,7,205,0,9390,9870,19260
"AL","2005-07-25",2005,7,206,40200,13900,9480,63580
"AL","2005-07-26",2005,7,207,0,10400,9230,19630
"AL","2005-07-27",2005,7,208,19100,11800,9440,40340
"AL","2005-07-28",2005,7,209,0,9950,9310,19260
"AL","2005-07-29",2005,7,210,7660,10400,9330,27390
"AL","2005-07-30",2005,7,211,20500,12400,9240,42140
"AL","2005-07-31",2005,7,212,0,10500,9170,19670
"AL","2005-08-01",2005,8,213,0,10200,9470,19670
"AL","2005-08-02",2005,8,214,0,9670,9520,19190
"AL","2005-08-03",2005,8,215,0,9570,9540,19110
"AL","2005-08-04",2005,8,216,0,9500,9570,19070
"AL","2005-08-05",2005,8,217,17600,11300,9410,38310
"AL","2005-08-06",2005,8,218,0,10100,9310,19410
"AL","2005-08-07",2005,8,219,0,9810,9490,19300
"AL","2005-08-08",2005,8,220,0,9420,9540,18960
"AL","2005-08-09",2005,8,221,0,9370,9550,18920
"AL","2005-08-10",2005,8,222,1580,9350,9540,20470
"AL","2005-08-11",2005,8,223,21600,11500,9320,42420
"AL","2005-08-12",2005,8,224,0,10100,9150,19250
"AL","2005-08-13",2005,8,225,4830,10200,9240,24270
"AL","2005-08-14",2005,8,226,0,9700,9240,18940
"AL","2005-08-15",2005,8,227,0,9590,9280,18870
"AL","2005-08-16",2005,8,228,0,9430,9350,18780
"AL","2005-08-17",2005,8,229,0,9240,9440,18680
"AL","2005-08-18",2005,8,230,0,9210,9420,18630
"AL","2005-08-19",2005,8,231,175,9190,9380,18745
"AL","2005-08-20",2005,8,232,42400,13700,9090,65190
"AL","2005-08-21",2005,8,233,7770,11400,8790,27960
"AL","2005-08-22",2005,8,234,0,10400,8990,19390
"AL","2005-08-23",2005,8,235,0,10200,9140,19340
"AL","2005-08-24",2005,8,236,0,9970,9170,19140
"AL","2005-08-25",2005,8,237,0,9790,9200,18990
"AL","2005-08-26",2005,8,238,0,9620,9230,18850
"AL","2005-08-27",2005,8,239,2630,9510,9210,21350
"AL","2005-08-28",2005,8,240,4480,9770,9190,23440
"AL","2005-08-29",2005,8,241,0,9410,9180,18590
"AL","2005-08-30",2005,8,242,0,9360,9210,18570
"AL","2005-08-31",2005,8,243,0,9280,9210,18490
"AL","2005-09-01",2005,9,244,0,9210,9200,18410
"AL","2005-09-02",2005,9,245,330,9180,9210,18720
"AL","2005-09-03",2005,9,246,0,9150,9220,18370
"AL","2005-09-04",2005,9,247,0,9130,9200,18330
"AL","2005-09-05",2005,9,248,0,9100,9190,18290
"AL","2005-09-06",2005,9,249,0,9080,9190,18270
"AL","2005-09-07",2005,9,250,0,9050,9200,18250
"AL","2005-09-08",2005,9,251,0,9030,9190,18220
"AL","2005-09-09",2005,9,252,0,9010,9130,18140
"AL","2005-09-10",2005,9,253,0,9140,9090,18230
"AL","2005-09-11",2005,9,254,453,9070,9070,18593
"AL","2005-09-12",2005,9,255,0,8970,9070,18040
"AL","2005-09-13",2005,9,256,0,8920,9080,18000
"AL","2005-09-14",2005,9,257,38400,12900,8770,60070
"AL","2005-09-15",2005,9,258,6460,10500,8470,25430
"AL","2005-09-16",2005,9,259,0,9940,8630,18570
"AL","2005-09-17",2005,9,260,0,9890,8750,18640
"AL","2005-09-18",2005,9,261,0,9690,8810,18500
"AL","2005-09-19",2005,9,262,0,9500,8860,18360
"AL","2005-09-20",2005,9,263,7200,9770,8820,25790
"AL","2005-09-21",2005,9,264,22400,11900,8810,43110
"AL","2005-09-22",2005,9,265,0,10100,8680,18780
"AL","2005-09-23",2005,9,266,10600,11000,8900,30500
"AL","2005-09-24",2005,9,267,0,10000,8790,18790
"AL","2005-09-25",2005,9,268,0,9940,8890,18830
"AL","2005-09-26",2005,9,269,3920,9940,8890,22750
"AL","2005-09-27",2005,9,270,23700,12600,9350,45650
"AL","2005-09-28",2005,9,271,0,10400,8700,19100
"AL","2005-09-29",2005,9,272,0,10300,8880,19180
"AL","2005-09-30",2005,9,273,19100,12700,9840,41640
"AL","2005-10-01",2005,10,274,0,10700,8810,19510
"AL","2005-10-02",2005,10,275,0,10500,8900,19400
"AL","2005-10-03",2005,10,276,0,10200,8910,19110
"AL","2005-10-04",2005,10,277,0,9820,8890,18710
"AL","2005-10-05",2005,10,278,22300,11600,9230,43130
"AL","2005-10-06",2005,10,279,205000,83100,103000,391100
"AL","2005-10-07",2005,10,280,21200,28700,49400,99300
"AL","2005-10-08",2005,10,281,2610,20000,28600,51210
"AL","2005-10-09",2005,10,282,0,16300,16400,32700
"AL","2005-10-10",2005,10,283,0,14300,11100,25400
"AL","2005-10-11",2005,10,284,0,14300,11000,25300
"AL","2005-10-12",2005,10,285,0,14300,11200,25500
"AL","2005-10-13",2005,10,286,1270,14400,11400,27070
"AL","2005-10-14",2005,10,287,7640,15500,11500,34640
"AL","2005-10-15",2005,10,288,3600,15100,11600,30300
"AL","2005-10-16",2005,10,289,0,14500,11300,25800
"AL","2005-10-17",2005,10,290,0,14400,11200,25600
"AL","2005-10-18",2005,10,291,13900,16300,12100,42300
"AL","2005-10-19",2005,10,292,8630,17300,14800,40730
"AL","2005-10-20",2005,10,293,0,14500,11500,26000
"AL","2005-10-21",2005,10,294,0,14000,11000,25000
"AL","2005-10-22",2005,10,295,0,13900,10900,24800
"AL","2005-10-23",2005,10,296,7760,15000,11000,33760
"AL","2005-10-24",2005,10,297,9700,16700,14400,40800
"AL","2005-10-25",2005,10,298,2010,14600,12100,28710
"AL","2005-10-26",2005,10,299,1690,14000,10800,26490
"AL","2005-10-27",2005,10,300,176,13600,10700,24476
"AL","2005-10-28",2005,10,301,0,13500,10700,24200
"AL","2005-10-29",2005,10,302,0,13500,10600,24100
"AL","2005-10-30",2005,10,303,0,13400,10500,23900
"AL","2005-10-31",2005,10,304,0,13300,10500,23800
"AL","2005-11-01",2005,11,305,6620,14200,10400,31220
"AL","2005-11-02",2005,11,306,0,13300,10400,23700
"AL","2005-11-03",2005,11,307,0,13000,10400,23400
"AL","2005-11-04",2005,11,308,0,13000,10300,23300
"AL","2005-11-05",2005,11,309,279,12900,10300,23479
"AL","2005-11-06",2005,11,310,0,12900,10300,23200
"AL","2005-11-07",2005,11,311,6710,13900,10400,31010
"AL","2005-11-08",2005,11,312,295,13000,10300,23595
"AL","2005-11-09",2005,11,313,0,12700,10300,23000
"AL","2005-11-10",2005,11,314,0,12700,10300,23000
"AL","2005-11-11",2005,11,315,500,12700,10300,23500
"AL","2005-11-12",2005,11,316,0,12700,10300,23000
"AL","2005-11-13",2005,11,317,0,12600,10300,22900
"AL","2005-11-14",2005,11,318,5340,13400,10500,29240
"AL","2005-11-15",2005,11,319,7550,12800,10200,30550
"AL","2005-11-16",2005,11,320,0,12700,10200,22900
"AL","2005-11-17",2005,11,321,29100,12700,9800,51600
"AL","2005-11-18",2005,11,322,2960,12700,9790,25450
"AL","2005-11-19",2005,11,323,709,12600,9980,23289
"AL","2005-11-20",2005,11,324,0,12600,10100,22700
"AL","2005-11-21",2005,11,325,0,12600,10200,22800
"AL","2005-11-22",2005,11,326,0,12500,10200,22700
"AL","2005-11-23",2005,11,327,1500,12500,10200,24200
"AL","2005-11-24",2005,11,328,10400,12500,10100,33000
"AL","2005-11-25",2005,11,329,5570,12500,10000,28070
"AL","2005-11-26",2005,11,330,7190,12500,9990,29680
"AL","2005-11-27",2005,11,331,0,12500,10100,22600
"AL","2005-11-28",2005,11,332,4250,12400,10100,26750
"AL","2005-11-29",2005,11,333,21500,12400,9770,43670
"AL","2005-11-30",2005,11,334,17500,14900,12600,45000
"AL","2005-12-01",2005,12,335,9380,12800,10100,32280
"AL","2005-12-02",2005,12,336,1650,12700,10000,24350
"AL","2005-12-03",2005,12,337,468,12700,10100,23268
"AL","2005-12-04",2005,12,338,0,12600,10200,22800
"AL","2005-12-05",2005,12,339,0,12600,10200,22800
"AL","2005-12-06",2005,12,340,0,12600,10300,22900
"AL","2005-12-07",2005,12,341,0,12500,10300,22800
"AL","2005-12-08",2005,12,342,0,12500,10300,22800
"AL","2005-12-09",2005,12,343,0,12500,10300,22800
"AL","2005-12-10",2005,12,344,0,12400,10300,22700
"AL","2005-12-11",2005,12,345,0,12400,10300,22700
"AL","2005-12-12",2005,12,346,1110,12400,10300,23810
"AL","2005-12-13",2005,12,347,0,12300,10300,22600
"AL","2005-12-14",2005,12,348,0,12300,10300,22600
"AL","2005-12-15",2005,12,349,0,12300,10400,22700
"AL","2005-12-16",2005,12,350,14500,12300,10100,36900
"AL","2005-12-17",2005,12,351,5270,12200,10000,27470
"AL","2005-12-18",2005,12,352,854,12200,10100,23154
"AL","2005-12-19",2005,12,353,0,12200,10200,22400
"AL","2005-12-20",2005,12,354,0,12200,10200,22400
"AL","2005-12-21",2005,12,355,0,12100,10200,22300
"AL","2005-12-22",2005,12,356,0,12100,10200,22300
"AL","2005-12-23",2005,12,357,0,12100,10200,22300
"AL","2005-12-24",2005,12,358,374,12100,10300,22774
"AL","2005-12-25",2005,12,359,1970,12000,10200,24170
"AL","2005-12-26",2005,12,360,386,12000,10200,22586
"AL","2005-12-27",2005,12,361,0,12000,10200,22200
"AL","2005-12-28",2005,12,362,0,12000,10300,22300
"AL","2005-12-29",2005,12,363,0,11900,10200,22100
"AL","2005-12-30",2005,12,364,0,11900,10200,22100
"AL","2005-12-31",2005,12,365,2690,11900,10200,24790
"AL","2006-01-01",2006,1,1,12600,11800,9950,34350
"AL","2006-01-02",2006,1,2,0,11800,10000,21800
"AL","2006-01-03",2006,1,3,0,11800,10100,21900
"AL","2006-01-04",2006,1,4,0,11800,10100,21900
"AL","2006-01-05",2006,1,5,3660,11700,10100,25460
"AL","2006-01-06",2006,1,6,1250,11700,10100,23050
"AL","2006-01-07",2006,1,7,0,11700,10100,21800
"AL","2006-01-08",2006,1,8,0,11600,10100,21700
"AL","2006-01-09",2006,1,9,1510,11600,10100,23210
"AL","2006-01-10",2006,1,10,0,11600,10100,21700
"AL","2006-01-11",2006,1,11,1090,11600,10100,22790
"AL","2006-01-12",2006,1,12,0,11500,10100,21600
"AL","2006-01-13",2006,1,13,0,11500,10100,21600
"AL","2006-01-14",2006,1,14,0,11500,10100,21600
"AL","2006-01-15",2006,1,15,0,11400,10100,21500
"AL","2006-01-16",2006,1,16,0,11400,10100,21500
"AL","2006-01-17",2006,1,17,0,11400,10100,21500
"AL","2006-01-18",2006,1,18,20900,11300,9700,41900
"AL","2006-01-19",2006,1,19,645,11300,9720,21665
"AL","2006-01-20",2006,1,20,0,11300,9820,21120
"AL","2006-01-21",2006,1,21,7210,11300,9720,28230
"AL","2006-01-22",2006,1,22,0,11200,9760,20960
"AL","2006-01-23",2006,1,23,0,11200,9820,21020
"AL","2006-01-24",2006,1,24,0,11200,9850,21050
"AL","2006-01-25",2006,1,25,2910,11200,9810,23920
"AL","2006-01-26",2006,1,26,2970,11100,9780,23850
"AL","2006-01-27",2006,1,27,0,11100,9810,20910
"AL","2006-01-28",2006,1,28,0,11100,9850,20950
"AL","2006-01-29",2006,1,29,0,11100,9870,20970
"AL","2006-01-30",2006,1,30,20400,11000,9500,40900
"AL","2006-01-31",2006,1,31,17600,11000,9240,37840
"AL","2006-02-01",2006,2,32,0,11000,9380,20380
"AL","2006-02-02",2006,2,33,13300,11000,9290,33590
"AL","2006-02-03",2006,2,34,0,10900,9380,20280
"AL","2006-02-04",2006,2,35,0,10900,9500,20400
"AL","2006-02-05",2006,2,36,1060,10900,9540,21500
"AL","2006-02-06",2006,2,37,281,10900,9580,20761
"AL","2006-02-07",2006,2,38,0,10900,9610,20510
"AL","2006-02-08",2006,2,39,0,10800,9630,20430
"AL","2006-02-09",2006,2,40,0,10800,9650,20450
"AL","2006-02-10",2006,2,41,0,10800,9660,20460
"AL","2006-02-11",2006,2,42,446,10800,9670,20916
"AL","2006-02-12",2006,2,43,0,10700,9670,20370
"AL","2006-02-13",2006,2,44,188,10700,9680,20568
"AL","2006-02-14",2006,2,45,0,10700,9680,20380
"AL","2006-02-15",2006,2,46,0,10600,9680,20280
"AL","2006-02-16",2006,2,47,0,10600,9680,20280
"AL","2006-02-17",2006,2,48,0,10600,9680,20280
"AL","2006-02-18",2006,2,49,4500,10600,9590,24690
"AL","2006-02-19",2006,2,50,0,10500,9590,20090
"AL","2006-02-20",2006,2,51,0,10500,9610,20110
"AL","2006-02-21",2006,2,52,0,10500,9610,20110
"AL","2006-02-22",2006,2,53,0,10500,9620,20120
"AL","2006-02-23",2006,2,54,0,10400,9610,20010
"AL","2006-02-24",2006,2,55,0,10400,9610,20010
"AL","2006-02-25",2006,2,56,0,10400,9600,20000
"AL","2006-02-26",2006,2,57,7630,10400,9450,27480
"AL","2006-02-27",2006,2,58,0,10400,9460,19860
"AL","2006-02-28",2006,2,59,0,10300,9500,19800
"AL","2006-03-01",2006,3,60,0,10300,9500,19800
"AL","2006-03-02",2006,3,61,0,10300,9520,19820
"AL","2006-03-03",2006,3,62,25300,10300,9080,44680
"AL","2006-03-04",2006,3,63,0,10300,9120,19420
"AL","2006-03-05",2006,3,64,0,10200,9270,19470
"AL","2006-03-06",2006,3,65,0,10200,9320,19520
"AL","2006-03-07",2006,3,66,22700,10200,8950,41850
"AL","2006-03-08",2006,3,67,0,10200,9010,19210
"AL","2006-03-09",2006,3,68,5510,10200,9060,24770
"AL","2006-03-10",2006,3,69,1920,10200,9120,21240
"AL","2006-03-11",2006,3,70,0,10100,9220,19320
"AL","2006-03-12",2006,3,71,0,10100,9300,19400
"AL","2006-03-13",2006,3,72,0,10100,9360,19460
"AL","2006-03-14",2006,3,73,12300,10100,9120,31520
"AL","2006-03-15",2006,3,74,30900,10100,8630,49630
"AL","2006-03-16",2006,3,75,474,10000,8740,19214
"AL","2006-03-17",2006,3,76,0,10000,8970,18970
"AL","2006-03-18",2006,3,77,0,10000,9060,19060
"AL","2006-03-19",2006,3,78,0,10000,9130,19130
"AL","2006-03-20",2006,3,79,0,9980,9160,19140
"AL","2006-03-21",2006,3,80,0,9960,9220,19180
"AL","2006-03-22",2006,3,81,0,9940,9250,19190
"AL","2006-03-23",2006,3,82,0,9920,9280,19200
"AL","2006-03-24",2006,3,83,0,9900,9300,19200
"AL","2006-03-25",2006,3,84,1510,9880,9300,20690
"AL","2006-03-26",2006,3,85,0,9860,9310,19170
"AL","2006-03-27",2006,3,86,0,9840,9340,19180
"AL","2006-03-28",2006,3,87,0,9820,9380,19200
"AL","2006-03-29",2006,3,88,0,9800,9420,19220
"AL","2006-03-30",2006,3,89,0,9780,9460,19240
"AL","2006-03-31",2006,3,90,1130,9770,10200,21100
"AL","2006-04-01",2006,4,91,10100,52000,1e+05,162100
"AL","2006-04-02",2006,4,92,5140,16300,19900,41340
"AL","2006-04-03",2006,4,93,0,16000,19400,35400
"AL","2006-04-04",2006,4,94,10300,13500,13900,37700
"AL","2006-04-05",2006,4,95,0,13400,12900,26300
"AL","2006-04-06",2006,4,96,0,13300,12800,26100
"AL","2006-04-07",2006,4,97,0,14900,16300,31200
"AL","2006-04-08",2006,4,98,0,19800,27100,46900
"AL","2006-04-09",2006,4,99,0,13700,13800,27500
"AL","2006-04-10",2006,4,100,0,14400,14800,29200
"AL","2006-04-11",2006,4,101,0,15900,18000,33900
"AL","2006-04-12",2006,4,102,0,20600,27400,48000
"AL","2006-04-13",2006,4,103,0,22500,19900,42400
"AL","2006-04-14",2006,4,104,348,14100,11700,26148
"AL","2006-04-15",2006,4,105,3020,14100,11600,28720
"AL","2006-04-16",2006,4,106,0,13500,11400,24900
"AL","2006-04-17",2006,4,107,0,13300,11300,24600
"AL","2006-04-18",2006,4,108,0,13100,11200,24300
"AL","2006-04-19",2006,4,109,0,12900,11200,24100
"AL","2006-04-20",2006,4,110,2610,13000,11200,26810
"AL","2006-04-21",2006,4,111,2500,13000,11100,26600
"AL","2006-04-22",2006,4,112,0,12400,11000,23400
"AL","2006-04-23",2006,4,113,1830,12400,11000,25230
"AL","2006-04-24",2006,4,114,1250,12400,11000,24650
"AL","2006-04-25",2006,4,115,348,12200,10900,23448
"AL","2006-04-26",2006,4,116,506,12100,10900,23506
"AL","2006-04-27",2006,4,117,0,12000,10900,22900
"AL","2006-04-28",2006,4,118,0,11900,10900,22800
"AL","2006-04-29",2006,4,119,0,11900,10900,22800
"AL","2006-04-30",2006,4,120,1390,11900,10900,24190
"AL","2006-05-01",2006,5,121,3510,12200,11000,26710
"AL","2006-05-02",2006,5,122,12700,13700,11200,37600
"AL","2006-05-03",2006,5,123,10600,14300,12400,37300
"AL","2006-05-04",2006,5,124,0,12000,10500,22500
"AL","2006-05-05",2006,5,125,508,11900,10600,23008
"AL","2006-05-06",2006,5,126,554,11900,10500,22954
"AL","2006-05-07",2006,5,127,0,11800,10400,22200
"AL","2006-05-08",2006,5,128,0,11700,10500,22200
"AL","2006-05-09",2006,5,129,9740,12100,10600,32440
"AL","2006-05-10",2006,5,130,17100,13700,12500,43300
"AL","2006-05-11",2006,5,131,9420,12800,12000,34220
"AL","2006-05-12",2006,5,132,22600,16700,18200,57500
"AL","2006-05-13",2006,5,133,36900,23200,26000,86100
"AL","2006-05-14",2006,5,134,8560,15300,14600,38460
"AL","2006-05-15",2006,5,135,3990,13700,11300,28990
"AL","2006-05-16",2006,5,136,3260,13300,11000,27560
"AL","2006-05-17",2006,5,137,2280,12900,11000,26180
"AL","2006-05-18",2006,5,138,3350,12500,11000,26850
"AL","2006-05-19",2006,5,139,1360,12100,10900,24360
"AL","2006-05-20",2006,5,140,0,11700,10900,22600
"AL","2006-05-21",2006,5,141,763,11600,10800,23163
"AL","2006-05-22",2006,5,142,369,11300,10800,22469
"AL","2006-05-23",2006,5,143,0,11000,10700,21700
"AL","2006-05-24",2006,5,144,0,10900,10700,21600
"AL","2006-05-25",2006,5,145,12700,11700,10600,35000
"AL","2006-05-26",2006,5,146,39700,18500,12400,70600
"AL","2006-05-27",2006,5,147,3180,12400,10400,25980
"AL","2006-05-28",2006,5,148,9150,12900,10700,32750
"AL","2006-05-29",2006,5,149,21900,17700,15800,55400
"AL","2006-05-30",2006,5,150,4070,12800,10700,27570
"AL","2006-05-31",2006,5,151,0,11900,10600,22500
"AL","2006-06-01",2006,6,152,4780,12100,10600,27480
"AL","2006-06-02",2006,6,153,0,11300,10500,21800
"AL","2006-06-03",2006,6,154,0,11100,10500,21600
"AL","2006-06-04",2006,6,155,0,10900,10500,21400
"AL","2006-06-05",2006,6,156,0,10800,10500,21300
"AL","2006-06-06",2006,6,157,0,10700,10500,21200
"AL","2006-06-07",2006,6,158,552,10600,10400,21552
"AL","2006-06-08",2006,6,159,40500,15400,10100,66000
"AL","2006-06-09",2006,6,160,0,11700,9860,21560
"AL","2006-06-10",2006,6,161,0,11400,10100,21500
"AL","2006-06-11",2006,6,162,0,11000,10200,21200
"AL","2006-06-12",2006,6,163,0,10800,10200,21000
"AL","2006-06-13",2006,6,164,0,10700,10200,20900
"AL","2006-06-14",2006,6,165,0,10500,10200,20700
"AL","2006-06-15",2006,6,166,368,10400,10200,20968
"AL","2006-06-16",2006,6,167,0,10400,10200,20600
"AL","2006-06-17",2006,6,168,0,10300,10200,20500
"AL","2006-06-18",2006,6,169,0,10300,10200,20500
"AL","2006-06-19",2006,6,170,20900,12200,10000,43100
"AL","2006-06-20",2006,6,171,0,10800,9910,20710
"AL","2006-06-21",2006,6,172,1240,10600,10000,21840
"AL","2006-06-22",2006,6,173,1980,10500,10000,22480
"AL","2006-06-23",2006,6,174,0,10200,10000,20200
"AL","2006-06-24",2006,6,175,0,10200,10000,20200
"AL","2006-06-25",2006,6,176,27500,13600,9890,50990
"AL","2006-06-26",2006,6,177,24500,13900,9890,48290
"AL","2006-06-27",2006,6,178,0,11400,9680,21080
"AL","2006-06-28",2006,6,179,0,11200,9910,21110
"AL","2006-06-29",2006,6,180,25500,14900,10200,50600
"AL","2006-06-30",2006,6,181,4760,12300,9790,26850
"AL","2006-07-01",2006,7,182,0,11500,9920,21420
"AL","2006-07-02",2006,7,183,1250,11200,10100,22550
"AL","2006-07-03",2006,7,184,20400,13300,10200,43900
"AL","2006-07-04",2006,7,185,2570,11700,10200,24470
"AL","2006-07-05",2006,7,186,8390,11700,10200,30290
"AL","2006-07-06",2006,7,187,0,10800,10100,20900
"AL","2006-07-07",2006,7,188,0,10700,10200,20900
"AL","2006-07-08",2006,7,189,0,10500,10300,20800
"AL","2006-07-09",2006,7,190,0,10400,10300,20700
"AL","2006-07-10",2006,7,191,19500,12200,10100,41800
"AL","2006-07-11",2006,7,192,0,10800,10100,20900
"AL","2006-07-12",2006,7,193,0,10200,10200,20400
"AL","2006-07-13",2006,7,194,0,10200,10300,20500
"AL","2006-07-14",2006,7,195,0,10100,10400,20500
"AL","2006-07-15",2006,7,196,5270,10400,10200,25870
"AL","2006-07-16",2006,7,197,3940,10500,10300,24740
"AL","2006-07-17",2006,7,198,0,10000,10300,20300
"AL","2006-07-18",2006,7,199,0,9970,10300,20270
"AL","2006-07-19",2006,7,200,0,9930,10300,20230
"AL","2006-07-20",2006,7,201,0,9900,10300,20200
"AL","2006-07-21",2006,7,202,0,9870,10200,20070
"AL","2006-07-22",2006,7,203,0,9840,10200,20040
"AL","2006-07-23",2006,7,204,131,9810,10100,20041
"AL","2006-07-24",2006,7,205,0,9780,10100,19880
"AL","2006-07-25",2006,7,206,13400,11100,9910,34410
"AL","2006-07-26",2006,7,207,0,10100,9880,19980
"AL","2006-07-27",2006,7,208,17000,11300,9800,38100
"AL","2006-07-28",2006,7,209,0,10100,9690,19790
"AL","2006-07-29",2006,7,210,0,9850,9800,19650
"AL","2006-07-30",2006,7,211,34200,13700,9680,57580
"AL","2006-07-31",2006,7,212,50900,18400,11000,80300
"AL","2006-08-01",2006,8,213,21000,14900,14400,50300
"AL","2006-08-02",2006,8,214,30300,18000,19100,67400
"AL","2006-08-03",2006,8,215,48000,23600,26500,98100
"AL","2006-08-04",2006,8,216,6300,14900,11900,33100
"AL","2006-08-05",2006,8,217,2920,13600,9850,26370
"AL","2006-08-06",2006,8,218,526,12900,9910,23336
"AL","2006-08-07",2006,8,219,0,12400,9930,22330
"AL","2006-08-08",2006,8,220,0,12100,9980,22080
"AL","2006-08-09",2006,8,221,0,11800,9970,21770
"AL","2006-08-10",2006,8,222,0,11500,9990,21490
"AL","2006-08-11",2006,8,223,0,11300,10000,21300
"AL","2006-08-12",2006,8,224,0,11100,10000,21100
"AL","2006-08-13",2006,8,225,0,11000,10000,21000
"AL","2006-08-14",2006,8,226,7970,11400,9970,29340
"AL","2006-08-15",2006,8,227,3600,11300,9940,24840
"AL","2006-08-16",2006,8,228,0,10900,9970,20870
"AL","2006-08-17",2006,8,229,0,10800,10000,20800
"AL","2006-08-18",2006,8,230,0,10600,10100,20700
"AL","2006-08-19",2006,8,231,18600,12100,9960,40660
"AL","2006-08-20",2006,8,232,50600,18700,12700,82000
"AL","2006-08-21",2006,8,233,0,12100,9620,21720
"AL","2006-08-22",2006,8,234,1210,12000,9910,23120
"AL","2006-08-23",2006,8,235,8410,12600,10100,31110
"AL","2006-08-24",2006,8,236,1290,11600,9980,22870
"AL","2006-08-25",2006,8,237,10700,12600,10000,33300
"AL","2006-08-26",2006,8,238,34900,18100,18500,71500
"AL","2006-08-27",2006,8,239,3470,12800,10100,26370
"AL","2006-08-28",2006,8,240,0,12100,9960,22060
"AL","2006-08-29",2006,8,241,0,11900,10000,21900
"AL","2006-08-30",2006,8,242,0,11500,10000,21500
"AL","2006-08-31",2006,8,243,0,11300,10000,21300
"AL","2006-09-01",2006,9,244,0,11100,10100,21200
"AL","2006-09-02",2006,9,245,0,10800,10000,20800
"AL","2006-09-03",2006,9,246,0,10700,10000,20700
"AL","2006-09-04",2006,9,247,0,10600,10000,20600
"AL","2006-09-05",2006,9,248,0,10500,10000,20500
"AL","2006-09-06",2006,9,249,0,10400,9990,20390
"AL","2006-09-07",2006,9,250,0,10300,9980,20280
"AL","2006-09-08",2006,9,251,1540,10300,9940,21780
"AL","2006-09-09",2006,9,252,4800,10600,9880,25280
"AL","2006-09-10",2006,9,253,3590,10700,9810,24100
"AL","2006-09-11",2006,9,254,0,10500,9800,20300
"AL","2006-09-12",2006,9,255,0,10500,9830,20330
"AL","2006-09-13",2006,9,256,495,10400,9830,20725
"AL","2006-09-14",2006,9,257,0,10300,9820,20120
"AL","2006-09-15",2006,9,258,0,10300,9820,20120
"AL","2006-09-16",2006,9,259,0,10200,9830,20030
"AL","2006-09-17",2006,9,260,6810,10600,9760,27170
"AL","2006-09-18",2006,9,261,12400,11600,9700,33700
"AL","2006-09-19",2006,9,262,2750,11100,9630,23480
"AL","2006-09-20",2006,9,263,4120,11200,9670,24990
"AL","2006-09-21",2006,9,264,2620,11000,9670,23290
"AL","2006-09-22",2006,9,265,1060,10900,9690,21650
"AL","2006-09-23",2006,9,266,3960,11100,9710,24770
"AL","2006-09-24",2006,9,267,4720,11200,9720,25640
"AL","2006-09-25",2006,9,268,2970,11100,9730,23800
"AL","2006-09-26",2006,9,269,220,10700,9730,20650
"AL","2006-09-27",2006,9,270,3030,10800,9740,23570
"AL","2006-09-28",2006,9,271,6690,11300,9650,27640
"AL","2006-09-29",2006,9,272,4650,11500,9820,25970
"AL","2006-09-30",2006,9,273,2760,11200,9680,23640
"AL","2006-10-01",2006,10,274,3420,11300,9700,24420
"AL","2006-10-02",2006,10,275,0,10800,9670,20470
"AL","2006-10-03",2006,10,276,0,10700,9680,20380
"AL","2006-10-04",2006,10,277,0,10400,9660,20060
"AL","2006-10-05",2006,10,278,11000,11200,9550,31750
"AL","2006-10-06",2006,10,279,0,10800,9520,20320
"AL","2006-10-07",2006,10,280,0,10700,9590,20290
"AL","2006-10-08",2006,10,281,0,10700,9570,20270
"AL","2006-10-09",2006,10,282,0,10700,9550,20250
"AL","2006-10-10",2006,10,283,0,10700,9560,20260
"AL","2006-10-11",2006,10,284,0,10700,9540,20240
"AL","2006-10-12",2006,10,285,9880,11800,9630,31310
"AL","2006-10-13",2006,10,286,2890,11300,9520,23710
"AL","2006-10-14",2006,10,287,11400,10800,9220,31420
"AL","2006-10-15",2006,10,288,7910,10800,9130,27840
"AL","2006-10-16",2006,10,289,0,10800,9250,20050
"AL","2006-10-17",2006,10,290,0,10900,9450,20350
"AL","2006-10-18",2006,10,291,23700,17000,11100,51800
"AL","2006-10-19",2006,10,292,2130,12200,9440,23770
"AL","2006-10-20",2006,10,293,1700,11800,9390,22890
"AL","2006-10-21",2006,10,294,0,11500,9390,20890
"AL","2006-10-22",2006,10,295,3240,11800,9420,24460
"AL","2006-10-23",2006,10,296,0,11400,9380,20780
"AL","2006-10-24",2006,10,297,0,11300,9390,20690
"AL","2006-10-25",2006,10,298,1210,11300,9380,21890
"AL","2006-10-26",2006,10,299,0,11200,9360,20560
"AL","2006-10-27",2006,10,300,0,11200,9360,20560
"AL","2006-10-28",2006,10,301,0,11100,9350,20450
"AL","2006-10-29",2006,10,302,4390,11400,9350,25140
"AL","2006-10-30",2006,10,303,0,11000,9310,20310
"AL","2006-10-31",2006,10,304,0,10900,9330,20230
"AL","2006-11-01",2006,11,305,0,10900,9360,20260
"AL","2006-11-02",2006,11,306,0,10900,9370,20270
"AL","2006-11-03",2006,11,307,0,10800,9390,20190
"AL","2006-11-04",2006,11,308,0,10800,9390,20190
"AL","2006-11-05",2006,11,309,0,10800,9410,20210
"AL","2006-11-06",2006,11,310,0,10800,9430,20230
"AL","2006-11-07",2006,11,311,256,10700,9450,20406
"AL","2006-11-08",2006,11,312,1280,10800,9470,21550
"AL","2006-11-09",2006,11,313,3000,11000,9540,23540
"AL","2006-11-10",2006,11,314,4390,11100,9410,24900
"AL","2006-11-11",2006,11,315,4920,11000,9310,25230
"AL","2006-11-12",2006,11,316,6150,10600,9160,25910
"AL","2006-11-13",2006,11,317,5740,10600,9090,25430
"AL","2006-11-14",2006,11,318,5500,10600,9040,25140
"AL","2006-11-15",2006,11,319,6000,10600,9000,25600
"AL","2006-11-16",2006,11,320,0,10600,9090,19690
"AL","2006-11-17",2006,11,321,0,10500,9180,19680
"AL","2006-11-18",2006,11,322,0,10500,9220,19720
"AL","2006-11-19",2006,11,323,0,10500,9250,19750
"AL","2006-11-20",2006,11,324,0,10500,9270,19770
"AL","2006-11-21",2006,11,325,0,10500,9290,19790
"AL","2006-11-22",2006,11,326,0,10500,9300,19800
"AL","2006-11-23",2006,11,327,0,10900,9490,20390
"AL","2006-11-24",2006,11,328,0,11000,9640,20640
"AL","2006-11-25",2006,11,329,0,10500,9350,19850
"AL","2006-11-26",2006,11,330,0,10400,9280,19680
"AL","2006-11-27",2006,11,331,1540,10500,9220,21260
"AL","2006-11-28",2006,11,332,5810,11200,9170,26180
"AL","2006-11-29",2006,11,333,15800,14000,11600,41400
"AL","2006-11-30",2006,11,334,11600,13200,12700,37500
"AL","2006-12-01",2006,12,335,0,11300,9280,20580
"AL","2006-12-02",2006,12,336,0,11000,9060,20060
"AL","2006-12-03",2006,12,337,1480,10900,9050,21430
"AL","2006-12-04",2006,12,338,2210,10900,9050,22160
"AL","2006-12-05",2006,12,339,1470,10800,9060,21330
"AL","2006-12-06",2006,12,340,2320,10700,9050,22070
"AL","2006-12-07",2006,12,341,4210,10700,9010,23920
"AL","2006-12-08",2006,12,342,1960,10600,9010,21570
"AL","2006-12-09",2006,12,343,0,10600,9070,19670
"AL","2006-12-10",2006,12,344,0,10500,9110,19610
"AL","2006-12-11",2006,12,345,0,10500,9130,19630
"AL","2006-12-12",2006,12,346,4120,10600,9510,24230
"AL","2006-12-13",2006,12,347,3510,12000,12600,28110
"AL","2006-12-14",2006,12,348,526,11400,10700,22626
"AL","2006-12-15",2006,12,349,3770,10800,9370,23940
"AL","2006-12-16",2006,12,350,1480,10800,9550,21830
"AL","2006-12-17",2006,12,351,0,10600,9180,19780
"AL","2006-12-18",2006,12,352,0,10500,9160,19660
"AL","2006-12-19",2006,12,353,0,10500,9180,19680
"AL","2006-12-20",2006,12,354,0,10400,9180,19580
"AL","2006-12-21",2006,12,355,0,10400,9190,19590
"AL","2006-12-22",2006,12,356,644,10300,9180,20124
"AL","2006-12-23",2006,12,357,11600,10300,8960,30860
"AL","2006-12-24",2006,12,358,17700,10300,8690,36690
"AL","2006-12-25",2006,12,359,0,10200,8790,18990
"AL","2006-12-26",2006,12,360,0,10200,8910,19110
"AL","2006-12-27",2006,12,361,0,10200,8960,19160
"AL","2006-12-28",2006,12,362,0,10100,8990,19090
"AL","2006-12-29",2006,12,363,0,10100,9010,19110
"AL","2006-12-30",2006,12,364,1030,10100,9010,20140
"AL","2006-12-31",2006,12,365,2490,10100,8980,21570
"AL","2007-01-01",2007,1,1,7090,10000,8880,25970
"AL","2007-01-02",2007,1,2,20100,10000,8560,38660
"AL","2007-01-03",2007,1,3,0,9990,8660,18650
"AL","2007-01-04",2007,1,4,0,9960,8810,18770
"AL","2007-01-05",2007,1,5,0,9940,8880,18820
"AL","2007-01-06",2007,1,6,0,9920,8910,18830
"AL","2007-01-07",2007,1,7,0,9900,8940,18840
"AL","2007-01-08",2007,1,8,1080,9880,8940,19900
"AL","2007-01-09",2007,1,9,879,9860,8950,19689
"AL","2007-01-10",2007,1,10,0,9840,8960,18800
"AL","2007-01-11",2007,1,11,0,9820,8960,18780
"AL","2007-01-12",2007,1,12,0,9800,8980,18780
"AL","2007-01-13",2007,1,13,0,9780,8990,18770
"AL","2007-01-14",2007,1,14,0,9760,8980,18740
"AL","2007-01-15",2007,1,15,0,9740,8980,18720
"AL","2007-01-16",2007,1,16,3650,9720,8910,22280
"AL","2007-01-17",2007,1,17,424,9700,8910,19034
"AL","2007-01-18",2007,1,18,0,9690,8910,18600
"AL","2007-01-19",2007,1,19,1510,9670,8890,20070
"AL","2007-01-20",2007,1,20,2360,9650,8850,20860
"AL","2007-01-21",2007,1,21,0,9630,8860,18490
"AL","2007-01-22",2007,1,22,0,9620,8880,18500
"AL","2007-01-23",2007,1,23,1540,9600,8860,20000
"AL","2007-01-24",2007,1,24,0,9590,8860,18450
"AL","2007-01-25",2007,1,25,0,9570,8860,18430
"AL","2007-01-26",2007,1,26,2220,9550,8820,20590
"AL","2007-01-27",2007,1,27,0,9530,8820,18350
"AL","2007-01-28",2007,1,28,860,9520,8820,19200
"AL","2007-01-29",2007,1,29,781,9500,8800,19081
"AL","2007-01-30",2007,1,30,0,9480,8800,18280
"AL","2007-01-31",2007,1,31,1850,9470,8770,20090
"AL","2007-02-01",2007,2,32,3230,9450,8710,21390
"AL","2007-02-02",2007,2,33,0,9440,8720,18160
"AL","2007-02-03",2007,2,34,0,9420,8740,18160
"AL","2007-02-04",2007,2,35,0,9410,8740,18150
"AL","2007-02-05",2007,2,36,0,9390,8740,18130
"AL","2007-02-06",2007,2,37,0,9380,8740,18120
"AL","2007-02-07",2007,2,38,0,9360,8730,18090
"AL","2007-02-08",2007,2,39,0,9350,8720,18070
"AL","2007-02-09",2007,2,40,0,9330,8710,18040
"AL","2007-02-10",2007,2,41,0,9320,8710,18030
"AL","2007-02-11",2007,2,42,0,9310,8700,18010
"AL","2007-02-12",2007,2,43,0,9290,8690,17980
"AL","2007-02-13",2007,2,44,0,9280,8680,17960
"AL","2007-02-14",2007,2,45,0,9270,8670,17940
"AL","2007-02-15",2007,2,46,0,9250,8660,17910
"AL","2007-02-16",2007,2,47,0,9240,8660,17900
"AL","2007-02-17",2007,2,48,0,9230,8640,17870
"AL","2007-02-18",2007,2,49,1060,9210,8620,18890
"AL","2007-02-19",2007,2,50,1480,9200,8580,19260
"AL","2007-02-20",2007,2,51,0,9190,8580,17770
"AL","2007-02-21",2007,2,52,0,9170,8600,17770
"AL","2007-02-22",2007,2,53,0,9160,8600,17760
"AL","2007-02-23",2007,2,54,938,9150,8570,18658
"AL","2007-02-24",2007,2,55,0,9140,8560,17700
"AL","2007-02-25",2007,2,56,2970,9130,8510,20610
"AL","2007-02-26",2007,2,57,5040,9120,8420,22580
"AL","2007-02-27",2007,2,58,2310,9100,8400,19810
"AL","2007-02-28",2007,2,59,2110,9090,8400,19600
"AL","2007-03-01",2007,3,60,2070,9080,8400,19550
"AL","2007-03-02",2007,3,61,7330,9070,8290,24690
"AL","2007-03-03",2007,3,62,15600,9070,8060,32730
"AL","2007-03-04",2007,3,63,4370,9060,8080,21510
"AL","2007-03-05",2007,3,64,689,9050,8190,17929
"AL","2007-03-06",2007,3,65,0,9040,8250,17290
"AL","2007-03-07",2007,3,66,3800,9030,8220,21050
"AL","2007-03-08",2007,3,67,7880,9020,8120,25020
"AL","2007-03-09",2007,3,68,0,9010,8190,17200
"AL","2007-03-10",2007,3,69,0,9000,8280,17280
"AL","2007-03-11",2007,3,70,0,8990,8340,17330
"AL","2007-03-12",2007,3,71,0,8970,8410,17380
"AL","2007-03-13",2007,3,72,861,8960,8860,18681
"AL","2007-03-14",2007,3,73,0,11500,15100,26600
"AL","2007-03-15",2007,3,74,0,11500,14200,25700
"AL","2007-03-16",2007,3,75,0,9580,8940,18520
"AL","2007-03-17",2007,3,76,0,9450,8640,18090
"AL","2007-03-18",2007,3,77,0,9400,8600,18000
"AL","2007-03-19",2007,3,78,7350,9330,8450,25130
"AL","2007-03-20",2007,3,79,9240,9270,8290,26800
"AL","2007-03-21",2007,3,80,0,9220,8370,17590
"AL","2007-03-22",2007,3,81,2370,9180,8410,19960
"AL","2007-03-23",2007,3,82,2540,9150,8410,20100
"AL","2007-03-24",2007,3,83,0,9750,11300,21050
"AL","2007-03-25",2007,3,84,0,12800,17400,30200
"AL","2007-03-26",2007,3,85,11800,51700,55900,119400
"AL","2007-03-27",2007,3,86,8270,15100,14000,37370
"AL","2007-03-28",2007,3,87,640,11300,8720,20660
"AL","2007-03-29",2007,3,88,1710,11300,8710,21720
"AL","2007-03-30",2007,3,89,0,10900,8700,19600
"AL","2007-03-31",2007,3,90,5050,11200,8780,25030
"AL","2007-04-01",2007,4,91,11400,12100,8900,32400
"AL","2007-04-02",2007,4,92,19700,14500,13600,47800
"AL","2007-04-03",2007,4,93,6690,12300,10300,29290
"AL","2007-04-04",2007,4,94,1050,11100,8640,20790
"AL","2007-04-05",2007,4,95,35600,10900,8160,54660
"AL","2007-04-06",2007,4,96,5870,10800,8190,24860
"AL","2007-04-07",2007,4,97,0,10700,8440,19140
"AL","2007-04-08",2007,4,98,698,10600,8550,19848
"AL","2007-04-09",2007,4,99,0,10600,8640,19240
"AL","2007-04-10",2007,4,100,0,10500,8710,19210
"AL","2007-04-11",2007,4,101,0,10400,8760,19160
"AL","2007-04-12",2007,4,102,0,10400,8810,19210
"AL","2007-04-13",2007,4,103,6350,10500,9340,26190
"AL","2007-04-14",2007,4,104,0,10500,9650,20150
"AL","2007-04-15",2007,4,105,0,11900,12600,24500
"AL","2007-04-16",2007,4,106,0,13200,14800,28000
"AL","2007-04-17",2007,4,107,0,12400,11400,23800
"AL","2007-04-18",2007,4,108,4430,11400,9410,25240
"AL","2007-04-19",2007,4,109,0,10700,8980,19680
"AL","2007-04-20",2007,4,110,0,10600,8970,19570
"AL","2007-04-21",2007,4,111,0,10500,8940,19440
"AL","2007-04-22",2007,4,112,0,10400,8900,19300
"AL","2007-04-23",2007,4,113,0,10300,8910,19210
"AL","2007-04-24",2007,4,114,21200,13800,11500,46500
"AL","2007-04-25",2007,4,115,0,10600,8670,19270
"AL","2007-04-26",2007,4,116,0,10500,8790,19290
"AL","2007-04-27",2007,4,117,0,10400,8790,19190
"AL","2007-04-28",2007,4,118,0,10300,8790,19090
"AL","2007-04-29",2007,4,119,0,10300,8820,19120
"AL","2007-04-30",2007,4,120,0,10200,8860,19060
"AL","2007-05-01",2007,5,121,0,10200,8910,19110
"AL","2007-05-02",2007,5,122,0,10100,8940,19040
"AL","2007-05-03",2007,5,123,0,10100,8980,19080
"AL","2007-05-04",2007,5,124,0,10000,9000,19000
"AL","2007-05-05",2007,5,125,0,10000,9040,19040
"AL","2007-05-06",2007,5,126,0,9990,9070,19060
"AL","2007-05-07",2007,5,127,0,9970,9080,19050
"AL","2007-05-08",2007,5,128,0,9950,9100,19050
"AL","2007-05-09",2007,5,129,8930,10300,9330,28560
"AL","2007-05-10",2007,5,130,20000,13300,11400,44700
"AL","2007-05-11",2007,5,131,25700,17000,17300,60000
"AL","2007-05-12",2007,5,132,0,10300,8510,18810
"AL","2007-05-13",2007,5,133,0,9770,8650,18420
"AL","2007-05-14",2007,5,134,0,9570,8670,18240
"AL","2007-05-15",2007,5,135,3850,9550,8620,22020
"AL","2007-05-16",2007,5,136,32100,12700,9150,53950
"AL","2007-05-17",2007,5,137,228,9770,8330,18328
"AL","2007-05-18",2007,5,138,0,9600,8520,18120
"AL","2007-05-19",2007,5,139,0,9570,8630,18200
"AL","2007-05-20",2007,5,140,2260,9300,8620,20180
"AL","2007-05-21",2007,5,141,0,9100,8650,17750
"AL","2007-05-22",2007,5,142,13600,10300,8580,32480
"AL","2007-05-23",2007,5,143,6640,10200,8490,25330
"AL","2007-05-24",2007,5,144,254,9550,8560,18364
"AL","2007-05-25",2007,5,145,57800,20100,16700,94600
"AL","2007-05-26",2007,5,146,50300,22100,28200,100600
"AL","2007-05-27",2007,5,147,0,11700,8300,20000
"AL","2007-05-28",2007,5,148,6400,11900,8780,27080
"AL","2007-05-29",2007,5,149,0,11300,8800,20100
"AL","2007-05-30",2007,5,150,0,11100,8920,20020
"AL","2007-05-31",2007,5,151,5030,10800,8910,24740
"AL","2007-06-01",2007,6,152,6790,10900,8930,26620
"AL","2007-06-02",2007,6,153,8440,11100,8940,28480
"AL","2007-06-03",2007,6,154,1450,10500,8930,20880
"AL","2007-06-04",2007,6,155,1500,10100,8980,20580
"AL","2007-06-05",2007,6,156,2280,10000,8990,21270
"AL","2007-06-06",2007,6,157,0,9590,8990,18580
"AL","2007-06-07",2007,6,158,1520,9550,9000,20070
"AL","2007-06-08",2007,6,159,1100,9400,9000,19500
"AL","2007-06-09",2007,6,160,368,9300,9010,18678
"AL","2007-06-10",2007,6,161,0,9230,9010,18240
"AL","2007-06-11",2007,6,162,253,9200,9030,18483
"AL","2007-06-12",2007,6,163,0,9150,9050,18200
"AL","2007-06-13",2007,6,164,0,9110,9050,18160
"AL","2007-06-14",2007,6,165,0,9070,9080,18150
"AL","2007-06-15",2007,6,166,0,9030,9090,18120
"AL","2007-06-16",2007,6,167,0,9000,9080,18080
"AL","2007-06-17",2007,6,168,0,8970,9060,18030
"AL","2007-06-18",2007,6,169,760,8950,9020,18730
"AL","2007-06-19",2007,6,170,25200,11000,8750,44950
"AL","2007-06-20",2007,6,171,24100,12500,8460,45060
"AL","2007-06-21",2007,6,172,1270,10100,8410,19780
"AL","2007-06-22",2007,6,173,1450,9830,8670,19950
"AL","2007-06-23",2007,6,174,0,9210,8740,17950
"AL","2007-06-24",2007,6,175,0,9090,8790,17880
"AL","2007-06-25",2007,6,176,0,9020,8840,17860
"AL","2007-06-26",2007,6,177,0,8980,8880,17860
"AL","2007-06-27",2007,6,178,18000,10300,8710,37010
"AL","2007-06-28",2007,6,179,17100,11400,8530,37030
"AL","2007-06-29",2007,6,180,0,9580,8530,18110
"AL","2007-06-30",2007,6,181,0,9340,8690,18030
"AL","2007-07-01",2007,7,182,0,9120,8780,17900
"AL","2007-07-02",2007,7,183,0,8920,8960,17880
"AL","2007-07-03",2007,7,184,394,8880,9010,18284
"AL","2007-07-04",2007,7,185,1660,8880,8990,19530
"AL","2007-07-05",2007,7,186,10500,9810,8940,29250
"AL","2007-07-06",2007,7,187,7330,9620,8940,25890
"AL","2007-07-07",2007,7,188,0,8820,9080,17900
"AL","2007-07-08",2007,7,189,0,8790,9180,17970
"AL","2007-07-09",2007,7,190,0,8760,9170,17930
"AL","2007-07-10",2007,7,191,25900,11300,8990,46190
"AL","2007-07-11",2007,7,192,0,9080,8820,17900
"AL","2007-07-12",2007,7,193,711,8890,8990,18591
"AL","2007-07-13",2007,7,194,7530,9340,8910,25780
"AL","2007-07-14",2007,7,195,5240,9330,8800,23370
"AL","2007-07-15",2007,7,196,5270,9390,8770,23430
"AL","2007-07-16",2007,7,197,467,8960,8790,18217
"AL","2007-07-17",2007,7,198,0,8760,8850,17610
"AL","2007-07-18",2007,7,199,0,8690,8910,17600
"AL","2007-07-19",2007,7,200,3070,8910,8890,20870
"AL","2007-07-20",2007,7,201,933,8730,9010,18673
"AL","2007-07-21",2007,7,202,0,8640,9040,17680
"AL","2007-07-22",2007,7,203,0,8740,8990,17730
"AL","2007-07-23",2007,7,204,0,8590,8970,17560
"AL","2007-07-24",2007,7,205,0,8690,8960,17650
"AL","2007-07-25",2007,7,206,0,8550,8950,17500
"AL","2007-07-26",2007,7,207,0,8650,8960,17610
"AL","2007-07-27",2007,7,208,4500,8710,8900,22110
"AL","2007-07-28",2007,7,209,9830,9180,8800,27810
"AL","2007-07-29",2007,7,210,0,8520,8750,17270
"AL","2007-07-30",2007,7,211,0,8460,8810,17270
"AL","2007-07-31",2007,7,212,0,8550,8850,17400
"AL","2007-08-01",2007,8,213,0,8420,8880,17300
"AL","2007-08-02",2007,8,214,0,8510,8870,17380
"AL","2007-08-03",2007,8,215,0,8390,8850,17240
"AL","2007-08-04",2007,8,216,0,8490,8920,17410
"AL","2007-08-05",2007,8,217,0,8360,8960,17320
"AL","2007-08-06",2007,8,218,0,8440,8950,17390
"AL","2007-08-07",2007,8,219,0,8330,8870,17200
"AL","2007-08-08",2007,8,220,0,8430,8820,17250
"AL","2007-08-09",2007,8,221,0,8300,8890,17190
"AL","2007-08-10",2007,8,222,0,8370,8840,17210
"AL","2007-08-11",2007,8,223,24000,9980,8610,42590
"AL","2007-08-12",2007,8,224,0,8710,8470,17180
"AL","2007-08-13",2007,8,225,1210,8500,8580,18290
"AL","2007-08-14",2007,8,226,0,8300,8650,16950
"AL","2007-08-15",2007,8,227,0,8370,8690,17060
"AL","2007-08-16",2007,8,228,0,8240,8650,16890
"AL","2007-08-17",2007,8,229,3660,8470,8560,20690
"AL","2007-08-18",2007,8,230,0,8250,8520,16770
"AL","2007-08-19",2007,8,231,0,8220,8520,16740
"AL","2007-08-20",2007,8,232,0,8170,8500,16670
"AL","2007-08-21",2007,8,233,878,8280,8470,17628
"AL","2007-08-22",2007,8,234,1730,8220,8440,18390
"AL","2007-08-23",2007,8,235,9090,8870,8360,26320
"AL","2007-08-24",2007,8,236,2330,8530,8310,19170
"AL","2007-08-25",2007,8,237,0,8250,8380,16630
"AL","2007-08-26",2007,8,238,0,8170,8400,16570
"AL","2007-08-27",2007,8,239,0,8090,8410,16500
"AL","2007-08-28",2007,8,240,3510,8250,8440,20200
"AL","2007-08-29",2007,8,241,37600,11800,8170,57570
"AL","2007-08-30",2007,8,242,16700,10800,7860,35360
"AL","2007-08-31",2007,8,243,0,9190,7990,17180
"AL","2007-09-01",2007,9,244,0,8960,8240,17200
"AL","2007-09-02",2007,9,245,0,8630,8310,16940
"AL","2007-09-03",2007,9,246,0,8480,8370,16850
"AL","2007-09-04",2007,9,247,0,8350,8410,16760
"AL","2007-09-05",2007,9,248,0,8290,8440,16730
"AL","2007-09-06",2007,9,249,0,8360,8480,16840
"AL","2007-09-07",2007,9,250,0,8210,8510,16720
"AL","2007-09-08",2007,9,251,247,8280,8500,17027
"AL","2007-09-09",2007,9,252,880,8150,8450,17480
"AL","2007-09-10",2007,9,253,0,8230,8420,16650
"AL","2007-09-11",2007,9,254,0,8180,8390,16570
"AL","2007-09-12",2007,9,255,3010,8230,8330,19570
"AL","2007-09-13",2007,9,256,0,8110,8290,16400
"AL","2007-09-14",2007,9,257,481,8150,8290,16921
"AL","2007-09-15",2007,9,258,7610,8610,8220,24440
"AL","2007-09-16",2007,9,259,3190,8540,8140,19870
"AL","2007-09-17",2007,9,260,0,8360,8150,16510
"AL","2007-09-18",2007,9,261,0,8360,8200,16560
"AL","2007-09-19",2007,9,262,769,8290,8230,17289
"AL","2007-09-20",2007,9,263,31700,11100,8100,50900
"AL","2007-09-21",2007,9,264,0,8750,7890,16640
"AL","2007-09-22",2007,9,265,31500,12300,8700,52500
"AL","2007-09-23",2007,9,266,16700,12900,11600,41200
"AL","2007-09-24",2007,9,267,0,9660,7910,17570
"AL","2007-09-25",2007,9,268,0,9530,8160,17690
"AL","2007-09-26",2007,9,269,25700,13300,13700,52700
"AL","2007-09-27",2007,9,270,1170,10400,8830,20400
"AL","2007-09-28",2007,9,271,1090,9850,8200,19140
"AL","2007-09-29",2007,9,272,1690,9730,8280,19700
"AL","2007-09-30",2007,9,273,0,9450,8320,17770
"AL","2007-10-01",2007,10,274,3880,9580,8360,21820
"AL","2007-10-02",2007,10,275,37100,16600,19700,73400
"AL","2007-10-03",2007,10,276,905,10800,9710,21415
"AL","2007-10-04",2007,10,277,51400,21100,29000,101500
"AL","2007-10-05",2007,10,278,0,11600,9110,20710
"AL","2007-10-06",2007,10,279,13500,12800,12700,39000
"AL","2007-10-07",2007,10,280,74000,32900,42400,149300
"AL","2007-10-08",2007,10,281,2350,15600,17200,35150
"AL","2007-10-09",2007,10,282,6270,14000,10100,30370
"AL","2007-10-10",2007,10,283,7420,14800,12900,35120
"AL","2007-10-11",2007,10,284,6740,14700,13100,34540
"AL","2007-10-12",2007,10,285,3180,13500,11700,28380
"AL","2007-10-13",2007,10,286,0,12600,10000,22600
"AL","2007-10-14",2007,10,287,0,12400,10000,22400
"AL","2007-10-15",2007,10,288,0,12200,9940,22140
"AL","2007-10-16",2007,10,289,5510,12800,9870,28180
"AL","2007-10-17",2007,10,290,9790,14400,11600,35790
"AL","2007-10-18",2007,10,291,14200,16100,16100,46400
"AL","2007-10-19",2007,10,292,17300,17600,17900,52800
"AL","2007-10-20",2007,10,293,31800,21800,24400,78000
"AL","2007-10-21",2007,10,294,10400,16700,15600,42700
"AL","2007-10-22",2007,10,295,0,13700,10900,24600
"AL","2007-10-23",2007,10,296,1730,13300,10700,25730
"AL","2007-10-24",2007,10,297,0,12900,10600,23500
"AL","2007-10-25",2007,10,298,9320,14200,11100,34620
"AL","2007-10-26",2007,10,299,0,12900,10700,23600
"AL","2007-10-27",2007,10,300,0,12600,10600,23200
"AL","2007-10-28",2007,10,301,671,12400,10500,23571
"AL","2007-10-29",2007,10,302,595,12300,10400,23295
"AL","2007-10-30",2007,10,303,0,12200,10300,22500
"AL","2007-10-31",2007,10,304,0,12100,10300,22400
"AL","2007-11-01",2007,11,305,1340,12100,10300,23740
"AL","2007-11-02",2007,11,306,1160,12000,10200,23360
"AL","2007-11-03",2007,11,307,0,11800,10100,21900
"AL","2007-11-04",2007,11,308,0,11800,10100,21900
"AL","2007-11-05",2007,11,309,750,11800,10100,22650
"AL","2007-11-06",2007,11,310,5160,12400,10100,27660
"AL","2007-11-07",2007,11,311,8280,12200,10100,30580
"AL","2007-11-08",2007,11,312,0,11800,9960,21760
"AL","2007-11-09",2007,11,313,0,11700,10000,21700
"AL","2007-11-10",2007,11,314,0,11600,10000,21600
"AL","2007-11-11",2007,11,315,0,11500,10000,21500
"AL","2007-11-12",2007,11,316,2630,11600,9990,24220
"AL","2007-11-13",2007,11,317,0,11400,9940,21340
"AL","2007-11-14",2007,11,318,0,11400,9890,21290
"AL","2007-11-15",2007,11,319,0,11400,9880,21280
"AL","2007-11-16",2007,11,320,7280,12200,9950,29430
"AL","2007-11-17",2007,11,321,750,11500,9790,22040
"AL","2007-11-18",2007,11,322,0,11400,9830,21230
"AL","2007-11-19",2007,11,323,0,11300,9810,21110
"AL","2007-11-20",2007,11,324,7210,11300,9650,28160
"AL","2007-11-21",2007,11,325,0,11300,9680,20980
"AL","2007-11-22",2007,11,326,333,11600,9860,21793
"AL","2007-11-23",2007,11,327,1960,11400,9760,23120
"AL","2007-11-24",2007,11,328,230,11300,9770,21300
"AL","2007-11-25",2007,11,329,230,11200,9780,21210
"AL","2007-11-26",2007,11,330,230,11100,9780,21110
"AL","2007-11-27",2007,11,331,0,11100,9770,20870
"AL","2007-11-28",2007,11,332,6230,11100,9600,26930
"AL","2007-11-29",2007,11,333,459,11100,9600,21159
"AL","2007-11-30",2007,11,334,0,11100,9640,20740
"AL","2007-12-01",2007,12,335,0,11100,9660,20760
"AL","2007-12-02",2007,12,336,0,11100,9670,20770
"AL","2007-12-03",2007,12,337,20800,11100,9310,41210
"AL","2007-12-04",2007,12,338,2550,11100,9320,22970
"AL","2007-12-05",2007,12,339,187,11100,9460,20747
"AL","2007-12-06",2007,12,340,609,11000,9530,21139
"AL","2007-12-07",2007,12,341,0,11000,9570,20570
"AL","2007-12-08",2007,12,342,445,11000,9590,21035
"AL","2007-12-09",2007,12,343,0,11000,9610,20610
"AL","2007-12-10",2007,12,344,0,11000,9640,20640
"AL","2007-12-11",2007,12,345,0,11000,9650,20650
"AL","2007-12-12",2007,12,346,0,11000,9660,20660
"AL","2007-12-13",2007,12,347,0,11000,9670,20670
"AL","2007-12-14",2007,12,348,0,10900,9680,20580
"AL","2007-12-15",2007,12,349,0,10900,9690,20590
"AL","2007-12-16",2007,12,350,0,10900,9690,20590
"AL","2007-12-17",2007,12,351,0,10900,9700,20600
"AL","2007-12-18",2007,12,352,93.5,10900,9700,20693.5
"AL","2007-12-19",2007,12,353,0,10900,9700,20600
"AL","2007-12-20",2007,12,354,93.5,10800,9700,20593.5
"AL","2007-12-21",2007,12,355,0,10800,9710,20510
"AL","2007-12-22",2007,12,356,129,10800,9710,20639
"AL","2007-12-23",2007,12,357,10400,10800,9510,30710
"AL","2007-12-24",2007,12,358,13100,10800,9290,33190
"AL","2007-12-25",2007,12,359,9260,10800,9210,29270
"AL","2007-12-26",2007,12,360,3260,10700,9270,23230
"AL","2007-12-27",2007,12,361,9750,10700,9200,29650
"AL","2007-12-28",2007,12,362,7060,10700,9160,26920
"AL","2007-12-29",2007,12,363,0,10700,9270,19970
"AL","2007-12-30",2007,12,364,1300,10700,9330,21330
"AL","2007-12-31",2007,12,365,1230,10600,9360,21190
"AL","2008-01-01",2008,1,1,0,10600,9410,20010
"AL","2008-01-02",2008,1,2,468,10600,9440,20508
"AL","2008-01-03",2008,1,3,312,10600,9460,20372
"AL","2008-01-04",2008,1,4,0,10600,9480,20080
"AL","2008-01-05",2008,1,5,0,10500,9490,19990
"AL","2008-01-06",2008,1,6,0,10500,9520,20020
"AL","2008-01-07",2008,1,7,215,10500,9540,20255
"AL","2008-01-08",2008,1,8,0,10500,9560,20060
"AL","2008-01-09",2008,1,9,12100,10400,9340,31840
"AL","2008-01-10",2008,1,10,0,10400,9370,19770
"AL","2008-01-11",2008,1,11,0,10400,9450,19850
"AL","2008-01-12",2008,1,12,0,10400,9480,19880
"AL","2008-01-13",2008,1,13,3510,10400,9430,23340
"AL","2008-01-14",2008,1,14,2400,10300,9410,22110
"AL","2008-01-15",2008,1,15,1150,10300,9420,20870
"AL","2008-01-16",2008,1,16,1390,10300,9430,21120
"AL","2008-01-17",2008,1,17,0,10300,9450,19750
"AL","2008-01-18",2008,1,18,5040,10200,9350,24590
"AL","2008-01-19",2008,1,19,13000,10200,9140,32340
"AL","2008-01-20",2008,1,20,0,10200,9200,19400
"AL","2008-01-21",2008,1,21,0,10200,9290,19490
"AL","2008-01-22",2008,1,22,0,10200,9320,19520
"AL","2008-01-23",2008,1,23,0,10100,9340,19440
"AL","2008-01-24",2008,1,24,0,10100,9350,19450
"AL","2008-01-25",2008,1,25,0,10100,9360,19460
"AL","2008-01-26",2008,1,26,0,10100,9360,19460
"AL","2008-01-27",2008,1,27,0,10000,9360,19360
"AL","2008-01-28",2008,1,28,0,10000,9370,19370
"AL","2008-01-29",2008,1,29,0,10000,9380,19380
"AL","2008-01-30",2008,1,30,5450,9980,9280,24710
"AL","2008-01-31",2008,1,31,8440,9960,9130,27530
"AL","2008-02-01",2008,2,32,0,9940,9180,19120
"AL","2008-02-02",2008,2,33,0,9920,9230,19150
"AL","2008-02-03",2008,2,34,950,9900,9240,20090
"AL","2008-02-04",2008,2,35,3400,9880,9190,22470
"AL","2008-02-05",2008,2,36,422,9860,9210,19492
"AL","2008-02-06",2008,2,37,1100,9840,9210,20150
"AL","2008-02-07",2008,2,38,0,9820,9220,19040
"AL","2008-02-08",2008,2,39,0,9800,9230,19030
"AL","2008-02-09",2008,2,40,0,9780,9230,19010
"AL","2008-02-10",2008,2,41,423,9770,9230,19423
"AL","2008-02-11",2008,2,42,188,9750,9220,19158
"AL","2008-02-12",2008,2,43,0,9730,9220,18950
"AL","2008-02-13",2008,2,44,0,9710,9210,18920
"AL","2008-02-14",2008,2,45,5070,9690,9110,23870
"AL","2008-02-15",2008,2,46,5350,9670,9020,24040
"AL","2008-02-16",2008,2,47,0,9660,9050,18710
"AL","2008-02-17",2008,2,48,0,9640,9090,18730
"AL","2008-02-18",2008,2,49,1690,9620,9070,20380
"AL","2008-02-19",2008,2,50,6040,9610,8970,24620
"AL","2008-02-20",2008,2,51,152,9590,8990,18732
"AL","2008-02-21",2008,2,52,0,9570,9030,18600
"AL","2008-02-22",2008,2,53,0,9550,9040,18590
"AL","2008-02-23",2008,2,54,0,9540,9040,18580
"AL","2008-02-24",2008,2,55,0,9520,9040,18560
"AL","2008-02-25",2008,2,56,0,9500,9040,18540
"AL","2008-02-26",2008,2,57,0,9480,9040,18520
"AL","2008-02-27",2008,2,58,188,9470,9040,18698
"AL","2008-02-28",2008,2,59,0,9450,9030,18480
"AL","2008-02-29",2008,2,60,317,9430,9010,18757
"AL","2008-03-01",2008,3,61,1560,9410,8980,19950
"AL","2008-03-02",2008,3,62,4220,9390,8910,22520
"AL","2008-03-03",2008,3,63,0,9380,8940,18320
"AL","2008-03-04",2008,3,64,2280,9360,8930,20570
"AL","2008-03-05",2008,3,65,0,9340,8920,18260
"AL","2008-03-06",2008,3,66,388,9320,8930,18638
"AL","2008-03-07",2008,3,67,0,9300,8930,18230
"AL","2008-03-08",2008,3,68,0,9280,8920,18200
"AL","2008-03-09",2008,3,69,0,9260,8910,18170
"AL","2008-03-10",2008,3,70,0,9240,8900,18140
"AL","2008-03-11",2008,3,71,0,9220,8900,18120
"AL","2008-03-12",2008,3,72,0,9210,8910,18120
"AL","2008-03-13",2008,3,73,10100,9190,8720,28010
"AL","2008-03-14",2008,3,74,10100,9170,8550,27820
"AL","2008-03-15",2008,3,75,0,9160,8650,17810
"AL","2008-03-16",2008,3,76,0,9140,8730,17870
"AL","2008-03-17",2008,3,77,0,9120,8750,17870
"AL","2008-03-18",2008,3,78,1550,9100,8750,19400
"AL","2008-03-19",2008,3,79,7650,9090,8610,25350
"AL","2008-03-20",2008,3,80,1810,9070,8620,19500
"AL","2008-03-21",2008,3,81,0,9060,8720,17780
"AL","2008-03-22",2008,3,82,0,9040,8740,17780
"AL","2008-03-23",2008,3,83,0,9020,8760,17780
"AL","2008-03-24",2008,3,84,0,9000,8770,17770
"AL","2008-03-25",2008,3,85,3300,8980,8720,21000
"AL","2008-03-26",2008,3,86,3400,8960,8670,21030
"AL","2008-03-27",2008,3,87,0,8950,8700,17650
"AL","2008-03-28",2008,3,88,0,8930,8740,17670
"AL","2008-03-29",2008,3,89,0,8910,8740,17650
"AL","2008-03-30",2008,3,90,0,8890,8770,17660
"AL","2008-03-31",2008,3,91,0,8870,8770,17640
"AL","2008-04-01",2008,4,92,8340,8860,8630,25830
"AL","2008-04-02",2008,4,93,21600,8840,8270,38710
"AL","2008-04-03",2008,4,94,0,8830,8330,17160
"AL","2008-04-04",2008,4,95,0,8810,8470,17280
"AL","2008-04-05",2008,4,96,0,8800,8520,17320
"AL","2008-04-06",2008,4,97,0,8780,8560,17340
"AL","2008-04-07",2008,4,98,1850,13100,18400,33350
"AL","2008-04-08",2008,4,99,9630,18400,45100,73130
"AL","2008-04-09",2008,4,100,20200,12400,14300,46900
"AL","2008-04-10",2008,4,101,5890,11900,12400,30190
"AL","2008-04-11",2008,4,102,10700,12000,12300,35000
"AL","2008-04-12",2008,4,103,28800,12600,13800,55200
"AL","2008-04-13",2008,4,104,15500,11100,9320,35920
"AL","2008-04-14",2008,4,105,0,10700,8840,19540
"AL","2008-04-15",2008,4,106,0,10500,8890,19390
"AL","2008-04-16",2008,4,107,0,10400,9250,19650
"AL","2008-04-17",2008,4,108,0,13800,17000,30800
"AL","2008-04-18",2008,4,109,10000,48500,57500,116000
"AL","2008-04-19",2008,4,110,14700,35100,42700,92500
"AL","2008-04-20",2008,4,111,12200,21600,29500,63300
"AL","2008-04-21",2008,4,112,3400,20700,14300,38400
"AL","2008-04-22",2008,4,113,6830,15600,12900,35330
"AL","2008-04-23",2008,4,114,4520,13900,11700,30120
"AL","2008-04-24",2008,4,115,3200,13500,11500,28200
"AL","2008-04-25",2008,4,116,5270,14000,11600,30870
"AL","2008-04-26",2008,4,117,8650,15000,12500,36150
"AL","2008-04-27",2008,4,118,10600,14900,13700,39200
"AL","2008-04-28",2008,4,119,512,13000,11100,24612
"AL","2008-04-29",2008,4,120,0,12700,11000,23700
"AL","2008-04-30",2008,4,121,0,12600,10900,23500
"AL","2008-05-01",2008,5,122,0,12400,10800,23200
"AL","2008-05-02",2008,5,123,10000,14000,11000,35000
"AL","2008-05-03",2008,5,124,47000,27400,29100,103500
"AL","2008-05-04",2008,5,125,47700,25500,32300,105500
"AL","2008-05-05",2008,5,126,2920,15200,12700,30820
"AL","2008-05-06",2008,5,127,0,13900,11600,25500
"AL","2008-05-07",2008,5,128,0,13800,11700,25500
"AL","2008-05-08",2008,5,129,3810,13400,11600,28810
"AL","2008-05-09",2008,5,130,0,12700,11500,24200
"AL","2008-05-10",2008,5,131,0,12400,11400,23800
"AL","2008-05-11",2008,5,132,0,11900,11300,23200
"AL","2008-05-12",2008,5,133,0,11500,11100,22600
"AL","2008-05-13",2008,5,134,0,11400,11000,22400
"AL","2008-05-14",2008,5,135,1250,11400,10900,23550
"AL","2008-05-15",2008,5,136,1060,11300,10800,23160
"AL","2008-05-16",2008,5,137,0,11100,10800,21900
"AL","2008-05-17",2008,5,138,1920,10800,10800,23520
"AL","2008-05-18",2008,5,139,4710,11000,10700,26410
"AL","2008-05-19",2008,5,140,4170,11000,10600,25770
"AL","2008-05-20",2008,5,141,1570,10900,10600,23070
"AL","2008-05-21",2008,5,142,0,10700,10600,21300
"AL","2008-05-22",2008,5,143,0,10700,10600,21300
"AL","2008-05-23",2008,5,144,0,10600,10600,21200
"AL","2008-05-24",2008,5,145,0,10500,10600,21100
"AL","2008-05-25",2008,5,146,1450,10400,10600,22450
"AL","2008-05-26",2008,5,147,21600,13400,10600,45600
"AL","2008-05-27",2008,5,148,33900,15100,11300,60300
"AL","2008-05-28",2008,5,149,0,11600,10300,21900
"AL","2008-05-29",2008,5,150,0,11100,10500,21600
"AL","2008-05-30",2008,5,151,14300,12800,10500,37600
"AL","2008-05-31",2008,5,152,31700,15500,11800,59000
"AL","2008-06-01",2008,6,153,508,11900,10300,22708
"AL","2008-06-02",2008,6,154,1240,11600,10500,23340
"AL","2008-06-03",2008,6,155,1960,11500,10600,24060
"AL","2008-06-04",2008,6,156,1500,11100,10600,23200
"AL","2008-06-05",2008,6,157,207,10900,10500,21607
"AL","2008-06-06",2008,6,158,10500,11800,10600,32900
"AL","2008-06-07",2008,6,159,34500,15300,13400,63200
"AL","2008-06-08",2008,6,160,300,11700,10300,22300
"AL","2008-06-09",2008,6,161,5910,12000,10600,28510
"AL","2008-06-10",2008,6,162,10000,12300,10600,32900
"AL","2008-06-11",2008,6,163,5590,12200,10600,28390
"AL","2008-06-12",2008,6,164,9820,13000,10700,33520
"AL","2008-06-13",2008,6,165,28800,17400,18700,64900
"AL","2008-06-14",2008,6,166,3290,12600,11000,26890
"AL","2008-06-15",2008,6,167,414,11800,10700,22914
"AL","2008-06-16",2008,6,168,1360,11500,10600,23460
"AL","2008-06-17",2008,6,169,5780,11700,10600,28080
"AL","2008-06-18",2008,6,170,0,11200,10500,21700
"AL","2008-06-19",2008,6,171,0,11100,10600,21700
"AL","2008-06-20",2008,6,172,1240,10900,10500,22640
"AL","2008-06-21",2008,6,173,3010,11000,10500,24510
"AL","2008-06-22",2008,6,174,22300,12600,10700,45600
"AL","2008-06-23",2008,6,175,26700,14300,11600,52600
"AL","2008-06-24",2008,6,176,1270,11800,10400,23470
"AL","2008-06-25",2008,6,177,0,11300,10500,21800
"AL","2008-06-26",2008,6,178,0,11100,10500,21600
"AL","2008-06-27",2008,6,179,0,10800,10500,21300
"AL","2008-06-28",2008,6,180,4760,11100,10400,26260
"AL","2008-06-29",2008,6,181,11700,11900,10400,34000
"AL","2008-06-30",2008,6,182,18500,12900,10500,41900
"AL","2008-07-01",2008,7,183,944,11400,10300,22644
"AL","2008-07-02",2008,7,184,0,11000,10400,21400
"AL","2008-07-03",2008,7,185,1400,10800,10500,22700
"AL","2008-07-04",2008,7,186,0,10500,10500,21000
"AL","2008-07-05",2008,7,187,0,10400,10600,21000
"AL","2008-07-06",2008,7,188,0,10300,10600,20900
"AL","2008-07-07",2008,7,189,1050,10200,10600,21850
"AL","2008-07-08",2008,7,190,1160,10200,10500,21860
"AL","2008-07-09",2008,7,191,22400,12100,10400,44900
"AL","2008-07-10",2008,7,192,0,10700,10300,21000
"AL","2008-07-11",2008,7,193,0,10200,10500,20700
"AL","2008-07-12",2008,7,194,974,10100,10400,21474
"AL","2008-07-13",2008,7,195,27600,12800,10400,50800
"AL","2008-07-14",2008,7,196,350,10700,10200,21250
"AL","2008-07-15",2008,7,197,3540,10900,10300,24740
"AL","2008-07-16",2008,7,198,13100,11600,10300,35000
"AL","2008-07-17",2008,7,199,1520,10700,10300,22520
"AL","2008-07-18",2008,7,200,17000,12700,10400,40100
"AL","2008-07-19",2008,7,201,32100,14500,11200,57800
"AL","2008-07-20",2008,7,202,0,11200,10100,21300
"AL","2008-07-21",2008,7,203,5220,11500,10300,27020
"AL","2008-07-22",2008,7,204,1040,10900,10200,22140
"AL","2008-07-23",2008,7,205,0,10500,10300,20800
"AL","2008-07-24",2008,7,206,0,10300,10400,20700
"AL","2008-07-25",2008,7,207,788,10100,10400,21288
"AL","2008-07-26",2008,7,208,12900,11600,10200,34700
"AL","2008-07-27",2008,7,209,233,10500,10100,20833
"AL","2008-07-28",2008,7,210,0,10100,10100,20200
"AL","2008-07-29",2008,7,211,0,9900,10200,20100
"AL","2008-07-30",2008,7,212,22200,12700,10000,44900
"AL","2008-07-31",2008,7,213,7940,11400,9860,29200
"AL","2008-08-01",2008,8,214,0,10500,9940,20440
"AL","2008-08-02",2008,8,215,1230,10200,10000,21430
"AL","2008-08-03",2008,8,216,0,9920,10100,20020
"AL","2008-08-04",2008,8,217,2170,9820,10100,22090
"AL","2008-08-05",2008,8,218,6230,10200,10000,26430
"AL","2008-08-06",2008,8,219,0,9720,9980,19700
"AL","2008-08-07",2008,8,220,2760,9820,10000,22580
"AL","2008-08-08",2008,8,221,4830,9960,9960,24750
"AL","2008-08-09",2008,8,222,0,9630,9910,19540
"AL","2008-08-10",2008,8,223,0,9610,9970,19580
"AL","2008-08-11",2008,8,224,0,9490,10000,19490
"AL","2008-08-12",2008,8,225,0,9460,10000,19460
"AL","2008-08-13",2008,8,226,0,9420,10100,19520
"AL","2008-08-14",2008,8,227,197,9390,9980,19567
"AL","2008-08-15",2008,8,228,0,9350,9910,19260
"AL","2008-08-16",2008,8,229,0,9320,9950,19270
"AL","2008-08-17",2008,8,230,0,9290,9970,19260
"AL","2008-08-18",2008,8,231,31000,12200,9670,52870
"AL","2008-08-19",2008,8,232,0,9840,9410,19250
"AL","2008-08-20",2008,8,233,0,9670,9650,19320
"AL","2008-08-21",2008,8,234,0,9330,9640,18970
"AL","2008-08-22",2008,8,235,0,9270,9610,18880
"AL","2008-08-23",2008,8,236,7720,9930,9520,27170
"AL","2008-08-24",2008,8,237,4810,9840,9420,24070
"AL","2008-08-25",2008,8,238,0,9390,9420,18810
"AL","2008-08-26",2008,8,239,0,9330,9480,18810
"AL","2008-08-27",2008,8,240,0,9130,9530,18660
"AL","2008-08-28",2008,8,241,0,9090,9570,18660
"AL","2008-08-29",2008,8,242,23200,11700,9280,44180
"AL","2008-08-30",2008,8,243,2960,10200,9090,22250
"AL","2008-08-31",2008,8,244,0,9710,9280,18990
"AL","2008-09-01",2008,9,245,0,9390,9350,18740
"AL","2008-09-02",2008,9,246,0,9180,9370,18550
"AL","2008-09-03",2008,9,247,0,9060,9380,18440
"AL","2008-09-04",2008,9,248,11100,9910,9250,30260
"AL","2008-09-05",2008,9,249,0,9260,9150,18410
"AL","2008-09-06",2008,9,250,0,9240,9200,18440
"AL","2008-09-07",2008,9,251,3440,9320,9160,21920
"AL","2008-09-08",2008,9,252,646,9180,9140,18966
"AL","2008-09-09",2008,9,253,10800,10100,9070,29970
"AL","2008-09-10",2008,9,254,426,9430,8980,18836
"AL","2008-09-11",2008,9,255,0,9300,9040,18340
"AL","2008-09-12",2008,9,256,0,9280,9080,18360
"AL","2008-09-13",2008,9,257,26800,12000,8960,47760
"AL","2008-09-14",2008,9,258,0,9800,8830,18630
"AL","2008-09-15",2008,9,259,56100,19000,16700,91800
"AL","2008-09-16",2008,9,260,701,10800,8900,20401
"AL","2008-09-17",2008,9,261,0,10600,8910,19510
"AL","2008-09-18",2008,9,262,0,10600,9040,19640
"AL","2008-09-19",2008,9,263,0,10400,9090,19490
"AL","2008-09-20",2008,9,264,0,10100,9120,19220
"AL","2008-09-21",2008,9,265,0,9930,9150,19080
"AL","2008-09-22",2008,9,266,0,9710,9150,18860
"AL","2008-09-23",2008,9,267,0,9570,9150,18720
"AL","2008-09-24",2008,9,268,0,9430,9170,18600
"AL","2008-09-25",2008,9,269,11500,10200,9000,30700
"AL","2008-09-26",2008,9,270,0,9830,8970,18800
"AL","2008-09-27",2008,9,271,0,9750,9100,18850
"AL","2008-09-28",2008,9,272,9900,10500,9000,29400
"AL","2008-09-29",2008,9,273,0,10100,9030,19130
"AL","2008-09-30",2008,9,274,0,9900,9140,19040
"AL","2008-10-01",2008,10,275,4140,9970,9120,23230
"AL","2008-10-02",2008,10,276,2310,9920,9090,21320
"AL","2008-10-03",2008,10,277,8510,10400,9060,27970
"AL","2008-10-04",2008,10,278,2950,10400,9160,22510
"AL","2008-10-05",2008,10,279,0,9820,9030,18850
"AL","2008-10-06",2008,10,280,0,9720,9040,18760
"AL","2008-10-07",2008,10,281,13100,11200,9200,33500
"AL","2008-10-08",2008,10,282,8670,11200,9220,29090
"AL","2008-10-09",2008,10,283,21000,14500,13100,48600
"AL","2008-10-10",2008,10,284,369,10900,9190,20459
"AL","2008-10-11",2008,10,285,0,10500,8890,19390
"AL","2008-10-12",2008,10,286,738,10500,8910,20148
"AL","2008-10-13",2008,10,287,0,10400,8920,19320
"AL","2008-10-14",2008,10,288,0,10300,8900,19200
"AL","2008-10-15",2008,10,289,6490,11000,8890,26380
"AL","2008-10-16",2008,10,290,151,10400,8890,19441
"AL","2008-10-17",2008,10,291,0,10100,8920,19020
"AL","2008-10-18",2008,10,292,0,10100,8910,19010
"AL","2008-10-19",2008,10,293,0,10100,8930,19030
"AL","2008-10-20",2008,10,294,0,10000,8950,18950
"AL","2008-10-21",2008,10,295,1310,10000,8980,20290
"AL","2008-10-22",2008,10,296,0,9970,8980,18950
"AL","2008-10-23",2008,10,297,0,9930,9000,18930
"AL","2008-10-24",2008,10,298,0,9900,9010,18910
"AL","2008-10-25",2008,10,299,1090,9920,9020,20030
"AL","2008-10-26",2008,10,300,22300,13800,12600,48700
"AL","2008-10-27",2008,10,301,2230,10800,9900,22930
"AL","2008-10-28",2008,10,302,26400,11600,11100,49100
"AL","2008-10-29",2008,10,303,3940,10500,8710,23150
"AL","2008-10-30",2008,10,304,0,10400,8810,19210
"AL","2008-10-31",2008,10,305,0,10900,10300,21200
"AL","2008-11-01",2008,11,306,0,13500,15300,28800
"AL","2008-11-02",2008,11,307,0,10700,9030,19730
"AL","2008-11-03",2008,11,308,0,10600,8930,19530
"AL","2008-11-04",2008,11,309,0,10400,8910,19310
"AL","2008-11-05",2008,11,310,0,10300,8890,19190
"AL","2008-11-06",2008,11,311,0,10300,8920,19220
"AL","2008-11-07",2008,11,312,2050,10400,8950,21400
"AL","2008-11-08",2008,11,313,5720,10800,8880,25400
"AL","2008-11-09",2008,11,314,8700,11700,9180,29580
"AL","2008-11-10",2008,11,315,5190,10600,8940,24730
"AL","2008-11-11",2008,11,316,459,10300,8880,19639
"AL","2008-11-12",2008,11,317,0,10200,8930,19130
"AL","2008-11-13",2008,11,318,3840,10200,8880,22920
"AL","2008-11-14",2008,11,319,13200,10800,9930,33930
"AL","2008-11-15",2008,11,320,2210,14400,16000,32610
"AL","2008-11-16",2008,11,321,2250,11000,9680,22930
"AL","2008-11-17",2008,11,322,230,10500,8830,19560
"AL","2008-11-18",2008,11,323,5440,10300,8750,24490
"AL","2008-11-19",2008,11,324,6190,10300,8670,25160
"AL","2008-11-20",2008,11,325,0,10200,8750,18950
"AL","2008-11-21",2008,11,326,2040,10200,8790,21030
"AL","2008-11-22",2008,11,327,3150,10100,8770,22020
"AL","2008-11-23",2008,11,328,0,10100,8800,18900
"AL","2008-11-24",2008,11,329,0,10000,8840,18840
"AL","2008-11-25",2008,11,330,0,10000,8880,18880
"AL","2008-11-26",2008,11,331,2590,9960,8870,21420
"AL","2008-11-27",2008,11,332,0,9920,8900,18820
"AL","2008-11-28",2008,11,333,0,9880,8930,18810
"AL","2008-11-29",2008,11,334,696,9850,8930,19476
"AL","2008-11-30",2008,11,335,0,9820,8940,18760
"AL","2008-12-01",2008,12,336,0,9790,8950,18740
"AL","2008-12-02",2008,12,337,445,9760,8940,19145
"AL","2008-12-03",2008,12,338,2280,9740,8890,20910
"AL","2008-12-04",2008,12,339,0,9720,8900,18620
"AL","2008-12-05",2008,12,340,0,9700,8900,18600
"AL","2008-12-06",2008,12,341,0,9680,8900,18580
"AL","2008-12-07",2008,12,342,4470,9660,8810,22940
"AL","2008-12-08",2008,12,343,1880,9650,8780,20310
"AL","2008-12-09",2008,12,344,3380,9630,8740,21750
"AL","2008-12-10",2008,12,345,4550,9620,8680,22850
"AL","2008-12-11",2008,12,346,0,9600,8710,18310
"AL","2008-12-12",2008,12,347,129,9580,8740,18449
"AL","2008-12-13",2008,12,348,0,9570,8750,18320
"AL","2008-12-14",2008,12,349,316,9550,8750,18616
"AL","2008-12-15",2008,12,350,4360,9530,8670,22560
"AL","2008-12-16",2008,12,351,7530,9510,8550,25590
"AL","2008-12-17",2008,12,352,0,9490,8590,18080
"AL","2008-12-18",2008,12,353,3160,9480,8590,21230
"AL","2008-12-19",2008,12,354,0,9460,8610,18070
"AL","2008-12-20",2008,12,355,0,9450,8640,18090
"AL","2008-12-21",2008,12,356,0,9430,8660,18090
"AL","2008-12-22",2008,12,357,8860,9410,8500,26770
"AL","2008-12-23",2008,12,358,258,9400,8520,18178
"AL","2008-12-24",2008,12,359,1840,9380,8540,19760
"AL","2008-12-25",2008,12,360,4600,9370,8490,22460
"AL","2008-12-26",2008,12,361,445,9350,8510,18305
"AL","2008-12-27",2008,12,362,8830,9340,8400,26570
"AL","2008-12-28",2008,12,363,550,9330,8430,18310
"AL","2008-12-29",2008,12,364,1300,9320,8480,19100
"AL","2008-12-30",2008,12,365,187,9300,8510,17997
"AL","2008-12-31",2008,12,366,0,9290,8530,17820
"AL","2009-01-01",2009,1,1,1350,9270,8520,19140
"AL","2009-01-02",2009,1,2,0,9260,8530,17790
"AL","2009-01-03",2009,1,3,0,9240,8550,17790
"AL","2009-01-04",2009,1,4,1520,9220,8520,19260
"AL","2009-01-05",2009,1,5,11900,9210,8320,29430
"AL","2009-01-06",2009,1,6,0,9190,8350,17540
"AL","2009-01-07",2009,1,7,0,9180,8430,17610
"AL","2009-01-08",2009,1,8,215,9160,8450,17825
"AL","2009-01-09",2009,1,9,17000,9150,8170,34320
"AL","2009-01-10",2009,1,10,0,9140,8220,17360
"AL","2009-01-11",2009,1,11,0,9130,8330,17460
"AL","2009-01-12",2009,1,12,0,9120,8370,17490
"AL","2009-01-13",2009,1,13,0,9100,8380,17480
"AL","2009-01-14",2009,1,14,3130,9090,8350,20570
"AL","2009-01-15",2009,1,15,0,9080,8360,17440
"AL","2009-01-16",2009,1,16,0,9070,8400,17470
"AL","2009-01-17",2009,1,17,0,9050,8400,17450
"AL","2009-01-18",2009,1,18,7560,9040,8280,24880
"AL","2009-01-19",2009,1,19,2400,9030,8260,19690
"AL","2009-01-20",2009,1,20,1640,9010,8290,18940
"AL","2009-01-21",2009,1,21,4650,9000,8230,21880
"AL","2009-01-22",2009,1,22,0,8990,8280,17270
"AL","2009-01-23",2009,1,23,0,8970,8320,17290
"AL","2009-01-24",2009,1,24,0,8960,8350,17310
"AL","2009-01-25",2009,1,25,371,8950,8340,17661
"AL","2009-01-26",2009,1,26,0,8940,8350,17290
"AL","2009-01-27",2009,1,27,0,8930,8350,17280
"AL","2009-01-28",2009,1,28,0,8910,8360,17270
"AL","2009-01-29",2009,1,29,0,8900,8350,17250
"AL","2009-01-30",2009,1,30,1760,8890,8320,18970
"AL","2009-01-31",2009,1,31,567,8890,8320,17777
"AL","2009-02-01",2009,2,32,0,8870,8320,17190
"AL","2009-02-02",2009,2,33,0,8870,8340,17210
"AL","2009-02-03",2009,2,34,0,8850,8330,17180
"AL","2009-02-04",2009,2,35,0,8840,8330,17170
"AL","2009-02-05",2009,2,36,0,8830,8320,17150
"AL","2009-02-06",2009,2,37,0,8820,8320,17140
"AL","2009-02-07",2009,2,38,0,8810,8320,17130
"AL","2009-02-08",2009,2,39,0,8800,8310,17110
"AL","2009-02-09",2009,2,40,0,8780,8310,17090
"AL","2009-02-10",2009,2,41,0,8770,8300,17070
"AL","2009-02-11",2009,2,42,2140,8760,8270,19170
"AL","2009-02-12",2009,2,43,317,8750,8270,17337
"AL","2009-02-13",2009,2,44,2140,8730,8540,19410
"AL","2009-02-14",2009,2,45,1220,8720,8270,18210
"AL","2009-02-15",2009,2,46,1170,8710,8240,18120
"AL","2009-02-16",2009,2,47,129,8700,8230,17059
"AL","2009-02-17",2009,2,48,0,8690,8240,16930
"AL","2009-02-18",2009,2,49,0,8680,8230,16910
"AL","2009-02-19",2009,2,50,1170,8660,8220,18050
"AL","2009-02-20",2009,2,51,317,8650,8200,17167
"AL","2009-02-21",2009,2,52,0,8640,8210,16850
"AL","2009-02-22",2009,2,53,0,8630,8200,16830
"AL","2009-02-23",2009,2,54,1710,8610,8170,18490
"AL","2009-02-24",2009,2,55,4120,8600,8100,20820
"AL","2009-02-25",2009,2,56,0,8590,8110,16700
"AL","2009-02-26",2009,2,57,750,8570,8130,17450
"AL","2009-02-27",2009,2,58,1270,8560,8120,17950
"AL","2009-02-28",2009,2,59,5680,8550,8020,22250
"AL","2009-03-01",2009,3,60,0,8530,8050,16580
"AL","2009-03-02",2009,3,61,0,8520,8080,16600
"AL","2009-03-03",2009,3,62,0,8510,8090,16600
"AL","2009-03-04",2009,3,63,0,8490,8100,16590
"AL","2009-03-05",2009,3,64,0,8480,8100,16580
"AL","2009-03-06",2009,3,65,0,8470,8130,16600
"AL","2009-03-07",2009,3,66,0,8450,8160,16610
"AL","2009-03-08",2009,3,67,0,8440,8190,16630
"AL","2009-03-09",2009,3,68,0,8420,8190,16610
"AL","2009-03-10",2009,3,69,0,8410,8180,16590
"AL","2009-03-11",2009,3,70,689,8390,8190,17269
"AL","2009-03-12",2009,3,71,6100,8380,8060,22540
"AL","2009-03-13",2009,3,72,0,8370,8040,16410
"AL","2009-03-14",2009,3,73,0,8360,8070,16430
"AL","2009-03-15",2009,3,74,0,8340,8090,16430
"AL","2009-03-16",2009,3,75,0,8330,8140,16470
"AL","2009-03-17",2009,3,76,0,8320,8200,16520
"AL","2009-03-18",2009,3,77,0,8360,9640,18000
"AL","2009-03-19",2009,3,78,0,10900,15600,26500
"AL","2009-03-20",2009,3,79,0,9920,12500,22420
"AL","2009-03-21",2009,3,80,0,8820,8750,17570
"AL","2009-03-22",2009,3,81,2630,8690,8300,19620
"AL","2009-03-23",2009,3,82,0,8760,8870,17630
"AL","2009-03-24",2009,3,83,0,10100,12400,22500
"AL","2009-03-25",2009,3,84,15500,10000,12000,37500
"AL","2009-03-26",2009,3,85,15900,15300,23900,55100
"AL","2009-03-27",2009,3,86,0,10700,11700,22400
"AL","2009-03-28",2009,3,87,172,9890,8820,18882
"AL","2009-03-29",2009,3,88,0,9650,8620,18270
"AL","2009-03-30",2009,3,89,0,9490,8620,18110
"AL","2009-03-31",2009,3,90,0,9350,8620,17970
"AL","2009-04-01",2009,4,91,0,9230,9770,19000
"AL","2009-04-02",2009,4,92,40900,9300,10300,60500
"AL","2009-04-03",2009,4,93,5380,9220,8580,23180
"AL","2009-04-04",2009,4,94,0,9060,9920,18980
"AL","2009-04-05",2009,4,95,0,9130,10300,19430
"AL","2009-04-06",2009,4,96,0,9770,11700,21470
"AL","2009-04-07",2009,4,97,0,9100,10200,19300
"AL","2009-04-08",2009,4,98,0,8950,8830,17780
"AL","2009-04-09",2009,4,99,0,9030,10200,19230
"AL","2009-04-10",2009,4,100,0,10600,12600,23200
"AL","2009-04-11",2009,4,101,0,9980,9820,19800
"AL","2009-04-12",2009,4,102,0,9880,9360,19240
"AL","2009-04-13",2009,4,103,0,10800,9110,19910
"AL","2009-04-14",2009,4,104,0,12300,8420,20720
"AL","2009-04-15",2009,4,105,0,11200,8390,19590
"AL","2009-04-16",2009,4,106,0,9770,8420,18190
"AL","2009-04-17",2009,4,107,0,9520,8460,17980
"AL","2009-04-18",2009,4,108,0,9360,8490,17850
"AL","2009-04-19",2009,4,109,0,9230,8530,17760
"AL","2009-04-20",2009,4,110,2040,9220,8560,19820
"AL","2009-04-21",2009,4,111,40200,10900,8910,60010
"AL","2009-04-22",2009,4,112,36400,10900,11400,58700
"AL","2009-04-23",2009,4,113,2880,12000,13900,28780
"AL","2009-04-24",2009,4,114,0,11600,12800,24400
"AL","2009-04-25",2009,4,115,0,14400,18000,32400
"AL","2009-04-26",2009,4,116,22900,18800,19000,60700
"AL","2009-04-27",2009,4,117,569,11300,9010,20879
"AL","2009-04-28",2009,4,118,22000,16100,15900,54000
"AL","2009-04-29",2009,4,119,0,11200,8800,20000
"AL","2009-04-30",2009,4,120,0,11000,8750,19750
"AL","2009-05-01",2009,5,121,2250,10900,8790,21940
"AL","2009-05-02",2009,5,122,3510,11100,8820,23430
"AL","2009-05-03",2009,5,123,0,10400,8810,19210
"AL","2009-05-04",2009,5,124,0,10300,8890,19190
"AL","2009-05-05",2009,5,125,0,10200,8980,19180
"AL","2009-05-06",2009,5,126,0,10100,9070,19170
"AL","2009-05-07",2009,5,127,36700,17500,19100,73300
"AL","2009-05-08",2009,5,128,5240,11400,9310,25950
"AL","2009-05-09",2009,5,129,0,10400,8920,19320
"AL","2009-05-10",2009,5,130,508,9860,8950,19318
"AL","2009-05-11",2009,5,131,0,9390,8870,18260
"AL","2009-05-12",2009,5,132,0,9310,8880,18190
"AL","2009-05-13",2009,5,133,0,9200,8900,18100
"AL","2009-05-14",2009,5,134,554,9070,8910,18534
"AL","2009-05-15",2009,5,135,37100,13400,9510,60010
"AL","2009-05-16",2009,5,136,0,10100,8600,18700
"AL","2009-05-17",2009,5,137,11200,11300,9180,31680
"AL","2009-05-18",2009,5,138,0,9690,8780,18470
"AL","2009-05-19",2009,5,139,0,9610,8910,18520
"AL","2009-05-20",2009,5,140,254,9350,8940,18544
"AL","2009-05-21",2009,5,141,0,9060,8970,18030
"AL","2009-05-22",2009,5,142,369,8860,8990,18219
"AL","2009-05-23",2009,5,143,8060,9400,8900,26360
"AL","2009-05-24",2009,5,144,508,8800,8850,18158
"AL","2009-05-25",2009,5,145,0,8670,8890,17560
"AL","2009-05-26",2009,5,146,0,8620,8910,17530
"AL","2009-05-27",2009,5,147,2750,8640,8820,20210
"AL","2009-05-28",2009,5,148,21800,10900,8640,41340
"AL","2009-05-29",2009,5,149,10000,10500,8470,28970
"AL","2009-05-30",2009,5,150,0,9410,8590,18000
"AL","2009-05-31",2009,5,151,1270,9210,8690,19170
"AL","2009-06-01",2009,6,152,0,8940,8760,17700
"AL","2009-06-02",2009,6,153,17100,10400,8730,36230
"AL","2009-06-03",2009,6,154,0,9280,8650,17930
"AL","2009-06-04",2009,6,155,0,9110,8830,17940
"AL","2009-06-05",2009,6,156,0,8740,8850,17590
"AL","2009-06-06",2009,6,157,0,8550,8870,17420
"AL","2009-06-07",2009,6,158,0,8490,8900,17390
"AL","2009-06-08",2009,6,159,23300,10500,8750,42550
"AL","2009-06-09",2009,6,160,1170,9250,8590,19010
"AL","2009-06-10",2009,6,161,44600,15000,10200,69800
"AL","2009-06-11",2009,6,162,0,9930,8340,18270
"AL","2009-06-12",2009,6,163,0,9820,8650,18470
"AL","2009-06-13",2009,6,164,0,9520,8730,18250
"AL","2009-06-14",2009,6,165,0,9250,8780,18030
"AL","2009-06-15",2009,6,166,15600,10600,8780,34980
"AL","2009-06-16",2009,6,167,0,9340,8710,18050
"AL","2009-06-17",2009,6,168,0,8990,8810,17800
"AL","2009-06-18",2009,6,169,0,8750,8810,17560
"AL","2009-06-19",2009,6,170,0,8670,8810,17480
"AL","2009-06-20",2009,6,171,0,8630,8820,17450
"AL","2009-06-21",2009,6,172,0,8600,8820,17420
"AL","2009-06-22",2009,6,173,0,8570,8810,17380
"AL","2009-06-23",2009,6,174,1060,8560,8810,18430
"AL","2009-06-24",2009,6,175,0,8530,8810,17340
"AL","2009-06-25",2009,6,176,0,8510,8820,17330
"AL","2009-06-26",2009,6,177,0,8490,8800,17290
"AL","2009-06-27",2009,6,178,0,8470,8810,17280
"AL","2009-06-28",2009,6,179,0,8460,8790,17250
"AL","2009-06-29",2009,6,180,13600,9460,8610,31670
"AL","2009-06-30",2009,6,181,10800,9800,8430,29030
"AL","2009-07-01",2009,7,182,5160,9410,8380,22950
"AL","2009-07-02",2009,7,183,1790,9070,8460,19320
"AL","2009-07-03",2009,7,184,0,8760,8560,17320
"AL","2009-07-04",2009,7,185,0,8660,8650,17310
"AL","2009-07-05",2009,7,186,0,8480,8760,17240
"AL","2009-07-06",2009,7,187,0,8410,8890,17300
"AL","2009-07-07",2009,7,188,0,8480,8940,17420
"AL","2009-07-08",2009,7,189,0,8360,8980,17340
"AL","2009-07-09",2009,7,190,0,8440,8980,17420
"AL","2009-07-10",2009,7,191,0,8330,8980,17310
"AL","2009-07-11",2009,7,192,17500,9980,8830,36310
"AL","2009-07-12",2009,7,193,2570,8870,8760,20200
"AL","2009-07-13",2009,7,194,0,8350,8780,17130
"AL","2009-07-14",2009,7,195,0,8430,8820,17250
"AL","2009-07-15",2009,7,196,0,8280,8860,17140
"AL","2009-07-16",2009,7,197,22500,10200,8610,41310
"AL","2009-07-17",2009,7,198,0,8780,8450,17230
"AL","2009-07-18",2009,7,199,3280,8730,8530,20540
"AL","2009-07-19",2009,7,200,1140,8570,8530,18240
"AL","2009-07-20",2009,7,201,161,8350,8550,17061
"AL","2009-07-21",2009,7,202,0,8250,8570,16820
"AL","2009-07-22",2009,7,203,4430,8470,8530,21430
"AL","2009-07-23",2009,7,204,0,8230,8530,16760
"AL","2009-07-24",2009,7,205,14400,9610,8450,32460
"AL","2009-07-25",2009,7,206,131,8540,8390,17061
"AL","2009-07-26",2009,7,207,10900,9130,8390,28420
"AL","2009-07-27",2009,7,208,7380,9210,8290,24880
"AL","2009-07-28",2009,7,209,0,8510,8330,16840
"AL","2009-07-29",2009,7,210,1680,8390,8440,18510
"AL","2009-07-30",2009,7,211,1790,8310,8430,18530
"AL","2009-07-31",2009,7,212,0,8150,8430,16580
"AL","2009-08-01",2009,8,213,22100,9950,8240,40290
"AL","2009-08-02",2009,8,214,1320,8800,8130,18250
"AL","2009-08-03",2009,8,215,6190,9130,8220,23540
"AL","2009-08-04",2009,8,216,4190,8970,8210,21370
"AL","2009-08-05",2009,8,217,483,8590,8280,17353
"AL","2009-08-06",2009,8,218,0,8360,8350,16710
"AL","2009-08-07",2009,8,219,0,8290,8380,16670
"AL","2009-08-08",2009,8,220,0,8170,8410,16580
"AL","2009-08-09",2009,8,221,19000,9450,8250,36700
"AL","2009-08-10",2009,8,222,1470,8620,8180,18270
"AL","2009-08-11",2009,8,223,0,8320,8320,16640
"AL","2009-08-12",2009,8,224,0,8220,8380,16600
"AL","2009-08-13",2009,8,225,0,8080,8410,16490
"AL","2009-08-14",2009,8,226,0,8150,8510,16660
"AL","2009-08-15",2009,8,227,2960,8190,8450,19600
"AL","2009-08-16",2009,8,228,5010,8420,8370,21800
"AL","2009-08-17",2009,8,229,11300,8940,8270,28510
"AL","2009-08-18",2009,8,230,2110,8400,8190,18700
"AL","2009-08-19",2009,8,231,0,8120,8240,16360
"AL","2009-08-20",2009,8,232,0,8040,8260,16300
"AL","2009-08-21",2009,8,233,25300,10200,8060,43560
"AL","2009-08-22",2009,8,234,63300,18300,17200,98800
"AL","2009-08-23",2009,8,235,3310,9880,7680,20870
"AL","2009-08-24",2009,8,236,0,9620,7790,17410
"AL","2009-08-25",2009,8,237,0,9580,8060,17640
"AL","2009-08-26",2009,8,238,12600,9940,8160,30700
"AL","2009-08-27",2009,8,239,16500,11400,9820,37720
"AL","2009-08-28",2009,8,240,0,9490,8040,17530
"AL","2009-08-29",2009,8,241,18600,11300,11900,41800
"AL","2009-08-30",2009,8,242,27800,15500,18100,61400
"AL","2009-08-31",2009,8,243,14900,13200,13300,41400
"AL","2009-09-01",2009,9,244,0,10300,8150,18450
"AL","2009-09-02",2009,9,245,0,10100,8360,18460
"AL","2009-09-03",2009,9,246,0,9770,8440,18210
"AL","2009-09-04",2009,9,247,0,9500,8470,17970
"AL","2009-09-05",2009,9,248,0,9260,8490,17750
"AL","2009-09-06",2009,9,249,0,9050,8530,17580
"AL","2009-09-07",2009,9,250,0,8860,8530,17390
"AL","2009-09-08",2009,9,251,0,8720,8530,17250
"AL","2009-09-09",2009,9,252,0,8600,8530,17130
"AL","2009-09-10",2009,9,253,0,8520,8550,17070
"AL","2009-09-11",2009,9,254,0,8460,8560,17020
"AL","2009-09-12",2009,9,255,0,8410,8570,16980
"AL","2009-09-13",2009,9,256,0,8360,8570,16930
"AL","2009-09-14",2009,9,257,0,8320,8560,16880
"AL","2009-09-15",2009,9,258,0,8270,8560,16830
"AL","2009-09-16",2009,9,259,0,8230,8550,16780
"AL","2009-09-17",2009,9,260,0,8310,8540,16850
"AL","2009-09-18",2009,9,261,0,8210,8510,16720
"AL","2009-09-19",2009,9,262,1540,8170,8470,18180
"AL","2009-09-20",2009,9,263,0,8080,8440,16520
"AL","2009-09-21",2009,9,264,0,8170,8430,16600
"AL","2009-09-22",2009,9,265,0,8090,8410,16500
"AL","2009-09-23",2009,9,266,0,8020,8380,16400
"AL","2009-09-24",2009,9,267,1260,7980,8330,17570
"AL","2009-09-25",2009,9,268,0,8050,8300,16350
"AL","2009-09-26",2009,9,269,0,8030,8280,16310
"AL","2009-09-27",2009,9,270,5510,8240,8110,21860
"AL","2009-09-28",2009,9,271,3300,8380,8070,19750
"AL","2009-09-29",2009,9,272,11800,9200,7930,28930
"AL","2009-09-30",2009,9,273,5640,9150,7790,22580
"AL","2009-10-01",2009,10,274,279,8700,7870,16849
"AL","2009-10-02",2009,10,275,0,8550,7950,16500
"AL","2009-10-03",2009,10,276,12900,9380,7880,30160
"AL","2009-10-04",2009,10,277,24800,11700,8660,45160
"AL","2009-10-05",2009,10,278,4540,9770,8000,22310
"AL","2009-10-06",2009,10,279,1590,9310,7940,18840
"AL","2009-10-07",2009,10,280,11300,10800,8570,30670
"AL","2009-10-08",2009,10,281,63900,25200,36100,125200
"AL","2009-10-09",2009,10,282,0,12000,12200,24200
"AL","2009-10-10",2009,10,283,0,10700,8490,19190
"AL","2009-10-11",2009,10,284,0,10600,8040,18640
"AL","2009-10-12",2009,10,285,0,10500,8100,18600
"AL","2009-10-13",2009,10,286,0,10300,8150,18450
"AL","2009-10-14",2009,10,287,8200,10200,8010,26410
"AL","2009-10-15",2009,10,288,0,10100,8090,18190
"AL","2009-10-16",2009,10,289,0,10100,8240,18340
"AL","2009-10-17",2009,10,290,1210,10400,8430,20040
"AL","2009-10-18",2009,10,291,243,9870,8370,18483
"AL","2009-10-19",2009,10,292,0,9790,8390,18180
"AL","2009-10-20",2009,10,293,0,9730,8410,18140
"AL","2009-10-21",2009,10,294,0,9680,8420,18100
"AL","2009-10-22",2009,10,295,402,9650,8450,18502
"AL","2009-10-23",2009,10,296,39400,17800,20000,77200
"AL","2009-10-24",2009,10,297,528,10800,9540,20868
"AL","2009-10-25",2009,10,298,55800,12600,11000,79400
"AL","2009-10-26",2009,10,299,1200,11500,9670,22370
"AL","2009-10-27",2009,10,300,34800,69700,66300,170800
"AL","2009-10-28",2009,10,301,0,13400,9810,23210
"AL","2009-10-29",2009,10,302,0,13500,11700,25200
"AL","2009-10-30",2009,10,303,0,13600,12600,26200
"AL","2009-10-31",2009,10,304,17100,17700,17800,52600
"AL","2009-11-01",2009,11,305,2130,13100,10600,25830
"AL","2009-11-02",2009,11,306,689,12000,9540,22229
"AL","2009-11-03",2009,11,307,186,11800,9570,21556
"AL","2009-11-04",2009,11,308,0,11600,9530,21130
"AL","2009-11-05",2009,11,309,0,11400,9470,20870
"AL","2009-11-06",2009,11,310,0,11300,9420,20720
"AL","2009-11-07",2009,11,311,0,11200,9440,20640
"AL","2009-11-08",2009,11,312,0,11100,9470,20570
"AL","2009-11-09",2009,11,313,0,11000,9500,20500
"AL","2009-11-10",2009,11,314,0,10900,9520,20420
"AL","2009-11-11",2009,11,315,0,10800,9530,20330
"AL","2009-11-12",2009,11,316,0,10700,9540,20240
"AL","2009-11-13",2009,11,317,0,10700,9560,20260
"AL","2009-11-14",2009,11,318,0,10600,9570,20170
"AL","2009-11-15",2009,11,319,0,10500,9580,20080
"AL","2009-11-16",2009,11,320,0,10500,9570,20070
"AL","2009-11-17",2009,11,321,0,10400,9560,19960
"AL","2009-11-18",2009,11,322,0,10400,9540,19940
"AL","2009-11-19",2009,11,323,0,10300,9530,19830
"AL","2009-11-20",2009,11,324,0,10300,9530,19830
"AL","2009-11-21",2009,11,325,3450,10600,9610,23660
"AL","2009-11-22",2009,11,326,0,10200,9430,19630
"AL","2009-11-23",2009,11,327,0,10100,9450,19550
"AL","2009-11-24",2009,11,328,746,10200,9460,20406
"AL","2009-11-25",2009,11,329,0,10100,9460,19560
"AL","2009-11-26",2009,11,330,0,10100,9470,19570
"AL","2009-11-27",2009,11,331,3900,10400,9560,23860
"AL","2009-11-28",2009,11,332,1690,10000,9340,21030
"AL","2009-11-29",2009,11,333,0,10000,9350,19350
"AL","2009-11-30",2009,11,334,2920,10300,9390,22610
"AL","2009-12-01",2009,12,335,1820,10000,9270,21090
"AL","2009-12-02",2009,12,336,1790,10200,9290,21280
"AL","2009-12-03",2009,12,337,0,10000,9280,19280
"AL","2009-12-04",2009,12,338,725,9990,9270,19985
"AL","2009-12-05",2009,12,339,445,9980,9260,19685
"AL","2009-12-06",2009,12,340,1050,9970,9230,20250
"AL","2009-12-07",2009,12,341,597,9960,9220,19777
"AL","2009-12-08",2009,12,342,0,9960,9230,19190
"AL","2009-12-09",2009,12,343,0,9950,9230,19180
"AL","2009-12-10",2009,12,344,10800,9940,9030,29770
"AL","2009-12-11",2009,12,345,7170,9930,8930,26030
"AL","2009-12-12",2009,12,346,421,9910,9000,19331
"AL","2009-12-13",2009,12,347,0,9900,9060,18960
"AL","2009-12-14",2009,12,348,0,9890,9090,18980
"AL","2009-12-15",2009,12,349,7600,9880,8970,26450
"AL","2009-12-16",2009,12,350,1920,9870,8970,20760
"AL","2009-12-17",2009,12,351,0,9870,9030,18900
"AL","2009-12-18",2009,12,352,0,9860,9060,18920
"AL","2009-12-19",2009,12,353,0,9860,9090,18950
"AL","2009-12-20",2009,12,354,0,9850,9100,18950
"AL","2009-12-21",2009,12,355,129,9850,9110,19089
"AL","2009-12-22",2009,12,356,867,9840,9120,19827
"AL","2009-12-23",2009,12,357,749,9830,9110,19689
"AL","2009-12-24",2009,12,358,0,9820,9130,18950
"AL","2009-12-25",2009,12,359,5650,9810,9030,24490
"AL","2009-12-26",2009,12,360,7990,9800,8910,26700
"AL","2009-12-27",2009,12,361,3560,9800,8900,22260
"AL","2009-12-28",2009,12,362,347,9790,8980,19117
"AL","2009-12-29",2009,12,363,2710,9780,8970,21460
"AL","2009-12-30",2009,12,364,0,9770,9000,18770
"AL","2009-12-31",2009,12,365,0,9770,9030,18800
"AL","2010-01-01",2010,1,1,0,9750,9050,18800
"AL","2010-01-02",2010,1,2,15800,9740,8780,34320
"AL","2010-01-03",2010,1,3,0,9730,8820,18550
"AL","2010-01-04",2010,1,4,0,9720,8920,18640
"AL","2010-01-05",2010,1,5,430,9700,8950,19080
"AL","2010-01-06",2010,1,6,1080,9690,8960,19730
"AL","2010-01-07",2010,1,7,0,9670,8980,18650
"AL","2010-01-08",2010,1,8,0,9650,9010,18660
"AL","2010-01-09",2010,1,9,430,9640,9020,19090
"AL","2010-01-10",2010,1,10,527,9620,9020,19167
"AL","2010-01-11",2010,1,11,0,9610,9020,18630
"AL","2010-01-12",2010,1,12,6130,9600,8920,24650
"AL","2010-01-13",2010,1,13,0,9580,8940,18520
"AL","2010-01-14",2010,1,14,0,9570,8990,18560
"AL","2010-01-15",2010,1,15,0,9560,9010,18570
"AL","2010-01-16",2010,1,16,0,9540,9020,18560
"AL","2010-01-17",2010,1,17,0,9530,9020,18550
"AL","2010-01-18",2010,1,18,0,9510,9030,18540
"AL","2010-01-19",2010,1,19,0,9500,9030,18530
"AL","2010-01-20",2010,1,20,0,9480,9030,18510
"AL","2010-01-21",2010,1,21,0,9460,9020,18480
"AL","2010-01-22",2010,1,22,0,9450,9010,18460
"AL","2010-01-23",2010,1,23,0,9430,9020,18450
"AL","2010-01-24",2010,1,24,0,9410,9010,18420
"AL","2010-01-25",2010,1,25,5960,9400,8890,24250
"AL","2010-01-26",2010,1,26,22200,9380,8510,40090
"AL","2010-01-27",2010,1,27,3280,9370,8520,21170
"AL","2010-01-28",2010,1,28,0,9360,8660,18020
"AL","2010-01-29",2010,1,29,0,9340,8730,18070
"AL","2010-01-30",2010,1,30,0,9330,8760,18090
"AL","2010-01-31",2010,1,31,0,9310,8770,18080
"AL","2010-02-01",2010,2,32,0,9300,8790,18090
"AL","2010-02-02",2010,2,33,0,9280,8800,18080
"AL","2010-02-03",2010,2,34,0,9260,8810,18070
"AL","2010-02-04",2010,2,35,1140,9240,8790,19170
"AL","2010-02-05",2010,2,36,0,9230,8790,18020
"AL","2010-02-06",2010,2,37,0,9210,8800,18010
"AL","2010-02-07",2010,2,38,0,9190,8810,18000
"AL","2010-02-08",2010,2,39,0,9170,8800,17970
"AL","2010-02-09",2010,2,40,0,9150,8800,17950
"AL","2010-02-10",2010,2,41,575,9130,8790,18495
"AL","2010-02-11",2010,2,42,3480,9110,8720,21310
"AL","2010-02-12",2010,2,43,0,9090,8720,17810
"AL","2010-02-13",2010,2,44,0,9080,8740,17820
"AL","2010-02-14",2010,2,45,0,9060,8740,17800
"AL","2010-02-15",2010,2,46,0,9040,8740,17780
"AL","2010-02-16",2010,2,47,6340,9020,8620,23980
"AL","2010-02-17",2010,2,48,739,9000,8620,18359
"AL","2010-02-18",2010,2,49,0,8980,8660,17640
"AL","2010-02-19",2010,2,50,0,8970,8670,17640
"AL","2010-02-20",2010,2,51,0,8950,8680,17630
"AL","2010-02-21",2010,2,52,0,8930,8670,17600
"AL","2010-02-22",2010,2,53,0,8910,8680,17590
"AL","2010-02-23",2010,2,54,0,8890,8670,17560
"AL","2010-02-24",2010,2,55,0,8880,8670,17550
"AL","2010-02-25",2010,2,56,1240,8860,8640,18740
"AL","2010-02-26",2010,2,57,188,8840,8640,17668
"AL","2010-02-27",2010,2,58,0,8830,8630,17460
"AL","2010-02-28",2010,2,59,0,8810,8630,17440
"AL","2010-03-01",2010,3,60,129,8790,8620,17539
"AL","2010-03-02",2010,3,61,0,8780,8630,17410
"AL","2010-03-03",2010,3,62,0,8760,8640,17400
"AL","2010-03-04",2010,3,63,0,8740,8640,17380
"AL","2010-03-05",2010,3,64,0,8730,8660,17390
"AL","2010-03-06",2010,3,65,0,8710,8660,17370
"AL","2010-03-07",2010,3,66,0,8690,8680,17370
"AL","2010-03-08",2010,3,67,0,8680,8710,17390
"AL","2010-03-09",2010,3,68,0,8660,8710,17370
"AL","2010-03-10",2010,3,69,0,8780,9660,18440
"AL","2010-03-11",2010,3,70,0,10400,12200,22600
"AL","2010-03-12",2010,3,71,2370,15200,24800,42370
"AL","2010-03-13",2010,3,72,12700,18500,25300,56500
"AL","2010-03-14",2010,3,73,442,11200,9970,21612
"AL","2010-03-15",2010,3,74,0,10500,9010,19510
"AL","2010-03-16",2010,3,75,0,10300,8990,19290
"AL","2010-03-17",2010,3,76,0,10200,8910,19110
"AL","2010-03-18",2010,3,77,0,10000,8900,18900
"AL","2010-03-19",2010,3,78,0,9830,8910,18740
"AL","2010-03-20",2010,3,79,0,9680,8910,18590
"AL","2010-03-21",2010,3,80,0,9550,8860,18410
"AL","2010-03-22",2010,3,81,0,9440,8830,18270
"AL","2010-03-23",2010,3,82,0,9360,8870,18230
"AL","2010-03-24",2010,3,83,0,9280,8910,18190
"AL","2010-03-25",2010,3,84,0,9210,8930,18140
"AL","2010-03-26",2010,3,85,0,9140,8940,18080
"AL","2010-03-27",2010,3,86,0,9080,8880,17960
"AL","2010-03-28",2010,3,87,0,9040,8850,17890
"AL","2010-03-29",2010,3,88,1390,9070,8860,19320
"AL","2010-03-30",2010,3,89,237,8940,8830,18007
"AL","2010-03-31",2010,3,90,0,8890,8870,17760
"AL","2010-04-01",2010,4,91,0,8860,8890,17750
"AL","2010-04-02",2010,4,92,0,8830,8860,17690
"AL","2010-04-03",2010,4,93,0,8810,8830,17640
"AL","2010-04-04",2010,4,94,427,8800,8820,18047
"AL","2010-04-05",2010,4,95,71.3,8760,8780,17611.3
"AL","2010-04-06",2010,4,96,2120,8920,8800,19840
"AL","2010-04-07",2010,4,97,0,8660,8730,17390
"AL","2010-04-08",2010,4,98,142,8640,8720,17502
"AL","2010-04-09",2010,4,99,0,8620,8690,17310
"AL","2010-04-10",2010,4,100,0,8600,8660,17260
"AL","2010-04-11",2010,4,101,0,8590,8640,17230
"AL","2010-04-12",2010,4,102,0,8570,8630,17200
"AL","2010-04-13",2010,4,103,0,8560,8620,17180
"AL","2010-04-14",2010,4,104,1850,8630,8630,19110
"AL","2010-04-15",2010,4,105,569,8580,8600,17749
"AL","2010-04-16",2010,4,106,9350,9530,8980,27860
"AL","2010-04-17",2010,4,107,4430,9050,8450,21930
"AL","2010-04-18",2010,4,108,0,8570,8380,16950
"AL","2010-04-19",2010,4,109,0,8520,8360,16880
"AL","2010-04-20",2010,4,110,0,8500,8360,16860
"AL","2010-04-21",2010,4,111,0,8480,8370,16850
"AL","2010-04-22",2010,4,112,0,8460,8380,16840
"AL","2010-04-23",2010,4,113,0,8440,8370,16810
"AL","2010-04-24",2010,4,114,0,8420,8370,16790
"AL","2010-04-25",2010,4,115,1470,8460,8380,18310
"AL","2010-04-26",2010,4,116,6150,9220,8540,23910
"AL","2010-04-27",2010,4,117,0,8420,8280,16700
"AL","2010-04-28",2010,4,118,0,8390,8270,16660
"AL","2010-04-29",2010,4,119,0,8370,8270,16640
"AL","2010-04-30",2010,4,120,0,8360,8280,16640
"AL","2010-05-01",2010,5,121,8260,9370,8410,26040
"AL","2010-05-02",2010,5,122,49300,19400,24500,93200
"AL","2010-05-03",2010,5,123,0,9710,8340,18050
"AL","2010-05-04",2010,5,124,0,9390,7960,17350
"AL","2010-05-05",2010,5,125,254,9330,7990,17574
"AL","2010-05-06",2010,5,126,13600,11200,8440,33240
"AL","2010-05-07",2010,5,127,1340,9490,7950,18780
"AL","2010-05-08",2010,5,128,0,9160,8000,17160
"AL","2010-05-09",2010,5,129,34500,9830,7630,51960
"AL","2010-05-10",2010,5,130,0,9510,8070,17580
"AL","2010-05-11",2010,5,131,0,11400,12700,24100
"AL","2010-05-12",2010,5,132,0,9750,8780,18530
"AL","2010-05-13",2010,5,133,6160,9620,8180,23960
"AL","2010-05-14",2010,5,134,5630,9580,8610,23820
"AL","2010-05-15",2010,5,135,18200,12600,13800,44600
"AL","2010-05-16",2010,5,136,1960,9490,7950,19400
"AL","2010-05-17",2010,5,137,0,9040,8130,17170
"AL","2010-05-18",2010,5,138,0,8660,8200,16860
"AL","2010-05-19",2010,5,139,0,8270,8200,16470
"AL","2010-05-20",2010,5,140,0,8150,8180,16330
"AL","2010-05-21",2010,5,141,0,8060,8180,16240
"AL","2010-05-22",2010,5,142,369,8000,8180,16549
"AL","2010-05-23",2010,5,143,2310,8020,8110,18440
"AL","2010-05-24",2010,5,144,0,7910,8090,16000
"AL","2010-05-25",2010,5,145,0,7860,8120,15980
"AL","2010-05-26",2010,5,146,0,7820,8140,15960
"AL","2010-05-27",2010,5,147,4150,7930,8100,20180
"AL","2010-05-28",2010,5,148,0,7760,8090,15850
"AL","2010-05-29",2010,5,149,0,7720,8130,15850
"AL","2010-05-30",2010,5,150,0,7690,8170,15860
"AL","2010-05-31",2010,5,151,11100,8280,8060,27440
"AL","2010-06-01",2010,6,152,12700,8780,7920,29400
"AL","2010-06-02",2010,6,153,0,7690,7870,15560
"AL","2010-06-03",2010,6,154,23000,9730,7740,40470
"AL","2010-06-04",2010,6,155,714,8140,7600,16454
"AL","2010-06-05",2010,6,156,5180,8310,7720,21210
"AL","2010-06-06",2010,6,157,31000,11000,7550,49550
"AL","2010-06-07",2010,6,158,16100,10100,7470,33670
"AL","2010-06-08",2010,6,159,0,8570,7470,16040
"AL","2010-06-09",2010,6,160,0,8400,7680,16080
"AL","2010-06-10",2010,6,161,95200,27700,35300,158200
"AL","2010-06-11",2010,6,162,9530,12700,12900,35130
"AL","2010-06-12",2010,6,163,3130,10600,8090,21820
"AL","2010-06-13",2010,6,164,64300,24800,33100,122200
"AL","2010-06-14",2010,6,165,4440,12500,10700,27640
"AL","2010-06-15",2010,6,166,15300,13400,12600,41300
"AL","2010-06-16",2010,6,167,1590,11300,8810,21700
"AL","2010-06-17",2010,6,168,30500,17100,17800,65400
"AL","2010-06-18",2010,6,169,0,11300,8900,20200
"AL","2010-06-19",2010,6,170,0,10900,9170,20070
"AL","2010-06-20",2010,6,171,0,10300,9140,19440
"AL","2010-06-21",2010,6,172,0,9860,9070,18930
"AL","2010-06-22",2010,6,173,0,9590,9050,18640
"AL","2010-06-23",2010,6,174,69100,20800,21200,111100
"AL","2010-06-24",2010,6,175,41600,21500,25200,88300
"AL","2010-06-25",2010,6,176,32100,19000,21900,73000
"AL","2010-06-26",2010,6,177,9890,13400,11700,34990
"AL","2010-06-27",2010,6,178,79400,36900,43300,159600
"AL","2010-06-28",2010,6,179,7870,16600,17000,41470
"AL","2010-06-29",2010,6,180,4780,14100,11700,30580
"AL","2010-06-30",2010,6,181,1010,13200,11400,25610
"AL","2010-07-01",2010,7,182,0,12900,11500,24400
"AL","2010-07-02",2010,7,183,0,12600,11600,24200
"AL","2010-07-03",2010,7,184,0,12100,11500,23600
"AL","2010-07-04",2010,7,185,0,11600,11400,23000
"AL","2010-07-05",2010,7,186,0,11300,11200,22500
"AL","2010-07-06",2010,7,187,25600,14200,11200,51000
"AL","2010-07-07",2010,7,188,35800,18200,12600,66600
"AL","2010-07-08",2010,7,189,2580,12700,11000,26280
"AL","2010-07-09",2010,7,190,17900,15200,12200,45300
"AL","2010-07-10",2010,7,191,0,12300,11000,23300
"AL","2010-07-11",2010,7,192,0,11800,11100,22900
"AL","2010-07-12",2010,7,193,686,11400,11000,23086
"AL","2010-07-13",2010,7,194,14400,12400,10900,37700
"AL","2010-07-14",2010,7,195,0,11400,10800,22200
"AL","2010-07-15",2010,7,196,21600,13200,11200,46000
"AL","2010-07-16",2010,7,197,89600,35600,41200,166400
"AL","2010-07-17",2010,7,198,0,14200,14600,28800
"AL","2010-07-18",2010,7,199,0,13300,11300,24600
"AL","2010-07-19",2010,7,200,9140,13900,11500,34540
"AL","2010-07-20",2010,7,201,10600,14400,11600,36600
"AL","2010-07-21",2010,7,202,0,12900,11400,24300
"AL","2010-07-22",2010,7,203,321,12500,11500,24321
"AL","2010-07-23",2010,7,204,0,12100,11400,23500
"AL","2010-07-24",2010,7,205,1520,11800,11300,24620
"AL","2010-07-25",2010,7,206,4610,12100,11300,28010
"AL","2010-07-26",2010,7,207,1870,11800,11200,24870
"AL","2010-07-27",2010,7,208,0,11500,11200,22700
"AL","2010-07-28",2010,7,209,263,11400,11200,22863
"AL","2010-07-29",2010,7,210,47400,17600,12000,77000
"AL","2010-07-30",2010,7,211,0,12700,10800,23500
"AL","2010-07-31",2010,7,212,0,12400,11100,23500
"AL","2010-08-01",2010,8,213,4140,12200,11100,27440
"AL","2010-08-02",2010,8,214,5230,12400,11100,28730
"AL","2010-08-03",2010,8,215,50100,21000,17700,88800
"AL","2010-08-04",2010,8,216,967,13300,10900,25167
"AL","2010-08-05",2010,8,217,9590,14000,11500,35090
"AL","2010-08-06",2010,8,218,526,12500,11200,24226
"AL","2010-08-07",2010,8,219,0,12100,11200,23300
"AL","2010-08-08",2010,8,220,0,12100,11100,23200
"AL","2010-08-09",2010,8,221,1e+05,37100,41800,178900
"AL","2010-08-10",2010,8,222,0,15000,14500,29500
"AL","2010-08-11",2010,8,223,0,14200,11600,25800
"AL","2010-08-12",2010,8,224,19800,17100,13900,50800
"AL","2010-08-13",2010,8,225,0,14300,11700,26000
"AL","2010-08-14",2010,8,226,7850,14400,11900,34150
"AL","2010-08-15",2010,8,227,51900,26800,29800,108500
"AL","2010-08-16",2010,8,228,20600,20700,20600,61900
"AL","2010-08-17",2010,8,229,2720,15600,12500,30820
"AL","2010-08-18",2010,8,230,0,14800,12500,27300
"AL","2010-08-19",2010,8,231,0,14500,12500,27000
"AL","2010-08-20",2010,8,232,21000,17200,14500,52700
"AL","2010-08-21",2010,8,233,19400,19300,19000,57700
"AL","2010-08-22",2010,8,234,116000,53700,64400,234100
"AL","2010-08-23",2010,8,235,0,20700,25900,46600
"AL","2010-08-24",2010,8,236,0,17200,15000,32200
"AL","2010-08-25",2010,8,237,0,16300,14000,30300
"AL","2010-08-26",2010,8,238,967,15900,14200,31067
"AL","2010-08-27",2010,8,239,0,15600,14200,29800
"AL","2010-08-28",2010,8,240,0,15300,14100,29400
"AL","2010-08-29",2010,8,241,0,14900,14000,28900
"AL","2010-08-30",2010,8,242,0,14600,13800,28400
"AL","2010-08-31",2010,8,243,0,14300,13600,27900
"AL","2010-09-01",2010,9,244,526,14000,13500,28026
"AL","2010-09-02",2010,9,245,8520,14800,13300,36620
"AL","2010-09-03",2010,9,246,1100,14200,13200,28500
"AL","2010-09-04",2010,9,247,12200,15600,13300,41100
"AL","2010-09-05",2010,9,248,6160,15300,13200,34660
"AL","2010-09-06",2010,9,249,0,14500,13100,27600
"AL","2010-09-07",2010,9,250,0,14400,13100,27500
"AL","2010-09-08",2010,9,251,8600,15100,13100,36800
"AL","2010-09-09",2010,9,252,5390,15000,13100,33490
"AL","2010-09-10",2010,9,253,247,14300,13000,27547
"AL","2010-09-11",2010,9,254,0,14000,13000,27000
"AL","2010-09-12",2010,9,255,19300,17100,13500,49900
"AL","2010-09-13",2010,9,256,3310,15000,12900,31210
"AL","2010-09-14",2010,9,257,1070,14400,13000,28470
"AL","2010-09-15",2010,9,258,0,14000,12900,26900
"AL","2010-09-16",2010,9,259,0,14000,12900,26900
"AL","2010-09-17",2010,9,260,98200,39700,36400,174300
"AL","2010-09-18",2010,9,261,1020,16600,15100,32720
"AL","2010-09-19",2010,9,262,1950,16300,13800,32050
"AL","2010-09-20",2010,9,263,0,16100,13700,29800
"AL","2010-09-21",2010,9,264,0,16100,13700,29800
"AL","2010-09-22",2010,9,265,6620,16600,14000,37220
"AL","2010-09-23",2010,9,266,1060,15900,13700,30660
"AL","2010-09-24",2010,9,267,4990,16300,13700,34990
"AL","2010-09-25",2010,9,268,115000,53800,64400,233200
"AL","2010-09-26",2010,9,269,5810,23500,29900,59210
"AL","2010-09-27",2010,9,270,0,19300,18700,38000
"AL","2010-09-28",2010,9,271,0,18100,15800,33900
"AL","2010-09-29",2010,9,272,0,17600,15200,32800
"AL","2010-09-30",2010,9,273,0,17300,15300,32600
"AL","2010-10-01",2010,10,274,2600,17100,15300,35000
"AL","2010-10-02",2010,10,275,0,16600,15200,31800
"AL","2010-10-03",2010,10,276,7740,17300,15300,40340
"AL","2010-10-04",2010,10,277,2340,17300,15700,35340
"AL","2010-10-05",2010,10,278,0,16600,15000,31600
"AL","2010-10-06",2010,10,279,0,16300,14900,31200
"AL","2010-10-07",2010,10,280,0,15900,14700,30600
"AL","2010-10-08",2010,10,281,0,16000,14600,30600
"AL","2010-10-09",2010,10,282,0,16000,14500,30500
"AL","2010-10-10",2010,10,283,0,16000,14500,30500
"AL","2010-10-11",2010,10,284,0,16000,14400,30400
"AL","2010-10-12",2010,10,285,0,15900,14300,30200
"AL","2010-10-13",2010,10,286,0,15900,14200,30100
"AL","2010-10-14",2010,10,287,4240,16500,14300,35040
"AL","2010-10-15",2010,10,288,0,15700,14000,29700
"AL","2010-10-16",2010,10,289,0,15600,13900,29500
"AL","2010-10-17",2010,10,290,0,15600,13900,29500
"AL","2010-10-18",2010,10,291,0,15500,13900,29400
"AL","2010-10-19",2010,10,292,0,15500,13800,29300
"AL","2010-10-20",2010,10,293,0,15400,13800,29200
"AL","2010-10-21",2010,10,294,0,15400,13700,29100
"AL","2010-10-22",2010,10,295,821,15300,13700,29821
"AL","2010-10-23",2010,10,296,198,15300,13700,29198
"AL","2010-10-24",2010,10,297,0,15200,13600,28800
"AL","2010-10-25",2010,10,298,25300,20900,18300,64500
"AL","2010-10-26",2010,10,299,21000,22300,23500,66800
"AL","2010-10-27",2010,10,300,24200,23700,25800,73700
"AL","2010-10-28",2010,10,301,29000,26300,29000,84300
"AL","2010-10-29",2010,10,302,8330,20100,19800,48230
"AL","2010-10-30",2010,10,303,0,17700,15400,33100
"AL","2010-10-31",2010,10,304,0,17100,15000,32100
"AL","2010-11-01",2010,11,305,0,16800,14900,31700
"AL","2010-11-02",2010,11,306,0,16700,14900,31600
"AL","2010-11-03",2010,11,307,0,16500,14700,31200
"AL","2010-11-04",2010,11,308,793,16400,14600,31793
"AL","2010-11-05",2010,11,309,2920,16600,14400,33920
"AL","2010-11-06",2010,11,310,0,15900,14200,30100
"AL","2010-11-07",2010,11,311,0,15900,14200,30100
"AL","2010-11-08",2010,11,312,0,15800,14200,30000
"AL","2010-11-09",2010,11,313,0,15700,14200,29900
"AL","2010-11-10",2010,11,314,0,15600,14100,29700
"AL","2010-11-11",2010,11,315,0,15600,14100,29700
"AL","2010-11-12",2010,11,316,0,15500,14000,29500
"AL","2010-11-13",2010,11,317,0,15400,14000,29400
"AL","2010-11-14",2010,11,318,2720,15500,14000,32220
"AL","2010-11-15",2010,11,319,20700,19900,17800,58400
"AL","2010-11-16",2010,11,320,4880,15900,14200,34980
"AL","2010-11-17",2010,11,321,0,15700,14200,29900
"AL","2010-11-18",2010,11,322,0,15800,14700,30500
"AL","2010-11-19",2010,11,323,0,15300,13900,29200
"AL","2010-11-20",2010,11,324,0,15200,13700,28900
"AL","2010-11-21",2010,11,325,0,15200,13600,28800
"AL","2010-11-22",2010,11,326,230,15100,13600,28930
"AL","2010-11-23",2010,11,327,2150,15100,13500,30750
"AL","2010-11-24",2010,11,328,5190,15000,13500,33690
"AL","2010-11-25",2010,11,329,6230,15000,13400,34630
"AL","2010-11-26",2010,11,330,14600,14900,13200,42700
"AL","2010-11-27",2010,11,331,230,14800,13300,28330
"AL","2010-11-28",2010,11,332,0,14800,13400,28200
"AL","2010-11-29",2010,11,333,0,14700,13500,28200
"AL","2010-11-30",2010,11,334,0,14700,13500,28200
"AL","2010-12-01",2010,12,335,10000,14700,13500,38200
"AL","2010-12-02",2010,12,336,468,15000,13800,29268
"AL","2010-12-03",2010,12,337,1020,14700,13500,29220
"AL","2010-12-04",2010,12,338,0,14600,13400,28000
"AL","2010-12-05",2010,12,339,305,14500,13400,28205
"AL","2010-12-06",2010,12,340,2640,14400,13400,30440
"AL","2010-12-07",2010,12,341,1350,14400,13300,29050
"AL","2010-12-08",2010,12,342,709,14300,13300,28309
"AL","2010-12-09",2010,12,343,370,14300,13300,27970
"AL","2010-12-10",2010,12,344,0,14200,13300,27500
"AL","2010-12-11",2010,12,345,7130,14200,13200,34530
"AL","2010-12-12",2010,12,346,1580,14100,13200,28880
"AL","2010-12-13",2010,12,347,10100,14100,13000,37200
"AL","2010-12-14",2010,12,348,52.7,14100,13000,27152.7
"AL","2010-12-15",2010,12,349,0,14000,13100,27100
"AL","2010-12-16",2010,12,350,0,14000,13100,27100
"AL","2010-12-17",2010,12,351,0,13900,13100,27000
"AL","2010-12-18",2010,12,352,0,13900,13100,27000
"AL","2010-12-19",2010,12,353,0,13900,13000,26900
"AL","2010-12-20",2010,12,354,159,13800,13000,26959
"AL","2010-12-21",2010,12,355,0,13800,13000,26800
"AL","2010-12-22",2010,12,356,6350,13700,12900,32950
"AL","2010-12-23",2010,12,357,5990,13700,12800,32490
"AL","2010-12-24",2010,12,358,0,13700,12800,26500
"AL","2010-12-25",2010,12,359,0,13600,12800,26400
"AL","2010-12-26",2010,12,360,0,13600,12800,26400
"AL","2010-12-27",2010,12,361,347,13500,12800,26647
"AL","2010-12-28",2010,12,362,0,13500,12800,26300
"AL","2010-12-29",2010,12,363,0,13500,12800,26300
"AL","2010-12-30",2010,12,364,0,13400,12700,26100
"AL","2010-12-31",2010,12,365,319,13400,12700,26419
"AL","2011-01-01",2011,1,1,5780,13300,12600,31680
"AL","2011-01-02",2011,1,2,0,13300,12600,25900
"AL","2011-01-03",2011,1,3,822,13300,12600,26722
"AL","2011-01-04",2011,1,4,0,13200,12500,25700
"AL","2011-01-05",2011,1,5,2040,13200,12500,27740
"AL","2011-01-06",2011,1,6,0,13100,12500,25600
"AL","2011-01-07",2011,1,7,1900,13100,12400,27400
"AL","2011-01-08",2011,1,8,624,13100,12400,26124
"AL","2011-01-09",2011,1,9,0,13000,12400,25400
"AL","2011-01-10",2011,1,10,1370,13000,12300,26670
"AL","2011-01-11",2011,1,11,0,13000,12300,25300
"AL","2011-01-12",2011,1,12,1180,12900,12300,26380
"AL","2011-01-13",2011,1,13,4740,12900,12200,29840
"AL","2011-01-14",2011,1,14,1230,12900,12200,26330
"AL","2011-01-15",2011,1,15,1460,12900,12200,26560
"AL","2011-01-16",2011,1,16,11700,12800,12000,36500
"AL","2011-01-17",2011,1,17,0,12800,12000,24800
"AL","2011-01-18",2011,1,18,0,12800,12100,24900
"AL","2011-01-19",2011,1,19,2990,12700,12000,27690
"AL","2011-01-20",2011,1,20,0,12700,12000,24700
"AL","2011-01-21",2011,1,21,0,12700,12000,24700
"AL","2011-01-22",2011,1,22,0,12600,12000,24600
"AL","2011-01-23",2011,1,23,0,12600,12000,24600
"AL","2011-01-24",2011,1,24,0,12600,12000,24600
"AL","2011-01-25",2011,1,25,254,12500,12000,24754
"AL","2011-01-26",2011,1,26,431,12500,11900,24831
"AL","2011-01-27",2011,1,27,127,12500,11900,24527
"AL","2011-01-28",2011,1,28,615,12500,11900,25015
"AL","2011-01-29",2011,1,29,3460,12400,11800,27660
"AL","2011-01-30",2011,1,30,14800,12400,11600,38800
"AL","2011-01-31",2011,1,31,726,12400,11600,24726
"AL","2011-02-01",2011,2,32,1780,12300,11600,25680
"AL","2011-02-02",2011,2,33,1780,12300,11600,25680
"AL","2011-02-03",2011,2,34,0,12300,11600,23900
"AL","2011-02-04",2011,2,35,0,12200,11600,23800
"AL","2011-02-05",2011,2,36,0,12200,11700,23900
"AL","2011-02-06",2011,2,37,844,12200,11600,24644
"AL","2011-02-07",2011,2,38,0,12100,11700,23800
"AL","2011-02-08",2011,2,39,886,12100,11600,24586
"AL","2011-02-09",2011,2,40,191,12100,11600,23891
"AL","2011-02-10",2011,2,41,0,12100,11600,23700
"AL","2011-02-11",2011,2,42,0,12000,11600,23600
"AL","2011-02-12",2011,2,43,0,12000,11600,23600
"AL","2011-02-13",2011,2,44,0,12000,11600,23600
"AL","2011-02-14",2011,2,45,1730,11900,11500,25130
"AL","2011-02-15",2011,2,46,294,11900,11500,23694
"AL","2011-02-16",2011,2,47,0,11900,11500,23400
"AL","2011-02-17",2011,2,48,0,11900,11500,23400
"AL","2011-02-18",2011,2,49,0,11800,11500,23300
"AL","2011-02-19",2011,2,50,0,11800,11500,23300
"AL","2011-02-20",2011,2,51,0,11800,11500,23300
"AL","2011-02-21",2011,2,52,0,11700,11500,23200
"AL","2011-02-22",2011,2,53,247,11700,11400,23347
"AL","2011-02-23",2011,2,54,0,11700,11400,23100
"AL","2011-02-24",2011,2,55,0,11600,11400,23000
"AL","2011-02-25",2011,2,56,0,11600,11400,23000
"AL","2011-02-26",2011,2,57,115,11600,11400,23115
"AL","2011-02-27",2011,2,58,0,11600,11300,22900
"AL","2011-02-28",2011,2,59,1970,11500,11300,24770
"AL","2011-03-01",2011,3,60,232,11500,11200,22932
"AL","2011-03-02",2011,3,61,0,11500,11200,22700
"AL","2011-03-03",2011,3,62,0,11400,11300,22700
"AL","2011-03-04",2011,3,63,0,11400,11200,22600
"AL","2011-03-05",2011,3,64,1950,11400,11200,24550
"AL","2011-03-06",2011,3,65,0,11400,11200,22600
"AL","2011-03-07",2011,3,66,0,11300,11200,22500
"AL","2011-03-08",2011,3,67,4670,11300,11100,27070
"AL","2011-03-09",2011,3,68,6150,11300,11000,28450
"AL","2011-03-10",2011,3,69,0,11200,11000,22200
"AL","2011-03-11",2011,3,70,9050,11200,10800,31050
"AL","2011-03-12",2011,3,71,0,11200,10900,22100
"AL","2011-03-13",2011,3,72,7600,11200,10800,29600
"AL","2011-03-14",2011,3,73,6330,11100,10700,28130
"AL","2011-03-15",2011,3,74,1610,11100,10700,23410
"AL","2011-03-16",2011,3,75,0,11100,10800,21900
"AL","2011-03-17",2011,3,76,0,11100,10900,22000
"AL","2011-03-18",2011,3,77,0,11000,10900,21900
"AL","2011-03-19",2011,3,78,0,11000,10900,21900
"AL","2011-03-20",2011,3,79,0,11000,10900,21900
"AL","2011-03-21",2011,3,80,2550,12100,13300,27950
"AL","2011-03-22",2011,3,81,34800,12200,12700,59700
"AL","2011-03-23",2011,3,82,0,11500,11500,23000
"AL","2011-03-24",2011,3,83,45300,11200,10100,66600
"AL","2011-03-25",2011,3,84,7200,11100,9990,28290
"AL","2011-03-26",2011,3,85,0,11100,10300,21400
"AL","2011-03-27",2011,3,86,0,11100,10400,21500
"AL","2011-03-28",2011,3,87,0,11000,10500,21500
"AL","2011-03-29",2011,3,88,0,11000,10500,21500
"AL","2011-03-30",2011,3,89,0,10900,10600,21500
"AL","2011-03-31",2011,3,90,0,10900,10600,21500
"AL","2011-04-01",2011,4,91,0,10900,10700,21600
"AL","2011-04-02",2011,4,92,0,10800,10700,21500
"AL","2011-04-03",2011,4,93,2760,10800,10700,24260
"AL","2011-04-04",2011,4,94,3370,10800,10900,25070
"AL","2011-04-05",2011,4,95,11300,11500,13200,36000
"AL","2011-04-06",2011,4,96,1630,11200,11000,23830
"AL","2011-04-07",2011,4,97,0,12300,13400,25700
"AL","2011-04-08",2011,4,98,0,12900,15000,27900
"AL","2011-04-09",2011,4,99,0,14400,17600,32000
"AL","2011-04-10",2011,4,100,0,15600,19600,35200
"AL","2011-04-11",2011,4,101,15100,111000,145000,271100
"AL","2011-04-12",2011,4,102,4940,36400,43100,84440
"AL","2011-04-13",2011,4,103,0,16400,17300,33700
"AL","2011-04-14",2011,4,104,0,14100,12300,26400
"AL","2011-04-15",2011,4,105,0,13900,12100,26000
"AL","2011-04-16",2011,4,106,0,13700,12300,26000
"AL","2011-04-17",2011,4,107,838,13600,12400,26838
"AL","2011-04-18",2011,4,108,16400,13500,12100,42000
"AL","2011-04-19",2011,4,109,460,13200,12200,25860
"AL","2011-04-20",2011,4,110,0,13000,12300,25300
"AL","2011-04-21",2011,4,111,1250,14100,14300,29650
"AL","2011-04-22",2011,4,112,314,13000,12200,25514
"AL","2011-04-23",2011,4,113,0,12600,12100,24700
"AL","2011-04-24",2011,4,114,30200,19800,23100,73100
"AL","2011-04-25",2011,4,115,0,13200,12200,25400
"AL","2011-04-26",2011,4,116,0,13000,12000,25000
"AL","2011-04-27",2011,4,117,0,12800,12000,24800
"AL","2011-04-28",2011,4,118,38800,17600,18900,75300
"AL","2011-04-29",2011,4,119,6230,17600,19400,43230
"AL","2011-04-30",2011,4,120,1470,13700,12600,27770
"AL","2011-05-01",2011,5,121,0,13200,12100,25300
"AL","2011-05-02",2011,5,122,13900,15900,15100,44900
"AL","2011-05-03",2011,5,123,1190,13300,12100,26590
"AL","2011-05-04",2011,5,124,219,13000,12000,25219
"AL","2011-05-05",2011,5,125,0,12800,12000,24800
"AL","2011-05-06",2011,5,126,0,12700,12000,24700
"AL","2011-05-07",2011,5,127,7040,13600,11900,32540
"AL","2011-05-08",2011,5,128,0,12500,11700,24200
"AL","2011-05-09",2011,5,129,0,11900,11800,23700
"AL","2011-05-10",2011,5,130,228,11400,11700,23328
"AL","2011-05-11",2011,5,131,2810,11300,11600,25710
"AL","2011-05-12",2011,5,132,23500,14100,12000,49600
"AL","2011-05-13",2011,5,133,33700,19000,19700,72400
"AL","2011-05-14",2011,5,134,18200,17400,17600,53200
"AL","2011-05-15",2011,5,135,0,12900,11600,24500
"AL","2011-05-16",2011,5,136,7840,13600,12100,33540
"AL","2011-05-17",2011,5,137,0,12700,11800,24500
"AL","2011-05-18",2011,5,138,0,12500,11900,24400
"AL","2011-05-19",2011,5,139,0,11900,11800,23700
"AL","2011-05-20",2011,5,140,0,11400,11600,23000
"AL","2011-05-21",2011,5,141,977,11200,11500,23677
"AL","2011-05-22",2011,5,142,0,11100,11500,22600
"AL","2011-05-23",2011,5,143,24700,14100,11600,50400
"AL","2011-05-24",2011,5,144,14900,13800,11700,40400
"AL","2011-05-25",2011,5,145,1450,12200,11300,24950
"AL","2011-05-26",2011,5,146,0,11800,11400,23200
"AL","2011-05-27",2011,5,147,0,11600,11400,23000
"AL","2011-05-28",2011,5,148,0,11400,11400,22800
"AL","2011-05-29",2011,5,149,11600,12400,11400,35400
"AL","2011-05-30",2011,5,150,10100,12700,11300,34100
"AL","2011-05-31",2011,5,151,3240,12100,11300,26640
"AL","2011-06-01",2011,6,152,3120,11900,11300,26320
"AL","2011-06-02",2011,6,153,207,11300,11300,22807
"AL","2011-06-03",2011,6,154,0,11000,11300,22300
"AL","2011-06-04",2011,6,155,0,10900,11300,22200
"AL","2011-06-05",2011,6,156,207,10700,11300,22207
"AL","2011-06-06",2011,6,157,0,10500,11300,21800
"AL","2011-06-07",2011,6,158,0,10400,11200,21600
"AL","2011-06-08",2011,6,159,3690,10500,11100,25290
"AL","2011-06-09",2011,6,160,0,10400,11000,21400
"AL","2011-06-10",2011,6,161,0,10300,11100,21400
"AL","2011-06-11",2011,6,162,0,10300,11000,21300
"AL","2011-06-12",2011,6,163,21400,12500,10700,44600
"AL","2011-06-13",2011,6,164,0,11100,10600,21700
"AL","2011-06-14",2011,6,165,0,11000,10800,21800
"AL","2011-06-15",2011,6,166,0,10400,10800,21200
"AL","2011-06-16",2011,6,167,0,10200,10800,21000
"AL","2011-06-17",2011,6,168,14200,11500,10700,36400
"AL","2011-06-18",2011,6,169,2800,11000,10600,24400
"AL","2011-06-19",2011,6,170,455,10500,10600,21555
"AL","2011-06-20",2011,6,171,44300,15900,11000,71200
"AL","2011-06-21",2011,6,172,9360,12700,10400,32460
"AL","2011-06-22",2011,6,173,10200,12600,10700,33500
"AL","2011-06-23",2011,6,174,97900,37500,47000,182400
"AL","2011-06-24",2011,6,175,13900,18700,22100,54700
"AL","2011-06-25",2011,6,176,2190,14600,12500,29290
"AL","2011-06-26",2011,6,177,0,13600,11700,25300
"AL","2011-06-27",2011,6,178,0,13400,11800,25200
"AL","2011-06-28",2011,6,179,0,12700,11600,24300
"AL","2011-06-29",2011,6,180,13400,13800,11600,38800
"AL","2011-06-30",2011,6,181,0,12600,11500,24100
"AL","2011-07-01",2011,7,182,0,12300,11500,23800
"AL","2011-07-02",2011,7,183,0,11800,11500,23300
"AL","2011-07-03",2011,7,184,487,11600,11500,23587
"AL","2011-07-04",2011,7,185,0,11500,11600,23100
"AL","2011-07-05",2011,7,186,0,11400,11600,23000
"AL","2011-07-06",2011,7,187,0,11200,11600,22800
"AL","2011-07-07",2011,7,188,7660,11800,11500,30960
"AL","2011-07-08",2011,7,189,0,11000,11400,22400
"AL","2011-07-09",2011,7,190,853,11000,11300,23153
"AL","2011-07-10",2011,7,191,0,10900,11300,22200
"AL","2011-07-11",2011,7,192,0,10800,11300,22100
"AL","2011-07-12",2011,7,193,1230,10800,11200,23230
"AL","2011-07-13",2011,7,194,0,10700,11300,22000
"AL","2011-07-14",2011,7,195,0,10700,11200,21900
"AL","2011-07-15",2011,7,196,0,10600,11100,21700
"AL","2011-07-16",2011,7,197,830,10600,11100,22530
"AL","2011-07-17",2011,7,198,3660,10800,11100,25560
"AL","2011-07-18",2011,7,199,0,10500,11100,21600
"AL","2011-07-19",2011,7,200,109000,30800,30300,170100
"AL","2011-07-20",2011,7,201,3940,13000,10700,27640
"AL","2011-07-21",2011,7,202,7050,13300,10700,31050
"AL","2011-07-22",2011,7,203,0,12600,10900,23500
"AL","2011-07-23",2011,7,204,0,12200,11100,23300
"AL","2011-07-24",2011,7,205,0,11700,11000,22700
"AL","2011-07-25",2011,7,206,14600,13000,11000,38600
"AL","2011-07-26",2011,7,207,0,11800,10900,22700
"AL","2011-07-27",2011,7,208,0,11500,11100,22600
"AL","2011-07-28",2011,7,209,10100,12100,11000,33200
"AL","2011-07-29",2011,7,210,23100,14300,10900,48300
"AL","2011-07-30",2011,7,211,197,12000,10900,23097
"AL","2011-07-31",2011,7,212,0,11200,11100,22300
"AL","2011-08-01",2011,8,213,22500,13400,11100,47000
"AL","2011-08-02",2011,8,214,198,11700,11100,22998
"AL","2011-08-03",2011,8,215,33700,15600,11800,61100
"AL","2011-08-04",2011,8,216,95600,36000,41200,172800
"AL","2011-08-05",2011,8,217,198,14900,14900,29998
"AL","2011-08-06",2011,8,218,0,13600,11500,25100
"AL","2011-08-07",2011,8,219,0,13500,11700,25200
"AL","2011-08-08",2011,8,220,17100,15100,11800,44000
"AL","2011-08-09",2011,8,221,198,13500,11600,25298
"AL","2011-08-10",2011,8,222,6260,13800,11800,31860
"AL","2011-08-11",2011,8,223,3830,13400,11700,28930
"AL","2011-08-12",2011,8,224,0,12800,11600,24400
"AL","2011-08-13",2011,8,225,9290,13600,11700,34590
"AL","2011-08-14",2011,8,226,0,12700,11600,24300
"AL","2011-08-15",2011,8,227,12500,13900,11600,38000
"AL","2011-08-16",2011,8,228,0,12700,11500,24200
"AL","2011-08-17",2011,8,229,0,12400,11600,24000
"AL","2011-08-18",2011,8,230,14600,13600,11600,39800
"AL","2011-08-19",2011,8,231,0,12400,11500,23900
"AL","2011-08-20",2011,8,232,8460,12900,11600,32960
"AL","2011-08-21",2011,8,233,4960,12800,11600,29360
"AL","2011-08-22",2011,8,234,692,12000,11500,24192
"AL","2011-08-23",2011,8,235,0,11700,11500,23200
"AL","2011-08-24",2011,8,236,0,11700,11500,23200
"AL","2011-08-25",2011,8,237,20200,13300,11600,45100
"AL","2011-08-26",2011,8,238,0,12100,11300,23400
"AL","2011-08-27",2011,8,239,0,11800,11400,23200
"AL","2011-08-28",2011,8,240,2040,11600,11400,25040
"AL","2011-08-29",2011,8,241,0,11200,11500,22700
"AL","2011-08-30",2011,8,242,0,11000,11500,22500
"AL","2011-08-31",2011,8,243,0,11000,11400,22400
"AL","2011-09-01",2011,9,244,9820,11800,11200,32820
"AL","2011-09-02",2011,9,245,1670,11400,11100,24170
"AL","2011-09-03",2011,9,246,0,11100,11200,22300
"AL","2011-09-04",2011,9,247,371,11000,11200,22571
"AL","2011-09-05",2011,9,248,5030,11300,11100,27430
"AL","2011-09-06",2011,9,249,3100,11300,11100,25500
"AL","2011-09-07",2011,9,250,0,11000,11000,22000
"AL","2011-09-08",2011,9,251,0,11100,11000,22100
"AL","2011-09-09",2011,9,252,0,11000,11000,22000
"AL","2011-09-10",2011,9,253,0,10900,11000,21900
"AL","2011-09-11",2011,9,254,0,10800,11000,21800
"AL","2011-09-12",2011,9,255,0,10600,11000,21600
"AL","2011-09-13",2011,9,256,0,10600,11000,21600
"AL","2011-09-14",2011,9,257,0,10500,11000,21500
"AL","2011-09-15",2011,9,258,2310,10500,10900,23710
"AL","2011-09-16",2011,9,259,1820,10700,10800,23320
"AL","2011-09-17",2011,9,260,272,10700,10800,21772
"AL","2011-09-18",2011,9,261,0,10700,10800,21500
"AL","2011-09-19",2011,9,262,0,10800,10800,21600
"AL","2011-09-20",2011,9,263,11500,11900,10700,34100
"AL","2011-09-21",2011,9,264,0,11200,10700,21900
"AL","2011-09-22",2011,9,265,872,11100,10800,22772
"AL","2011-09-23",2011,9,266,8680,11800,10700,31180
"AL","2011-09-24",2011,9,267,1470,11400,10700,23570
"AL","2011-09-25",2011,9,268,2510,11400,10800,24710
"AL","2011-09-26",2011,9,269,1450,11200,10800,23450
"AL","2011-09-27",2011,9,270,136,11000,10800,21936
"AL","2011-09-28",2011,9,271,6820,11600,10700,29120
"AL","2011-09-29",2011,9,272,3060,11600,10800,25460
"AL","2011-09-30",2011,9,273,136,11200,10800,22136
"AL","2011-10-01",2011,10,274,10500,12100,10900,33500
"AL","2011-10-02",2011,10,275,3210,11900,10900,26010
"AL","2011-10-03",2011,10,276,0,11300,10700,22000
"AL","2011-10-04",2011,10,277,0,11200,10700,21900
"AL","2011-10-05",2011,10,278,0,10900,10700,21600
"AL","2011-10-06",2011,10,279,0,10700,10700,21400
"AL","2011-10-07",2011,10,280,0,10500,10700,21200
"AL","2011-10-08",2011,10,281,0,10600,10700,21300
"AL","2011-10-09",2011,10,282,0,10700,10800,21500
"AL","2011-10-10",2011,10,283,0,10800,10800,21600
"AL","2011-10-11",2011,10,284,0,10900,10800,21700
"AL","2011-10-12",2011,10,285,166,11000,10800,21966
"AL","2011-10-13",2011,10,286,679,11000,10900,22579
"AL","2011-10-14",2011,10,287,18100,13200,11400,42700
"AL","2011-10-15",2011,10,288,36100,17200,12100,65400
"AL","2011-10-16",2011,10,289,2380,12500,10800,25680
"AL","2011-10-17",2011,10,290,0,12100,10600,22700
"AL","2011-10-18",2011,10,291,0,12100,10600,22700
"AL","2011-10-19",2011,10,292,331,12100,10600,23031
"AL","2011-10-20",2011,10,293,2850,12300,10600,25750
"AL","2011-10-21",2011,10,294,3190,12200,10500,25890
"AL","2011-10-22",2011,10,295,1270,11900,10500,23670
"AL","2011-10-23",2011,10,296,0,11700,10500,22200
"AL","2011-10-24",2011,10,297,166,11700,10500,22366
"AL","2011-10-25",2011,10,298,8770,12700,10700,32170
"AL","2011-10-26",2011,10,299,331,11800,10500,22631
"AL","2011-10-27",2011,10,300,14400,14300,12300,41000
"AL","2011-10-28",2011,10,301,1720,12300,11000,25020
"AL","2011-10-29",2011,10,302,0,11800,10400,22200
"AL","2011-10-30",2011,10,303,2090,11900,10500,24490
"AL","2011-10-31",2011,10,304,0,11700,10500,22200
"AL","2011-11-01",2011,11,305,2620,11900,10500,25020
"AL","2011-11-02",2011,11,306,198,11600,10500,22298
"AL","2011-11-03",2011,11,307,3050,11900,10500,25450
"AL","2011-11-04",2011,11,308,188,11500,10300,21988
"AL","2011-11-05",2011,11,309,0,11500,10300,21800
"AL","2011-11-06",2011,11,310,0,11400,10300,21700
"AL","2011-11-07",2011,11,311,0,11400,10400,21800
"AL","2011-11-08",2011,11,312,0,11400,10400,21800
"AL","2011-11-09",2011,11,313,0,11300,10400,21700
"AL","2011-11-10",2011,11,314,0,11300,10400,21700
"AL","2011-11-11",2011,11,315,7510,11300,10300,29110
"AL","2011-11-12",2011,11,316,7880,11300,10100,29280
"AL","2011-11-13",2011,11,317,0,11200,10200,21400
"AL","2011-11-14",2011,11,318,0,12100,10800,22900
"AL","2011-11-15",2011,11,319,0,11500,10400,21900
"AL","2011-11-16",2011,11,320,0,11200,10300,21500
"AL","2011-11-17",2011,11,321,0,11200,10300,21500
"AL","2011-11-18",2011,11,322,1210,11200,10200,22610
"AL","2011-11-19",2011,11,323,0,11100,10100,21200
"AL","2011-11-20",2011,11,324,0,11100,10200,21300
"AL","2011-11-21",2011,11,325,19800,11100,9800,40700
"AL","2011-11-22",2011,11,326,0,11100,9850,20950
"AL","2011-11-23",2011,11,327,0,11000,9990,20990
"AL","2011-11-24",2011,11,328,0,11000,10000,21000
"AL","2011-11-25",2011,11,329,0,11000,10100,21100
"AL","2011-11-26",2011,11,330,0,11800,10800,22600
"AL","2011-11-27",2011,11,331,9160,13200,12600,34960
"AL","2011-11-28",2011,11,332,6400,13000,12800,32200
"AL","2011-11-29",2011,11,333,230,11600,10300,22130
"AL","2011-11-30",2011,11,334,0,11200,10100,21300
"AL","2011-12-01",2011,12,335,0,11100,10100,21200
"AL","2011-12-02",2011,12,336,5340,11100,9950,26390
"AL","2011-12-03",2011,12,337,7140,11100,9830,28070
"AL","2011-12-04",2011,12,338,0,11000,9940,20940
"AL","2011-12-05",2011,12,339,11400,11000,9780,32180
"AL","2011-12-06",2011,12,340,0,11000,9830,20830
"AL","2011-12-07",2011,12,341,0,10900,9920,20820
"AL","2011-12-08",2011,12,342,0,10900,9950,20850
"AL","2011-12-09",2011,12,343,0,10900,9970,20870
"AL","2011-12-10",2011,12,344,0,10800,9990,20790
"AL","2011-12-11",2011,12,345,0,10800,9990,20790
"AL","2011-12-12",2011,12,346,0,10800,10000,20800
"AL","2011-12-13",2011,12,347,187,11000,10400,21587
"AL","2011-12-14",2011,12,348,2420,11000,10500,23920
"AL","2011-12-15",2011,12,349,2710,12300,13100,28110
"AL","2011-12-16",2011,12,350,20400,15700,19600,55700
"AL","2011-12-17",2011,12,351,2090,11800,10700,24590
"AL","2011-12-18",2011,12,352,0,11500,10000,21500
"AL","2011-12-19",2011,12,353,105,11400,9970,21475
"AL","2011-12-20",2011,12,354,0,11300,10000,21300
"AL","2011-12-21",2011,12,355,0,11200,10000,21200
"AL","2011-12-22",2011,12,356,0,11100,10000,21100
"AL","2011-12-23",2011,12,357,492,11000,10000,21492
"AL","2011-12-24",2011,12,358,0,11000,10000,21000
"AL","2011-12-25",2011,12,359,13400,10900,9780,34080
"AL","2011-12-26",2011,12,360,0,10800,9810,20610
"AL","2011-12-27",2011,12,361,0,10800,9870,20670
"AL","2011-12-28",2011,12,362,129,11200,10800,22129
"AL","2011-12-29",2011,12,363,808,10800,10000,21608
"AL","2011-12-30",2011,12,364,0,10700,9920,20620
"AL","2011-12-31",2011,12,365,4180,10700,9840,24720
"AL","2012-01-01",2012,1,1,0,10600,9860,20460
"AL","2012-01-02",2012,1,2,18100,10600,9550,38250
"AL","2012-01-03",2012,1,3,3910,10600,9500,24010
"AL","2012-01-04",2012,1,4,351,10500,9620,20471
"AL","2012-01-05",2012,1,5,0,10500,9680,20180
"AL","2012-01-06",2012,1,6,0,10500,9720,20220
"AL","2012-01-07",2012,1,7,0,10500,9750,20250
"AL","2012-01-08",2012,1,8,0,10400,9770,20170
"AL","2012-01-09",2012,1,9,0,10400,9780,20180
"AL","2012-01-10",2012,1,10,0,10400,9790,20190
"AL","2012-01-11",2012,1,11,0,10400,9800,20200
"AL","2012-01-12",2012,1,12,0,10300,9800,20100
"AL","2012-01-13",2012,1,13,5410,10300,9690,25400
"AL","2012-01-14",2012,1,14,6510,10300,9570,26380
"AL","2012-01-15",2012,1,15,430,10300,9600,20330
"AL","2012-01-16",2012,1,16,0,10200,9640,19840
"AL","2012-01-17",2012,1,17,0,10200,9660,19860
"AL","2012-01-18",2012,1,18,468,10200,9670,20338
"AL","2012-01-19",2012,1,19,3480,10200,9600,23280
"AL","2012-01-20",2012,1,20,2130,10100,9560,21790
"AL","2012-01-21",2012,1,21,0,10100,9580,19680
"AL","2012-01-22",2012,1,22,0,10100,9600,19700
"AL","2012-01-23",2012,1,23,0,10100,9600,19700
"AL","2012-01-24",2012,1,24,10600,10100,9410,30110
"AL","2012-01-25",2012,1,25,11900,10000,9220,31120
"AL","2012-01-26",2012,1,26,1520,10000,9280,20800
"AL","2012-01-27",2012,1,27,0,10000,9390,19390
"AL","2012-01-28",2012,1,28,0,9990,9430,19420
"AL","2012-01-29",2012,1,29,5430,9980,9350,24760
"AL","2012-01-30",2012,1,30,176,9960,9370,19506
"AL","2012-01-31",2012,1,31,508,9940,9410,19858
"AL","2012-02-01",2012,2,32,215,9920,9430,19565
"AL","2012-02-02",2012,2,33,0,9900,9450,19350
"AL","2012-02-03",2012,2,34,657,9890,9460,20007
"AL","2012-02-04",2012,2,35,0,9870,9460,19330
"AL","2012-02-05",2012,2,36,0,9850,9470,19320
"AL","2012-02-06",2012,2,37,0,9830,9470,19300
"AL","2012-02-07",2012,2,38,0,9810,9460,19270
"AL","2012-02-08",2012,2,39,0,9800,9460,19260
"AL","2012-02-09",2012,2,40,0,9780,9450,19230
"AL","2012-02-10",2012,2,41,0,9760,9450,19210
"AL","2012-02-11",2012,2,42,1510,9750,9410,20670
"AL","2012-02-12",2012,2,43,0,9730,9410,19140
"AL","2012-02-13",2012,2,44,0,9710,9400,19110
"AL","2012-02-14",2012,2,45,0,9700,9410,19110
"AL","2012-02-15",2012,2,46,106,9680,9390,19176
"AL","2012-02-16",2012,2,47,375,9670,9380,19425
"AL","2012-02-17",2012,2,48,129,9650,9370,19149
"AL","2012-02-18",2012,2,49,0,9630,9380,19010
"AL","2012-02-19",2012,2,50,621,9620,9350,19591
"AL","2012-02-20",2012,2,51,0,9600,9340,18940
"AL","2012-02-21",2012,2,52,0,9590,9330,18920
"AL","2012-02-22",2012,2,53,0,9580,9330,18910
"AL","2012-02-23",2012,2,54,2840,9560,9270,21670
"AL","2012-02-24",2012,2,55,0,9550,9260,18810
"AL","2012-02-25",2012,2,56,0,9530,9280,18810
"AL","2012-02-26",2012,2,57,1330,9520,9240,20090
"AL","2012-02-27",2012,2,58,0,9510,9230,18740
"AL","2012-02-28",2012,2,59,1200,9490,9220,19910
"AL","2012-02-29",2012,2,60,0,9480,9220,18700
"AL","2012-03-01",2012,3,61,32500,9470,8660,50630
"AL","2012-03-02",2012,3,62,17000,9460,8420,34880
"AL","2012-03-03",2012,3,63,0,9460,8640,18100
"AL","2012-03-04",2012,3,64,13900,9450,8560,31910
"AL","2012-03-05",2012,3,65,474,9440,8640,18554
"AL","2012-03-06",2012,3,66,0,9430,8790,18220
"AL","2012-03-07",2012,3,67,1210,9420,8840,19470
"AL","2012-03-08",2012,3,68,0,9410,8920,18330
"AL","2012-03-09",2012,3,69,6290,9400,8840,24530
"AL","2012-03-10",2012,3,70,3470,9380,8820,21670
"AL","2012-03-11",2012,3,71,0,9370,8910,18280
"AL","2012-03-12",2012,3,72,0,9360,9000,18360
"AL","2012-03-13",2012,3,73,9920,16900,26800,53620
"AL","2012-03-14",2012,3,74,3440,17700,27000,48140
"AL","2012-03-15",2012,3,75,0,13400,15500,28900
"AL","2012-03-16",2012,3,76,0,16300,21300,37600
"AL","2012-03-17",2012,3,77,0,16700,20900,37600
"AL","2012-03-18",2012,3,78,0,13400,15100,28500
"AL","2012-03-19",2012,3,79,0,12100,10300,22400
"AL","2012-03-20",2012,3,80,0,11900,10200,22100
"AL","2012-03-21",2012,3,81,489,11700,10300,22489
"AL","2012-03-22",2012,3,82,0,11400,10300,21700
"AL","2012-03-23",2012,3,83,3540,11600,10300,25440
"AL","2012-03-24",2012,3,84,4610,11700,10200,26510
"AL","2012-03-25",2012,3,85,1540,11200,10100,22840
"AL","2012-03-26",2012,3,86,0,10800,10100,20900
"AL","2012-03-27",2012,3,87,0,10700,10100,20800
"AL","2012-03-28",2012,3,88,1290,10700,10100,22090
"AL","2012-03-29",2012,3,89,0,10600,10100,20700
"AL","2012-03-30",2012,3,90,0,10500,10100,20600
"AL","2012-03-31",2012,3,91,2160,10600,10100,22860
"AL","2012-04-01",2012,4,92,1390,10500,10100,21990
"AL","2012-04-02",2012,4,93,0,10300,10000,20300
"AL","2012-04-03",2012,4,94,3200,10500,10100,23800
"AL","2012-04-04",2012,4,95,9060,11500,10200,30760
"AL","2012-04-05",2012,4,96,142,10300,9770,20212
"AL","2012-04-06",2012,4,97,0,10200,9760,19960
"AL","2012-04-07",2012,4,98,0,10200,9710,19910
"AL","2012-04-08",2012,4,99,0,10100,9700,19800
"AL","2012-04-09",2012,4,100,6340,10900,9810,27050
"AL","2012-04-10",2012,4,101,0,10000,9630,19630
"AL","2012-04-11",2012,4,102,0,10000,9620,19620
"AL","2012-04-12",2012,4,103,0,9980,9620,19600
"AL","2012-04-13",2012,4,104,0,9960,9640,19600
"AL","2012-04-14",2012,4,105,0,9930,9660,19590
"AL","2012-04-15",2012,4,106,3160,10200,9690,23050
"AL","2012-04-16",2012,4,107,1530,10000,9640,21170
"AL","2012-04-17",2012,4,108,3190,10100,9700,22990
"AL","2012-04-18",2012,4,109,6190,10500,9640,26330
"AL","2012-04-19",2012,4,110,27800,13200,13700,54700
"AL","2012-04-20",2012,4,111,18200,16900,20300,55400
"AL","2012-04-21",2012,4,112,0,11100,10100,21200
"AL","2012-04-22",2012,4,113,0,10800,9360,20160
"AL","2012-04-23",2012,4,114,0,10700,9410,20110
"AL","2012-04-24",2012,4,115,0,10600,9410,20010
"AL","2012-04-25",2012,4,116,0,10500,9400,19900
"AL","2012-04-26",2012,4,117,0,10400,9440,19840
"AL","2012-04-27",2012,4,118,7690,11300,9590,28580
"AL","2012-04-28",2012,4,119,512,10300,9430,20242
"AL","2012-04-29",2012,4,120,0,10200,9470,19670
"AL","2012-04-30",2012,4,121,0,10200,9460,19660
"AL","2012-05-01",2012,5,122,10900,11600,9750,32250
"AL","2012-05-02",2012,5,123,1180,10400,9420,21000
"AL","2012-05-03",2012,5,124,19400,14400,13500,47300
"AL","2012-05-04",2012,5,125,12900,12700,12800,38400
"AL","2012-05-05",2012,5,126,19600,15600,15400,50600
"AL","2012-05-06",2012,5,127,1390,11400,9140,21930
"AL","2012-05-07",2012,5,128,21100,15300,14300,50700
"AL","2012-05-08",2012,5,129,72100,31400,39700,143200
"AL","2012-05-09",2012,5,130,0,14100,14400,28500
"AL","2012-05-10",2012,5,131,1960,12600,10200,24760
"AL","2012-05-11",2012,5,132,0,12200,10300,22500
"AL","2012-05-12",2012,5,133,0,11700,10400,22100
"AL","2012-05-13",2012,5,134,923,11000,10300,22223
"AL","2012-05-14",2012,5,135,0,10600,10200,20800
"AL","2012-05-15",2012,5,136,0,10400,10100,20500
"AL","2012-05-16",2012,5,137,0,10200,10100,20300
"AL","2012-05-17",2012,5,138,0,10100,10000,20100
"AL","2012-05-18",2012,5,139,0,9960,9920,19880
"AL","2012-05-19",2012,5,140,2060,9950,9850,21860
"AL","2012-05-20",2012,5,141,0,9810,9860,19670
"AL","2012-05-21",2012,5,142,0,9730,9880,19610
"AL","2012-05-22",2012,5,143,20600,11700,9730,42030
"AL","2012-05-23",2012,5,144,0,10100,9590,19690
"AL","2012-05-24",2012,5,145,0,9920,9710,19630
"AL","2012-05-25",2012,5,146,1850,9750,9710,21310
"AL","2012-05-26",2012,5,147,47900,15400,10400,73700
"AL","2012-05-27",2012,5,148,0,10500,9260,19760
"AL","2012-05-28",2012,5,149,41900,17200,15200,74300
"AL","2012-05-29",2012,5,150,0,11400,9350,20750
"AL","2012-05-30",2012,5,151,4480,11400,9640,25520
"AL","2012-05-31",2012,5,152,7550,11600,9670,28820
"AL","2012-06-01",2012,6,153,0,10900,9640,20540
"AL","2012-06-02",2012,6,154,0,10800,9760,20560
"AL","2012-06-03",2012,6,155,0,10400,9810,20210
"AL","2012-06-04",2012,6,156,0,10000,9770,19770
"AL","2012-06-05",2012,6,157,0,9880,9760,19640
"AL","2012-06-06",2012,6,158,368,9780,9730,19878
"AL","2012-06-07",2012,6,159,2850,9870,9680,22400
"AL","2012-06-08",2012,6,160,0,9630,9690,19320
"AL","2012-06-09",2012,6,161,0,9580,9700,19280
"AL","2012-06-10",2012,6,162,5680,9920,9640,25240
"AL","2012-06-11",2012,6,163,0,9520,9640,19160
"AL","2012-06-12",2012,6,164,1100,9500,9670,20270
"AL","2012-06-13",2012,6,165,0,9460,9710,19170
"AL","2012-06-14",2012,6,166,0,9430,9680,19110
"AL","2012-06-15",2012,6,167,0,9400,9690,19090
"AL","2012-06-16",2012,6,168,49300,14900,9340,73540
"AL","2012-06-17",2012,6,169,313,10700,8980,19993
"AL","2012-06-18",2012,6,170,5890,10900,9330,26120
"AL","2012-06-19",2012,6,171,60000,21500,23000,104500
"AL","2012-06-20",2012,6,172,11300,13500,11000,35800
"AL","2012-06-21",2012,6,173,9800,13200,10100,33100
"AL","2012-06-22",2012,6,174,147000,54500,72700,274200
"AL","2012-06-23",2012,6,175,0,18100,24700,42800
"AL","2012-06-24",2012,6,176,1990,14600,12900,29490
"AL","2012-06-25",2012,6,177,20100,17500,16200,53800
"AL","2012-06-26",2012,6,178,60000,35800,36200,132000
"AL","2012-06-27",2012,6,179,0,16400,13000,29400
"AL","2012-06-28",2012,6,180,0,14900,12400,27300
"AL","2012-06-29",2012,6,181,0,14600,12700,27300
"AL","2012-06-30",2012,6,182,0,14100,12700,26800
"AL","2012-07-01",2012,7,183,0,13700,12500,26200
"AL","2012-07-02",2012,7,184,0,13200,12500,25700
"AL","2012-07-03",2012,7,185,0,12900,12300,25200
"AL","2012-07-04",2012,7,186,44800,20000,12800,77600
"AL","2012-07-05",2012,7,187,656,14100,12000,26756
"AL","2012-07-06",2012,7,188,0,13300,12100,25400
"AL","2012-07-07",2012,7,189,0,12900,12100,25000
"AL","2012-07-08",2012,7,190,34200,17600,12300,64100
"AL","2012-07-09",2012,7,191,0,13100,11600,24700
"AL","2012-07-10",2012,7,192,656,12900,11800,25356
"AL","2012-07-11",2012,7,193,0,12400,11800,24200
"AL","2012-07-12",2012,7,194,0,12300,11700,24000
"AL","2012-07-13",2012,7,195,0,12200,11700,23900
"AL","2012-07-14",2012,7,196,0,12000,11700,23700
"AL","2012-07-15",2012,7,197,1280,11900,11600,24780
"AL","2012-07-16",2012,7,198,17200,13700,11400,42300
"AL","2012-07-17",2012,7,199,0,12400,11300,23700
"AL","2012-07-18",2012,7,200,0,12000,11500,23500
"AL","2012-07-19",2012,7,201,1610,11700,11400,24710
"AL","2012-07-20",2012,7,202,2280,11800,11400,25480
"AL","2012-07-21",2012,7,203,0,11600,11400,23000
"AL","2012-07-22",2012,7,204,0,11600,11400,23000
"AL","2012-07-23",2012,7,205,0,11600,11500,23100
"AL","2012-07-24",2012,7,206,1970,11600,11600,25170
"AL","2012-07-25",2012,7,207,0,11500,11600,23100
"AL","2012-07-26",2012,7,208,31400,15200,11200,57800
"AL","2012-07-27",2012,7,209,25800,16500,10800,53100
"AL","2012-07-28",2012,7,210,15600,14900,10800,41300
"AL","2012-07-29",2012,7,211,453,13200,11000,24653
"AL","2012-07-30",2012,7,212,0,12300,11300,23600
"AL","2012-07-31",2012,7,213,263,12100,11200,23563
"AL","2012-08-01",2012,8,214,0,12000,11200,23200
"AL","2012-08-02",2012,8,215,0,11900,11200,23100
"AL","2012-08-03",2012,8,216,12500,13200,11200,36900
"AL","2012-08-04",2012,8,217,0,12100,11100,23200
"AL","2012-08-05",2012,8,218,14400,13500,11100,39000
"AL","2012-08-06",2012,8,219,1760,12600,11000,25360
"AL","2012-08-07",2012,8,220,0,12200,11100,23300
"AL","2012-08-08",2012,8,221,3360,12200,11100,26660
"AL","2012-08-09",2012,8,222,0,11900,11200,23100
"AL","2012-08-10",2012,8,223,10600,12700,11100,34400
"AL","2012-08-11",2012,8,224,41700,18300,12000,72000
"AL","2012-08-12",2012,8,225,0,13200,10800,24000
"AL","2012-08-13",2012,8,226,0,13100,11100,24200
"AL","2012-08-14",2012,8,227,0,12500,11100,23600
"AL","2012-08-15",2012,8,228,8490,12900,11200,32590
"AL","2012-08-16",2012,8,229,0,12100,11100,23200
"AL","2012-08-17",2012,8,230,4690,12300,11100,28090
"AL","2012-08-18",2012,8,231,5430,12600,11100,29130
"AL","2012-08-19",2012,8,232,1290,12300,11000,24590
"AL","2012-08-20",2012,8,233,10700,13200,11100,35000
"AL","2012-08-21",2012,8,234,13200,14400,11200,38800
"AL","2012-08-22",2012,8,235,0,12400,11100,23500
"AL","2012-08-23",2012,8,236,0,12000,11200,23200
"AL","2012-08-24",2012,8,237,3010,11700,11200,25910
"AL","2012-08-25",2012,8,238,7090,12300,11100,30490
"AL","2012-08-26",2012,8,239,0,11700,11000,22700
"AL","2012-08-27",2012,8,240,0,11600,11000,22600
"AL","2012-08-28",2012,8,241,1180,11400,11100,23680
"AL","2012-08-29",2012,8,242,0,11200,11100,22300
"AL","2012-08-30",2012,8,243,0,11100,11100,22200
"AL","2012-08-31",2012,8,244,0,11100,11100,22200
"AL","2012-09-01",2012,9,245,0,11000,11100,22100
"AL","2012-09-02",2012,9,246,0,10900,11000,21900
"AL","2012-09-03",2012,9,247,0,10900,10900,21800
"AL","2012-09-04",2012,9,248,110,10900,10800,21810
"AL","2012-09-05",2012,9,249,0,10800,10800,21600
"AL","2012-09-06",2012,9,250,110,10800,10700,21610
"AL","2012-09-07",2012,9,251,5830,11200,10600,27630
"AL","2012-09-08",2012,9,252,13800,12400,10400,36600
"AL","2012-09-09",2012,9,253,6950,12200,10300,29450
"AL","2012-09-10",2012,9,254,7110,12300,10200,29610
"AL","2012-09-11",2012,9,255,3830,12200,10300,26330
"AL","2012-09-12",2012,9,256,0,11600,10300,21900
"AL","2012-09-13",2012,9,257,0,11400,10500,21900
"AL","2012-09-14",2012,9,258,2680,11200,10400,24280
"AL","2012-09-15",2012,9,259,0,11000,10400,21400
"AL","2012-09-16",2012,9,260,0,11000,10400,21400
"AL","2012-09-17",2012,9,261,0,10900,10400,21300
"AL","2012-09-18",2012,9,262,797,10800,10400,21997
"AL","2012-09-19",2012,9,263,11900,11900,10300,34100
"AL","2012-09-20",2012,9,264,2710,11500,10200,24410
"AL","2012-09-21",2012,9,265,11600,12700,10300,34600
"AL","2012-09-22",2012,9,266,10700,12900,10500,34100
"AL","2012-09-23",2012,9,267,3110,12000,10300,25410
"AL","2012-09-24",2012,9,268,1900,11800,10300,24000
"AL","2012-09-25",2012,9,269,0,11500,10400,21900
"AL","2012-09-26",2012,9,270,0,11500,10400,21900
"AL","2012-09-27",2012,9,271,0,11300,10400,21700
"AL","2012-09-28",2012,9,272,0,11200,10400,21600
"AL","2012-09-29",2012,9,273,0,11100,10400,21500
"AL","2012-09-30",2012,9,274,0,11000,10400,21400
"AL","2012-10-01",2012,10,275,0,10800,10300,21100
"AL","2012-10-02",2012,10,276,0,10700,10300,21000
"AL","2012-10-03",2012,10,277,0,10600,10300,20900
"AL","2012-10-04",2012,10,278,0,10400,10200,20600
"AL","2012-10-05",2012,10,279,0,10300,10200,20500
"AL","2012-10-06",2012,10,280,0,10200,10100,20300
"AL","2012-10-07",2012,10,281,926,10400,10100,21426
"AL","2012-10-08",2012,10,282,0,10500,10100,20600
"AL","2012-10-09",2012,10,283,0,10600,10100,20700
"AL","2012-10-10",2012,10,284,1790,10800,10100,22690
"AL","2012-10-11",2012,10,285,8220,11700,10100,30020
"AL","2012-10-12",2012,10,286,1430,11300,10100,22830
"AL","2012-10-13",2012,10,287,0,11000,10000,21000
"AL","2012-10-14",2012,10,288,2400,11200,10000,23600
"AL","2012-10-15",2012,10,289,2580,11300,10000,23880
"AL","2012-10-16",2012,10,290,871,11100,10000,21971
"AL","2012-10-17",2012,10,291,1220,11100,9990,22310
"AL","2012-10-18",2012,10,292,302,10900,9970,21172
"AL","2012-10-19",2012,10,293,28700,15100,10900,54700
"AL","2012-10-20",2012,10,294,6570,12600,9970,29140
"AL","2012-10-21",2012,10,295,0,11700,9820,21520
"AL","2012-10-22",2012,10,296,0,11500,9860,21360
"AL","2012-10-23",2012,10,297,0,11500,9860,21360
"AL","2012-10-24",2012,10,298,456,11400,9840,21696
"AL","2012-10-25",2012,10,299,1080,11400,9810,22290
"AL","2012-10-26",2012,10,300,71000,26500,27200,124700
"AL","2012-10-27",2012,10,301,68400,19100,21500,109000
"AL","2012-10-28",2012,10,302,0,13900,11100,25000
"AL","2012-10-29",2012,10,303,0,13500,10800,24300
"AL","2012-10-30",2012,10,304,0,13900,11900,25800
"AL","2012-10-31",2012,10,305,0,14300,12700,27000
"AL","2012-11-01",2012,11,306,0,13700,11700,25400
"AL","2012-11-02",2012,11,307,0,13600,11800,25400
"AL","2012-11-03",2012,11,308,0,13400,11600,25000
"AL","2012-11-04",2012,11,309,0,13000,10900,23900
"AL","2012-11-05",2012,11,310,0,12800,10500,23300
"AL","2012-11-06",2012,11,311,0,12700,10500,23200
"AL","2012-11-07",2012,11,312,1670,12600,10500,24770
"AL","2012-11-08",2012,11,313,2650,12900,11900,27450
"AL","2012-11-09",2012,11,314,1250,15400,11900,28550
"AL","2012-11-10",2012,11,315,0,12600,10300,22900
"AL","2012-11-11",2012,11,316,0,12400,10200,22600
"AL","2012-11-12",2012,11,317,4410,12800,10200,27410
"AL","2012-11-13",2012,11,318,26300,18700,17100,62100
"AL","2012-11-14",2012,11,319,459,13200,10600,24259
"AL","2012-11-15",2012,11,320,230,12800,10200,23230
"AL","2012-11-16",2012,11,321,0,12500,10200,22700
"AL","2012-11-17",2012,11,322,0,12400,10200,22600
"AL","2012-11-18",2012,11,323,0,12300,10100,22400
"AL","2012-11-19",2012,11,324,0,12200,10100,22300
"AL","2012-11-20",2012,11,325,0,12100,10100,22200
"AL","2012-11-21",2012,11,326,0,12000,10000,22000
"AL","2012-11-22",2012,11,327,0,12000,10000,22000
"AL","2012-11-23",2012,11,328,0,11900,10000,21900
"AL","2012-11-24",2012,11,329,4800,12400,10100,27300
"AL","2012-11-25",2012,11,330,4320,11700,9910,25930
"AL","2012-11-26",2012,11,331,4940,11700,9840,26480
"AL","2012-11-27",2012,11,332,1610,11700,9860,23170
"AL","2012-11-28",2012,11,333,0,11600,9910,21510
"AL","2012-11-29",2012,11,334,4040,11600,9870,25510
"AL","2012-11-30",2012,11,335,0,11500,9900,21400
"AL","2012-12-01",2012,12,336,0,11500,9950,21450
"AL","2012-12-02",2012,12,337,0,11500,9960,21460
"AL","2012-12-03",2012,12,338,1060,12100,10300,23460
"AL","2012-12-04",2012,12,339,0,12000,10500,22500
"AL","2012-12-05",2012,12,340,1350,11700,10200,23250
"AL","2012-12-06",2012,12,341,0,11500,10000,21500
"AL","2012-12-07",2012,12,342,468,11400,10000,21868
"AL","2012-12-08",2012,12,343,1790,11500,10200,23490
"AL","2012-12-09",2012,12,344,0,11400,9990,21390
"AL","2012-12-10",2012,12,345,0,11300,9990,21290
"AL","2012-12-11",2012,12,346,3090,11300,9920,24310
"AL","2012-12-12",2012,12,347,0,11300,9920,21220
"AL","2012-12-13",2012,12,348,421,11200,9920,21541
"AL","2012-12-14",2012,12,349,0,11200,9930,21130
"AL","2012-12-15",2012,12,350,0,11200,9920,21120
"AL","2012-12-16",2012,12,351,0,11100,9910,21010
"AL","2012-12-17",2012,12,352,9420,14000,13700,37120
"AL","2012-12-18",2012,12,353,2090,11500,10200,23790
"AL","2012-12-19",2012,12,354,0,11300,9860,21160
"AL","2012-12-20",2012,12,355,0,11200,9830,21030
"AL","2012-12-21",2012,12,356,2410,11200,9790,23400
"AL","2012-12-22",2012,12,357,9050,11100,9620,29770
"AL","2012-12-23",2012,12,358,0,11100,9650,20750
"AL","2012-12-24",2012,12,359,842,11100,9690,21632
"AL","2012-12-25",2012,12,360,0,11000,9710,20710
"AL","2012-12-26",2012,12,361,222,11000,9720,20942
"AL","2012-12-27",2012,12,362,0,11000,9720,20720
"AL","2012-12-28",2012,12,363,0,10900,9720,20620
"AL","2012-12-29",2012,12,364,0,10900,9720,20620
"AL","2012-12-30",2012,12,365,1300,10900,9690,21890
"AL","2012-12-31",2012,12,366,234,10800,9690,20724
"AL","2013-01-01",2013,1,1,0,10800,9690,20490
"AL","2013-01-02",2013,1,2,0,10800,9690,20490
"AL","2013-01-03",2013,1,3,0,10800,9680,20480
"AL","2013-01-04",2013,1,4,0,10800,9680,20480
"AL","2013-01-05",2013,1,5,0,10700,9670,20370
"AL","2013-01-06",2013,1,6,0,10700,9670,20370
"AL","2013-01-07",2013,1,7,781,10700,9650,21131
"AL","2013-01-08",2013,1,8,215,10700,9650,20565
"AL","2013-01-09",2013,1,9,0,10600,9640,20240
"AL","2013-01-10",2013,1,10,0,10600,9640,20240
"AL","2013-01-11",2013,1,11,0,10600,9630,20230
"AL","2013-01-12",2013,1,12,8850,10600,9450,28900
"AL","2013-01-13",2013,1,13,1390,13200,15000,29590
"AL","2013-01-14",2013,1,14,0,10900,9900,20800
"AL","2013-01-15",2013,1,15,391,10800,9540,20731
"AL","2013-01-16",2013,1,16,0,10700,9530,20230
"AL","2013-01-17",2013,1,17,0,10700,9530,20230
"AL","2013-01-18",2013,1,18,782,10700,9520,21002
"AL","2013-01-19",2013,1,19,1560,10600,9490,21650
"AL","2013-01-20",2013,1,20,6330,10600,9370,26300
"AL","2013-01-21",2013,1,21,6770,10500,9270,26540
"AL","2013-01-22",2013,1,22,0,10500,9330,19830
"AL","2013-01-23",2013,1,23,0,10500,9380,19880
"AL","2013-01-24",2013,1,24,0,10500,9390,19890
"AL","2013-01-25",2013,1,25,1760,10400,9360,21520
"AL","2013-01-26",2013,1,26,5960,10400,9260,25620
"AL","2013-01-27",2013,1,27,2130,10400,9250,21780
"AL","2013-01-28",2013,1,28,0,10400,9300,19700
"AL","2013-01-29",2013,1,29,22800,10300,8920,42020
"AL","2013-01-30",2013,1,30,16600,10300,8690,35590
"AL","2013-01-31",2013,1,31,3230,10300,8830,22360
"AL","2013-02-01",2013,2,32,15900,10300,8700,34900
"AL","2013-02-02",2013,2,33,188,10300,8810,19298
"AL","2013-02-03",2013,2,34,0,10200,8960,19160
"AL","2013-02-04",2013,2,35,0,10200,9030,19230
"AL","2013-02-05",2013,2,36,0,10200,9080,19280
"AL","2013-02-06",2013,2,37,3310,10200,9060,22570
"AL","2013-02-07",2013,2,38,0,10200,9110,19310
"AL","2013-02-08",2013,2,39,3800,10100,9090,22990
"AL","2013-02-09",2013,2,40,0,10100,9120,19220
"AL","2013-02-10",2013,2,41,0,10100,9170,19270
"AL","2013-02-11",2013,2,42,0,10100,9190,19290
"AL","2013-02-12",2013,2,43,14000,10100,8970,33070
"AL","2013-02-13",2013,2,44,2010,10000,8970,20980
"AL","2013-02-14",2013,2,45,0,10000,9080,19080
"AL","2013-02-15",2013,2,46,551,10000,9110,19661
"AL","2013-02-16",2013,2,47,93.8,9990,9150,19233.8
"AL","2013-02-17",2013,2,48,0,9970,9170,19140
"AL","2013-02-18",2013,2,49,0,9960,9180,19140
"AL","2013-02-19",2013,2,50,0,9940,9190,19130
"AL","2013-02-20",2013,2,51,3730,9920,9140,22790
"AL","2013-02-21",2013,2,52,551,9900,9140,19591
"AL","2013-02-22",2013,2,53,0,9890,9170,19060
"AL","2013-02-23",2013,2,54,563,9870,9180,19613
"AL","2013-02-24",2013,2,55,6390,9860,9060,25310
"AL","2013-02-25",2013,2,56,1500,9840,9060,20400
"AL","2013-02-26",2013,2,57,0,9830,9120,18950
"AL","2013-02-27",2013,2,58,0,9810,9140,18950
"AL","2013-02-28",2013,2,59,0,9800,9150,18950
"AL","2013-03-01",2013,3,60,0,9780,9170,18950
"AL","2013-03-02",2013,3,61,0,9760,9180,18940
"AL","2013-03-03",2013,3,62,0,9750,9180,18930
"AL","2013-03-04",2013,3,63,0,9730,9160,18890
"AL","2013-03-05",2013,3,64,0,9710,9160,18870
"AL","2013-03-06",2013,3,65,0,9700,9170,18870
"AL","2013-03-07",2013,3,66,0,9680,9180,18860
"AL","2013-03-08",2013,3,67,0,9660,9180,18840
"AL","2013-03-09",2013,3,68,0,9650,9180,18830
"AL","2013-03-10",2013,3,69,0,9630,9190,18820
"AL","2013-03-11",2013,3,70,20000,9620,8810,38430
"AL","2013-03-12",2013,3,71,26900,9610,8380,44890
"AL","2013-03-13",2013,3,72,8360,9610,8380,26350
"AL","2013-03-14",2013,3,73,2310,9600,8550,20460
"AL","2013-03-15",2013,3,74,0,9590,8680,18270
"AL","2013-03-16",2013,3,75,0,9580,8770,18350
"AL","2013-03-17",2013,3,76,7930,9570,8670,26170
"AL","2013-03-18",2013,3,77,0,9550,8710,18260
"AL","2013-03-19",2013,3,78,0,9540,8800,18340
"AL","2013-03-20",2013,3,79,15000,9530,8560,33090
"AL","2013-03-21",2013,3,80,0,9520,8630,18150
"AL","2013-03-22",2013,3,81,0,9500,8740,18240
"AL","2013-03-23",2013,3,82,0,9490,8800,18290
"AL","2013-03-24",2013,3,83,0,9470,8830,18300
"AL","2013-03-25",2013,3,84,0,9460,8890,18350
"AL","2013-03-26",2013,3,85,0,9440,8920,18360
"AL","2013-03-27",2013,3,86,0,9430,8940,18370
"AL","2013-03-28",2013,3,87,0,9410,8980,18390
"AL","2013-03-29",2013,3,88,0,9390,9010,18400
"AL","2013-03-30",2013,3,89,0,9370,9050,18420
"AL","2013-03-31",2013,3,90,7890,9360,8950,26200
"AL","2013-04-01",2013,4,91,24000,9340,8570,41910
"AL","2013-04-02",2013,4,92,0,9330,8620,17950
"AL","2013-04-03",2013,4,93,0,9320,8740,18060
"AL","2013-04-04",2013,4,94,0,9300,8790,18090
"AL","2013-04-05",2013,4,95,0,9290,8820,18110
"AL","2013-04-06",2013,4,96,0,9270,8840,18110
"AL","2013-04-07",2013,4,97,13800,9260,8610,31670
"AL","2013-04-08",2013,4,98,22600,9310,9230,41140
"AL","2013-04-09",2013,4,99,15500,11900,14900,42300
"AL","2013-04-10",2013,4,100,20900,16100,23800,60800
"AL","2013-04-11",2013,4,101,0,11200,11400,22600
"AL","2013-04-12",2013,4,102,0,11100,10200,21300
"AL","2013-04-13",2013,4,103,16500,10600,9060,36160
"AL","2013-04-14",2013,4,104,8540,10400,8690,27630
"AL","2013-04-15",2013,4,105,4160,10300,8670,23130
"AL","2013-04-16",2013,4,106,70100,10200,7850,88150
"AL","2013-04-17",2013,4,107,0,10000,8050,18050
"AL","2013-04-18",2013,4,108,0,9960,8460,18420
"AL","2013-04-19",2013,4,109,9400,11600,12000,33000
"AL","2013-04-20",2013,4,110,39000,10600,9630,59230
"AL","2013-04-21",2013,4,111,5960,10100,8420,24480
"AL","2013-04-22",2013,4,112,0,9990,8550,18540
"AL","2013-04-23",2013,4,113,7870,9930,8590,26390
"AL","2013-04-24",2013,4,114,59800,9880,8260,77940
"AL","2013-04-25",2013,4,115,0,9820,8210,18030
"AL","2013-04-26",2013,4,116,4050,11300,12500,27850
"AL","2013-04-27",2013,4,117,4350,14200,18000,36550
"AL","2013-04-28",2013,4,118,854,24900,32900,58654
"AL","2013-04-29",2013,4,119,0,17500,22300,39800
"AL","2013-04-30",2013,4,120,6440,163000,214000,383440
"AL","2013-05-01",2013,5,121,7700,245000,293000,545700
"AL","2013-05-02",2013,5,122,10500,228000,252000,490500
"AL","2013-05-03",2013,5,123,7170,21700,14300,43170
"AL","2013-05-04",2013,5,124,19700,16300,7500,43500
"AL","2013-05-05",2013,5,125,17000,15400,7410,39810
"AL","2013-05-06",2013,5,126,0,17000,11500,28500
"AL","2013-05-07",2013,5,127,0,21200,21500,42700
"AL","2013-05-08",2013,5,128,0,15700,11300,27000
"AL","2013-05-09",2013,5,129,0,14500,10600,25100
"AL","2013-05-10",2013,5,130,0,13800,11000,24800
"AL","2013-05-11",2013,5,131,25600,15500,11300,52400
"AL","2013-05-12",2013,5,132,2310,15000,11800,29110
"AL","2013-05-13",2013,5,133,1730,14200,12300,28230
"AL","2013-05-14",2013,5,134,0,13800,12500,26300
"AL","2013-05-15",2013,5,135,0,13700,12900,26600
"AL","2013-05-16",2013,5,136,0,13000,13100,26100
"AL","2013-05-17",2013,5,137,369,12300,13100,25769
"AL","2013-05-18",2013,5,138,623,12000,13200,25823
"AL","2013-05-19",2013,5,139,6160,12300,13200,31660
"AL","2013-05-20",2013,5,140,20400,14100,13400,47900
"AL","2013-05-21",2013,5,141,14100,14200,13700,42000
"AL","2013-05-22",2013,5,142,33900,18200,15800,67900
"AL","2013-05-23",2013,5,143,26400,19600,21500,67500
"AL","2013-05-24",2013,5,144,2470,14000,13800,30270
"AL","2013-05-25",2013,5,145,354,13400,13700,27454
"AL","2013-05-26",2013,5,146,0,13100,13600,26700
"AL","2013-05-27",2013,5,147,0,12800,13600,26400
"AL","2013-05-28",2013,5,148,0,12200,13300,25500
"AL","2013-05-29",2013,5,149,0,11900,13100,25000
"AL","2013-05-30",2013,5,150,1340,11800,12900,26040
"AL","2013-05-31",2013,5,151,30200,16100,13400,59700
"AL","2013-06-01",2013,6,152,37700,21700,22900,82300
"AL","2013-06-02",2013,6,153,39700,24700,27700,92100
"AL","2013-06-03",2013,6,154,8610,15900,14700,39210
"AL","2013-06-04",2013,6,155,0,14400,13300,27700
"AL","2013-06-05",2013,6,156,0,14200,13400,27600
"AL","2013-06-06",2013,6,157,6490,14300,13400,34190
"AL","2013-06-07",2013,6,158,44000,24200,27500,95700
"AL","2013-06-08",2013,6,159,15600,19900,19000,54500
"AL","2013-06-09",2013,6,160,1200,15200,13700,30100
"AL","2013-06-10",2013,6,161,0,14400,13700,28100
"AL","2013-06-11",2013,6,162,2120,14100,13600,29820
"AL","2013-06-12",2013,6,163,0,13500,13400,26900
"AL","2013-06-13",2013,6,164,0,13200,13300,26500
"AL","2013-06-14",2013,6,165,0,12800,13100,25900
"AL","2013-06-15",2013,6,166,0,12600,12900,25500
"AL","2013-06-16",2013,6,167,938,12500,12700,26138
"AL","2013-06-17",2013,6,168,28000,16200,12800,57000
"AL","2013-06-18",2013,6,169,13500,15500,12900,41900
"AL","2013-06-19",2013,6,170,627,13600,12600,26827
"AL","2013-06-20",2013,6,171,0,12900,12500,25400
"AL","2013-06-21",2013,6,172,0,12800,12500,25300
"AL","2013-06-22",2013,6,173,59400,21500,18000,98900
"AL","2013-06-23",2013,6,174,10800,16100,14200,41100
"AL","2013-06-24",2013,6,175,455,14300,12700,27455
"AL","2013-06-25",2013,6,176,42700,27800,26200,96700
"AL","2013-06-26",2013,6,177,0,15200,13000,28200
"AL","2013-06-27",2013,6,178,0,14600,12900,27500
"AL","2013-06-28",2013,6,179,17000,16300,13200,46500
"AL","2013-06-29",2013,6,180,68400,34100,38800,141300
"AL","2013-06-30",2013,6,181,13000,19000,18300,50300
"AL","2013-07-01",2013,7,182,1380,16200,13600,31180
"AL","2013-07-02",2013,7,183,0,15500,13800,29300
"AL","2013-07-03",2013,7,184,0,15000,13900,28900
"AL","2013-07-04",2013,7,185,0,14100,13700,27800
"AL","2013-07-05",2013,7,186,0,13900,13400,27300
"AL","2013-07-06",2013,7,187,0,13700,13200,26900
"AL","2013-07-07",2013,7,188,0,13600,13100,26700
"AL","2013-07-08",2013,7,189,36000,17200,13400,66600
"AL","2013-07-09",2013,7,190,30100,19800,14300,64200
"AL","2013-07-10",2013,7,191,0,14900,13000,27900
"AL","2013-07-11",2013,7,192,29300,20200,17600,67100
"AL","2013-07-12",2013,7,193,0,15100,13100,28200
"AL","2013-07-13",2013,7,194,0,14700,13200,27900
"AL","2013-07-14",2013,7,195,0,14100,13100,27200
"AL","2013-07-15",2013,7,196,0,13600,13000,26600
"AL","2013-07-16",2013,7,197,0,13500,12900,26400
"AL","2013-07-17",2013,7,198,993,13400,12800,27193
"AL","2013-07-18",2013,7,199,0,13300,12700,26000
"AL","2013-07-19",2013,7,200,2880,13200,12600,28680
"AL","2013-07-20",2013,7,201,1320,13200,12600,27120
"AL","2013-07-21",2013,7,202,0,13000,12500,25500
"AL","2013-07-22",2013,7,203,0,12900,12500,25400
"AL","2013-07-23",2013,7,204,0,12800,12400,25200
"AL","2013-07-24",2013,7,205,9950,13700,12300,35950
"AL","2013-07-25",2013,7,206,0,12700,12200,24900
"AL","2013-07-26",2013,7,207,0,12800,12200,25000
"AL","2013-07-27",2013,7,208,8020,13300,12200,33520
"AL","2013-07-28",2013,7,209,1870,12900,12100,26870
"AL","2013-07-29",2013,7,210,2600,12900,12100,27600
"AL","2013-07-30",2013,7,211,948,12800,12000,25748
"AL","2013-07-31",2013,7,212,2410,13000,12200,27610
"AL","2013-08-01",2013,8,213,978,12600,12100,25678
"AL","2013-08-02",2013,8,214,175,12400,12100,24675
"AL","2013-08-03",2013,8,215,2790,12700,12100,27590
"AL","2013-08-04",2013,8,216,0,12400,12000,24400
"AL","2013-08-05",2013,8,217,0,12400,12000,24400
"AL","2013-08-06",2013,8,218,483,12300,12000,24783
"AL","2013-08-07",2013,8,219,46300,18800,12600,77700
"AL","2013-08-08",2013,8,220,32200,20400,16800,69400
"AL","2013-08-09",2013,8,221,0,14300,11700,26000
"AL","2013-08-10",2013,8,222,1080,14300,12000,27380
"AL","2013-08-11",2013,8,223,0,14000,12000,26000
"AL","2013-08-12",2013,8,224,0,13700,12000,25700
"AL","2013-08-13",2013,8,225,5980,14100,12000,32080
"AL","2013-08-14",2013,8,226,1490,13700,12100,27290
"AL","2013-08-15",2013,8,227,0,13000,12000,25000
"AL","2013-08-16",2013,8,228,0,13100,12000,25100
"AL","2013-08-17",2013,8,229,0,12900,12000,24900
"AL","2013-08-18",2013,8,230,0,12600,12100,24700
"AL","2013-08-19",2013,8,231,0,12500,12100,24600
"AL","2013-08-20",2013,8,232,1780,12400,11900,26080
"AL","2013-08-21",2013,8,233,0,12300,11900,24200
"AL","2013-08-22",2013,8,234,0,12300,11900,24200
"AL","2013-08-23",2013,8,235,10200,13000,11800,35000
"AL","2013-08-24",2013,8,236,0,12200,11800,24000
"AL","2013-08-25",2013,8,237,0,12000,11900,23900
"AL","2013-08-26",2013,8,238,0,11900,11900,23800
"AL","2013-08-27",2013,8,239,64000,20900,13500,98400
"AL","2013-08-28",2013,8,240,99900,41700,53000,194600
"AL","2013-08-29",2013,8,241,395,18000,21600,39995
"AL","2013-08-30",2013,8,242,0,15500,13000,28500
"AL","2013-08-31",2013,8,243,95900,42700,51900,190500
"AL","2013-09-01",2013,9,244,0,19100,21200,40300
"AL","2013-09-02",2013,9,245,1320,16800,14000,32120
"AL","2013-09-03",2013,9,246,797,16400,13900,31097
"AL","2013-09-04",2013,9,247,439,16200,14100,30739
"AL","2013-09-05",2013,9,248,0,15900,14100,30000
"AL","2013-09-06",2013,9,249,0,15800,14000,29800
"AL","2013-09-07",2013,9,250,0,15400,13800,29200
"AL","2013-09-08",2013,9,251,481,15100,13700,29281
"AL","2013-09-09",2013,9,252,0,14700,13500,28200
"AL","2013-09-10",2013,9,253,2600,14700,13300,30600
"AL","2013-09-11",2013,9,254,3330,14800,13200,31330
"AL","2013-09-12",2013,9,255,825,14500,13100,28425
"AL","2013-09-13",2013,9,256,0,14200,13000,27200
"AL","2013-09-14",2013,9,257,0,14100,12900,27000
"AL","2013-09-15",2013,9,258,0,14000,12800,26800
"AL","2013-09-16",2013,9,259,10200,15000,12800,38000
"AL","2013-09-17",2013,9,260,1570,14500,12600,28670
"AL","2013-09-18",2013,9,261,0,14200,12600,26800
"AL","2013-09-19",2013,9,262,1530,14200,12600,28330
"AL","2013-09-20",2013,9,263,303,13900,12600,26803
"AL","2013-09-21",2013,9,264,14500,15800,12800,43100
"AL","2013-09-22",2013,9,265,1500,14300,12500,28300
"AL","2013-09-23",2013,9,266,671,13900,12500,27071
"AL","2013-09-24",2013,9,267,1110,13900,12500,27510
"AL","2013-09-25",2013,9,268,0,13700,12400,26100
"AL","2013-09-26",2013,9,269,0,13600,12400,26000
"AL","2013-09-27",2013,9,270,0,13400,12400,25800
"AL","2013-09-28",2013,9,271,0,13200,12400,25600
"AL","2013-09-29",2013,9,272,0,13100,12400,25500
"AL","2013-09-30",2013,9,273,12500,14400,12200,39100
"AL","2013-10-01",2013,10,274,0,13900,12200,26100
"AL","2013-10-02",2013,10,275,0,13700,12300,26000
"AL","2013-10-03",2013,10,276,0,13200,12200,25400
"AL","2013-10-04",2013,10,277,40700,19400,13400,73500
"AL","2013-10-05",2013,10,278,7160,15700,12300,35160
"AL","2013-10-06",2013,10,279,25300,21200,20600,67100
"AL","2013-10-07",2013,10,280,42400,27600,32600,102600
"AL","2013-10-08",2013,10,281,9840,19700,18200,47740
"AL","2013-10-09",2013,10,282,0,16600,13600,30200
"AL","2013-10-10",2013,10,283,0,16000,13300,29300
"AL","2013-10-11",2013,10,284,0,15800,13200,29000
"AL","2013-10-12",2013,10,285,0,15600,13100,28700
"AL","2013-10-13",2013,10,286,0,15500,13000,28500
"AL","2013-10-14",2013,10,287,335,15400,12900,28635
"AL","2013-10-15",2013,10,288,0,15200,12900,28100
"AL","2013-10-16",2013,10,289,10700,16700,13300,40700
"AL","2013-10-17",2013,10,290,34500,25600,26500,86600
"AL","2013-10-18",2013,10,291,1080,16700,14200,31980
"AL","2013-10-19",2013,10,292,8680,17800,16100,42580
"AL","2013-10-20",2013,10,293,5440,17400,15900,38740
"AL","2013-10-21",2013,10,294,7410,18200,17000,42610
"AL","2013-10-22",2013,10,295,15200,19400,19200,53800
"AL","2013-10-23",2013,10,296,6810,16400,14000,37210
"AL","2013-10-24",2013,10,297,198,18700,17800,36698
"AL","2013-10-25",2013,10,298,1610,16300,14400,32310
"AL","2013-10-26",2013,10,299,1390,16000,13900,31290
"AL","2013-10-27",2013,10,300,3570,16200,14300,34070
"AL","2013-10-28",2013,10,301,1020,15700,13800,30520
"AL","2013-10-29",2013,10,302,19200,18400,18000,55600
"AL","2013-10-30",2013,10,303,0,16500,15000,31500
"AL","2013-10-31",2013,10,304,4520,17300,16800,38620
"AL","2013-11-01",2013,11,305,5230,18800,16000,40030
"AL","2013-11-02",2013,11,306,4380,17400,16000,37780
"AL","2013-11-03",2013,11,307,4450,16500,13900,34850
"AL","2013-11-04",2013,11,308,5720,16600,14100,36420
"AL","2013-11-05",2013,11,309,0,15900,13800,29700
"AL","2013-11-06",2013,11,310,5460,16300,14300,36060
"AL","2013-11-07",2013,11,311,22700,20100,20500,63300
"AL","2013-11-08",2013,11,312,0,16300,14200,30500
"AL","2013-11-09",2013,11,313,459,15900,13800,30159
"AL","2013-11-10",2013,11,314,14200,15700,13600,43500
"AL","2013-11-11",2013,11,315,279,16800,16100,33179
"AL","2013-11-12",2013,11,316,3440,16500,15700,35640
"AL","2013-11-13",2013,11,317,500,15700,13900,30100
"AL","2013-11-14",2013,11,318,0,15500,13800,29300
"AL","2013-11-15",2013,11,319,0,15500,13800,29300
"AL","2013-11-16",2013,11,320,0,15600,14200,29800
"AL","2013-11-17",2013,11,321,0,15900,14800,30700
"AL","2013-11-18",2013,11,322,20400,21500,20900,62800
"AL","2013-11-19",2013,11,323,2270,16600,15000,33870
"AL","2013-11-20",2013,11,324,0,15600,13400,29000
"AL","2013-11-21",2013,11,325,0,15500,13500,29000
"AL","2013-11-22",2013,11,326,14400,15900,13500,43800
"AL","2013-11-23",2013,11,327,6800,15500,13400,35700
"AL","2013-11-24",2013,11,328,1690,15400,13400,30490
"AL","2013-11-25",2013,11,329,855,15300,13500,29655
"AL","2013-11-26",2013,11,330,0,15200,13500,28700
"AL","2013-11-27",2013,11,331,375,15200,13500,29075
"AL","2013-11-28",2013,11,332,1130,15100,13500,29730
"AL","2013-11-29",2013,11,333,2650,15000,13400,31050
"AL","2013-11-30",2013,11,334,230,15000,13400,28630
"AL","2013-12-01",2013,12,335,0,14900,13500,28400
"AL","2013-12-02",2013,12,336,0,14900,13400,28300
"AL","2013-12-03",2013,12,337,0,14800,13400,28200
"AL","2013-12-04",2013,12,338,9390,14800,13200,37390
"AL","2013-12-05",2013,12,339,5830,14800,13200,33830
"AL","2013-12-06",2013,12,340,19800,14700,12900,47400
"AL","2013-12-07",2013,12,341,0,14700,13000,27700
"AL","2013-12-08",2013,12,342,0,14700,13200,27900
"AL","2013-12-09",2013,12,343,0,14600,13200,27800
"AL","2013-12-10",2013,12,344,3110,14600,13200,30910
"AL","2013-12-11",2013,12,345,1570,14600,13200,29370
"AL","2013-12-12",2013,12,346,0,14500,13200,27700
"AL","2013-12-13",2013,12,347,0,14500,13200,27700
"AL","2013-12-14",2013,12,348,726,14500,13200,28426
"AL","2013-12-15",2013,12,349,129,14400,13200,27729
"AL","2013-12-16",2013,12,350,2210,14400,13100,29710
"AL","2013-12-17",2013,12,351,0,14400,13100,27500
"AL","2013-12-18",2013,12,352,2610,14300,13100,30010
"AL","2013-12-19",2013,12,353,93.5,14300,13100,27493.5
"AL","2013-12-20",2013,12,354,0,14300,13100,27400
"AL","2013-12-21",2013,12,355,2610,14300,13000,29910
"AL","2013-12-22",2013,12,356,515,14200,13000,27715
"AL","2013-12-23",2013,12,357,0,14200,13000,27200
"AL","2013-12-24",2013,12,358,3350,14200,13000,30550
"AL","2013-12-25",2013,12,359,0,14200,13000,27200
"AL","2013-12-26",2013,12,360,5180,14100,12900,32180
"AL","2013-12-27",2013,12,361,363,14100,12900,27363
"AL","2013-12-28",2013,12,362,0,14100,12900,27000
"AL","2013-12-29",2013,12,363,0,14100,12900,27000
"AL","2013-12-30",2013,12,364,105,14100,12900,27105
"AL","2013-12-31",2013,12,365,0,14000,12900,26900
"AL","2014-01-01",2014,1,1,0,14000,12900,26900
"AL","2014-01-02",2014,1,2,0,14000,12900,26900
"AL","2014-01-03",2014,1,3,0,13900,12800,26700
"AL","2014-01-04",2014,1,4,0,13900,12800,26700
"AL","2014-01-05",2014,1,5,6950,13900,12700,33550
"AL","2014-01-06",2014,1,6,0,13800,12700,26500
"AL","2014-01-07",2014,1,7,0,13800,12700,26500
"AL","2014-01-08",2014,1,8,0,13800,12700,26500
"AL","2014-01-09",2014,1,9,0,13800,12700,26500
"AL","2014-01-10",2014,1,10,0,13700,12700,26400
"AL","2014-01-11",2014,1,11,0,13700,12700,26400
"AL","2014-01-12",2014,1,12,12100,13700,12500,38300
"AL","2014-01-13",2014,1,13,0,13600,12500,26100
"AL","2014-01-14",2014,1,14,0,13600,12600,26200
"AL","2014-01-15",2014,1,15,0,13600,12600,26200
"AL","2014-01-16",2014,1,16,918,13500,12500,26918
"AL","2014-01-17",2014,1,17,6210,13500,12400,32110
"AL","2014-01-18",2014,1,18,7770,13500,12300,33570
"AL","2014-01-19",2014,1,19,0,13500,12400,25900
"AL","2014-01-20",2014,1,20,1020,13400,12400,26820
"AL","2014-01-21",2014,1,21,312,13400,12400,26112
"AL","2014-01-22",2014,1,22,156,13400,12400,25956
"AL","2014-01-23",2014,1,23,3380,13400,12300,29080
"AL","2014-01-24",2014,1,24,2150,13300,12300,27750
"AL","2014-01-25",2014,1,25,312,13300,12300,25912
"AL","2014-01-26",2014,1,26,4020,13300,12200,29520
"AL","2014-01-27",2014,1,27,1910,13200,12200,27310
"AL","2014-01-28",2014,1,28,3630,13200,12200,29030
"AL","2014-01-29",2014,1,29,0,13200,12200,25400
"AL","2014-01-30",2014,1,30,0,13200,12200,25400
"AL","2014-01-31",2014,1,31,1350,13100,12200,26650
"AL","2014-02-01",2014,2,32,18700,13100,11900,43700
"AL","2014-02-02",2014,2,33,0,13100,11900,25000
"AL","2014-02-03",2014,2,34,0,13100,12000,25100
"AL","2014-02-04",2014,2,35,0,13000,12100,25100
"AL","2014-02-05",2014,2,36,0,13000,12100,25100
"AL","2014-02-06",2014,2,37,0,13000,12100,25100
"AL","2014-02-07",2014,2,38,0,12900,12100,25000
"AL","2014-02-08",2014,2,39,0,12900,12000,24900
"AL","2014-02-09",2014,2,40,0,12900,12000,24900
"AL","2014-02-10",2014,2,41,0,12900,12000,24900
"AL","2014-02-11",2014,2,42,0,12800,12000,24800
"AL","2014-02-12",2014,2,43,0,12800,12000,24800
"AL","2014-02-13",2014,2,44,1540,12800,11900,26240
"AL","2014-02-14",2014,2,45,0,12700,11900,24600
"AL","2014-02-15",2014,2,46,6860,12700,11800,31360
"AL","2014-02-16",2014,2,47,0,12700,11800,24500
"AL","2014-02-17",2014,2,48,3310,12700,11800,27810
"AL","2014-02-18",2014,2,49,1560,12600,11700,25860
"AL","2014-02-19",2014,2,50,6660,12600,11600,30860
"AL","2014-02-20",2014,2,51,0,12600,11700,24300
"AL","2014-02-21",2014,2,52,0,12600,11700,24300
"AL","2014-02-22",2014,2,53,22300,12500,11400,46200
"AL","2014-02-23",2014,2,54,3260,12500,11400,27160
"AL","2014-02-24",2014,2,55,0,12500,11500,24000
"AL","2014-02-25",2014,2,56,0,12500,11600,24100
"AL","2014-02-26",2014,2,57,0,12400,11600,24000
"AL","2014-02-27",2014,2,58,0,12400,11600,24000
"AL","2014-02-28",2014,2,59,3200,12400,11500,27100
"AL","2014-03-01",2014,3,60,0,12400,11500,23900
"AL","2014-03-02",2014,3,61,1100,12300,11500,24900
"AL","2014-03-03",2014,3,62,0,12300,11500,23800
"AL","2014-03-04",2014,3,63,0,12300,11600,23900
"AL","2014-03-05",2014,3,64,5190,12300,11400,28890
"AL","2014-03-06",2014,3,65,0,12200,11500,23700
"AL","2014-03-07",2014,3,66,0,12200,11500,23700
"AL","2014-03-08",2014,3,67,2580,12200,11400,26180
"AL","2014-03-09",2014,3,68,345,12200,11400,23945
"AL","2014-03-10",2014,3,69,0,12100,11500,23600
"AL","2014-03-11",2014,3,70,0,12100,11500,23600
"AL","2014-03-12",2014,3,71,0,12100,11500,23600
"AL","2014-03-13",2014,3,72,0,12000,11500,23500
"AL","2014-03-14",2014,3,73,0,12000,11500,23500
"AL","2014-03-15",2014,3,74,0,12000,11500,23500
"AL","2014-03-16",2014,3,75,4270,12000,11400,27670
"AL","2014-03-17",2014,3,76,0,11900,11400,23300
"AL","2014-03-18",2014,3,77,345,11900,11400,23645
"AL","2014-03-19",2014,3,78,7890,11900,11200,30990
"AL","2014-03-20",2014,3,79,11700,11900,11000,34600
"AL","2014-03-21",2014,3,80,2180,11900,11100,25180
"AL","2014-03-22",2014,3,81,0,11800,11100,22900
"AL","2014-03-23",2014,3,82,7710,11800,11100,30610
"AL","2014-03-24",2014,3,83,0,11800,11100,22900
"AL","2014-03-25",2014,3,84,0,11800,11100,22900
"AL","2014-03-26",2014,3,85,194,11700,11100,22994
"AL","2014-03-27",2014,3,86,0,11700,11100,22800
"AL","2014-03-28",2014,3,87,0,11700,11100,22800
"AL","2014-03-29",2014,3,88,25900,11700,10700,48300
"AL","2014-03-30",2014,3,89,0,11600,10700,22300
"AL","2014-03-31",2014,3,90,0,11600,10900,22500
"AL","2014-04-01",2014,4,91,0,11600,11000,22600
"AL","2014-04-02",2014,4,92,0,11600,11100,22700
"AL","2014-04-03",2014,4,93,209,11600,11100,22909
"AL","2014-04-04",2014,4,94,0,11500,11100,22600
"AL","2014-04-05",2014,4,95,40700,11500,10400,62600
"AL","2014-04-06",2014,4,96,24200,11500,10100,45800
"AL","2014-04-07",2014,4,97,419,11500,10400,22319
"AL","2014-04-08",2014,4,98,0,11500,10600,22100
"AL","2014-04-09",2014,4,99,0,11400,10700,22100
"AL","2014-04-10",2014,4,100,0,11400,10800,22200
"AL","2014-04-11",2014,4,101,285,12800,14300,27385
"AL","2014-04-12",2014,4,102,0,14000,16200,30200
"AL","2014-04-13",2014,4,103,13000,16300,20800,50100
"AL","2014-04-14",2014,4,104,13000,20900,28800,62700
"AL","2014-04-15",2014,4,105,13500,16600,19500,49600
"AL","2014-04-16",2014,4,106,0,13700,12500,26200
"AL","2014-04-17",2014,4,107,0,13400,12000,25400
"AL","2014-04-18",2014,4,108,78000,13200,10700,101900
"AL","2014-04-19",2014,4,109,0,13000,11000,24000
"AL","2014-04-20",2014,4,110,0,12800,11500,24300
"AL","2014-04-21",2014,4,111,3310,13600,13900,30810
"AL","2014-04-22",2014,4,112,0,18400,23400,41800
"AL","2014-04-23",2014,4,113,0,19100,24200,43300
"AL","2014-04-24",2014,4,114,0,15200,15800,31000
"AL","2014-04-25",2014,4,115,3880,20900,27500,52280
"AL","2014-04-26",2014,4,116,24300,23500,32000,79800
"AL","2014-04-27",2014,4,117,3140,19300,23600,46040
"AL","2014-04-28",2014,4,118,0,17900,20500,38400
"AL","2014-04-29",2014,4,119,5540,21000,26700,53240
"AL","2014-04-30",2014,4,120,1740,25800,34100,61640
"AL","2014-05-01",2014,5,121,27100,27200,36500,90800
"AL","2014-05-02",2014,5,122,21600,48100,64600,134300
"AL","2014-05-03",2014,5,123,1890,24800,26900,53590
"AL","2014-05-04",2014,5,124,5080,26100,26600,57780
"AL","2014-05-05",2014,5,125,2890,19400,18100,40390
"AL","2014-05-06",2014,5,126,8280,20000,19400,47680
"AL","2014-05-07",2014,5,127,1040,18200,17100,36340
"AL","2014-05-08",2014,5,128,0,17800,17000,34800
"AL","2014-05-09",2014,5,129,19900,21900,21500,63300
"AL","2014-05-10",2014,5,130,76300,42100,51600,170000
"AL","2014-05-11",2014,5,131,2310,20300,23000,45610
"AL","2014-05-12",2014,5,132,1340,18500,17800,37640
"AL","2014-05-13",2014,5,133,45400,31800,35700,112900
"AL","2014-05-14",2014,5,134,5170,19900,19100,44170
"AL","2014-05-15",2014,5,135,785,18400,17600,36785
"AL","2014-05-16",2014,5,136,0,17800,17700,35500
"AL","2014-05-17",2014,5,137,0,17500,17800,35300
"AL","2014-05-18",2014,5,138,0,17200,17800,35000
"AL","2014-05-19",2014,5,139,0,16900,17800,34700
"AL","2014-05-20",2014,5,140,0,16500,17700,34200
"AL","2014-05-21",2014,5,141,77400,38600,42800,158800
"AL","2014-05-22",2014,5,142,623,18500,19000,38123
"AL","2014-05-23",2014,5,143,0,17800,17900,35700
"AL","2014-05-24",2014,5,144,0,17600,18000,35600
"AL","2014-05-25",2014,5,145,0,17100,17900,35000
"AL","2014-05-26",2014,5,146,0,16400,17800,34200
"AL","2014-05-27",2014,5,147,0,15900,17400,33300
"AL","2014-05-28",2014,5,148,20700,18300,17500,56500
"AL","2014-05-29",2014,5,149,0,16700,17200,33900
"AL","2014-05-30",2014,5,150,0,16400,17200,33600
"AL","2014-05-31",2014,5,151,0,15600,16900,32500
"AL","2014-06-01",2014,6,152,0,15400,16700,32100
"AL","2014-06-02",2014,6,153,16200,17200,16500,49900
"AL","2014-06-03",2014,6,154,23000,20000,16800,59800
"AL","2014-06-04",2014,6,155,35600,24200,19100,78900
"AL","2014-06-05",2014,6,156,207,17600,16600,34407
"AL","2014-06-06",2014,6,157,0,17000,16700,33700
"AL","2014-06-07",2014,6,158,4050,17000,16700,37750
"AL","2014-06-08",2014,6,159,5820,17200,16700,39720
"AL","2014-06-09",2014,6,160,5250,17100,16600,38950
"AL","2014-06-10",2014,6,161,0,16400,16500,32900
"AL","2014-06-11",2014,6,162,207,16300,16400,32907
"AL","2014-06-12",2014,6,163,0,16000,16300,32300
"AL","2014-06-13",2014,6,164,9590,16600,16200,42390
"AL","2014-06-14",2014,6,165,3870,16500,16100,36470
"AL","2014-06-15",2014,6,166,0,16000,16000,32000
"AL","2014-06-16",2014,6,167,48200,24800,20700,93700
"AL","2014-06-17",2014,6,168,12200,19300,18100,49600
"AL","2014-06-18",2014,6,169,940,17500,16300,34740
"AL","2014-06-19",2014,6,170,0,16700,16200,32900
"AL","2014-06-20",2014,6,171,0,16300,16100,32400
"AL","2014-06-21",2014,6,172,25600,20000,17300,62900
"AL","2014-06-22",2014,6,173,6150,18100,16400,40650
"AL","2014-06-23",2014,6,174,0,16800,16100,32900
"AL","2014-06-24",2014,6,175,49200,30900,30900,111000
"AL","2014-06-25",2014,6,176,6580,18900,17200,42680
"AL","2014-06-26",2014,6,177,9570,18900,17500,45970
"AL","2014-06-27",2014,6,178,19400,22200,22500,64100
"AL","2014-06-28",2014,6,179,0,17900,16400,34300
"AL","2014-06-29",2014,6,180,74400,38600,46600,159600
"AL","2014-06-30",2014,6,181,23200,25400,28500,77100
"AL","2014-07-01",2014,7,182,782,19400,17400,37582
"AL","2014-07-02",2014,7,183,233,18400,17200,35833
"AL","2014-07-03",2014,7,184,14200,19600,17900,51700
"AL","2014-07-04",2014,7,185,0,18000,17300,35300
"AL","2014-07-05",2014,7,186,482,17600,17400,35482
"AL","2014-07-06",2014,7,187,0,16700,17000,33700
"AL","2014-07-07",2014,7,188,2920,16500,16800,36220
"AL","2014-07-08",2014,7,189,23200,19800,17200,60200
"AL","2014-07-09",2014,7,190,15400,20100,18000,53500
"AL","2014-07-10",2014,7,191,1070,17600,16700,35370
"AL","2014-07-11",2014,7,192,0,16900,16600,33500
"AL","2014-07-12",2014,7,193,0,16700,16400,33100
"AL","2014-07-13",2014,7,194,467,16200,16200,32867
"AL","2014-07-14",2014,7,195,1360,15800,16000,33160
"AL","2014-07-15",2014,7,196,0,15600,15800,31400
"AL","2014-07-16",2014,7,197,14300,17300,15700,47300
"AL","2014-07-17",2014,7,198,131,16300,15500,31931
"AL","2014-07-18",2014,7,199,0,15900,15500,31400
"AL","2014-07-19",2014,7,200,0,15500,15400,30900
"AL","2014-07-20",2014,7,201,0,15300,15200,30500
"AL","2014-07-21",2014,7,202,0,15100,15100,30200
"AL","2014-07-22",2014,7,203,6170,15800,14900,36870
"AL","2014-07-23",2014,7,204,3890,15500,14800,34190
"AL","2014-07-24",2014,7,205,0,14900,14800,29700
"AL","2014-07-25",2014,7,206,0,14800,14700,29500
"AL","2014-07-26",2014,7,207,1050,14700,14600,30350
"AL","2014-07-27",2014,7,208,8550,15700,14500,38750
"AL","2014-07-28",2014,7,209,6710,15600,14400,36710
"AL","2014-07-29",2014,7,210,14900,16900,14400,46200
"AL","2014-07-30",2014,7,211,4450,16100,14400,34950
"AL","2014-07-31",2014,7,212,467,15400,14400,30267
"AL","2014-08-01",2014,8,213,0,15000,14400,29400
"AL","2014-08-02",2014,8,214,0,14800,14400,29200
"AL","2014-08-03",2014,8,215,0,14500,14500,29000
"AL","2014-08-04",2014,8,216,0,14300,14400,28700
"AL","2014-08-05",2014,8,217,10300,15600,14300,40200
"AL","2014-08-06",2014,8,218,6430,15500,14200,36130
"AL","2014-08-07",2014,8,219,0,14800,14200,29000
"AL","2014-08-08",2014,8,220,0,14500,14200,28700
"AL","2014-08-09",2014,8,221,0,14300,14200,28500
"AL","2014-08-10",2014,8,222,0,14100,14100,28200
"AL","2014-08-11",2014,8,223,0,14000,14100,28100
"AL","2014-08-12",2014,8,224,434,13900,14000,28334
"AL","2014-08-13",2014,8,225,47900,20800,14900,83600
"AL","2014-08-14",2014,8,226,0,15500,13800,29300
"AL","2014-08-15",2014,8,227,0,15400,14200,29600
"AL","2014-08-16",2014,8,228,0,14800,14200,29000
"AL","2014-08-17",2014,8,229,0,14300,14100,28400
"AL","2014-08-18",2014,8,230,23900,17200,14100,55200
"AL","2014-08-19",2014,8,231,28200,21400,17000,66600
"AL","2014-08-20",2014,8,232,6740,17000,14700,38440
"AL","2014-08-21",2014,8,233,0,16000,14200,30200
"AL","2014-08-22",2014,8,234,0,15700,14300,30000
"AL","2014-08-23",2014,8,235,351,15200,14200,29751
"AL","2014-08-24",2014,8,236,175,14900,14100,29175
"AL","2014-08-25",2014,8,237,0,14500,14000,28500
"AL","2014-08-26",2014,8,238,33400,19200,16000,68600
"AL","2014-08-27",2014,8,239,0,15600,13900,29500
"AL","2014-08-28",2014,8,240,2060,15300,14000,31360
"AL","2014-08-29",2014,8,241,0,14900,14000,28900
"AL","2014-08-30",2014,8,242,3990,14900,14000,32890
"AL","2014-08-31",2014,8,243,55800,27800,28500,112100
"AL","2014-09-01",2014,9,244,9080,17800,16800,43680
"AL","2014-09-02",2014,9,245,16000,20000,20200,56200
"AL","2014-09-03",2014,9,246,7670,17800,16200,41670
"AL","2014-09-04",2014,9,247,0,16300,14600,30900
"AL","2014-09-05",2014,9,248,47900,29600,32900,110400
"AL","2014-09-06",2014,9,249,61600,37000,43100,141700
"AL","2014-09-07",2014,9,250,0,19200,18800,38000
"AL","2014-09-08",2014,9,251,454,17900,15900,34254
"AL","2014-09-09",2014,9,252,0,17400,15800,33200
"AL","2014-09-10",2014,9,253,948,17100,15700,33748
"AL","2014-09-11",2014,9,254,25100,21400,20500,67000
"AL","2014-09-12",2014,9,255,51100,33300,38000,122400
"AL","2014-09-13",2014,9,256,140,18700,16700,35540
"AL","2014-09-14",2014,9,257,12500,21500,20500,54500
"AL","2014-09-15",2014,9,258,0,18400,16500,34900
"AL","2014-09-16",2014,9,259,0,18000,16600,34600
"AL","2014-09-17",2014,9,260,0,17500,16300,33800
"AL","2014-09-18",2014,9,261,0,17100,16200,33300
"AL","2014-09-19",2014,9,262,0,16800,16000,32800
"AL","2014-09-20",2014,9,263,0,16500,15800,32300
"AL","2014-09-21",2014,9,264,0,16300,15600,31900
"AL","2014-09-22",2014,9,265,15100,18300,16500,49900
"AL","2014-09-23",2014,9,266,0,16700,15400,32100
"AL","2014-09-24",2014,9,267,0,16500,15400,31900
"AL","2014-09-25",2014,9,268,0,16200,15300,31500
"AL","2014-09-26",2014,9,269,5280,16400,15100,36780
"AL","2014-09-27",2014,9,270,0,16300,15200,31500
"AL","2014-09-28",2014,9,271,0,16100,15100,31200
"AL","2014-09-29",2014,9,272,0,15700,15000,30700
"AL","2014-09-30",2014,9,273,3280,15600,14800,33680
"AL","2014-10-01",2014,10,274,2350,15800,14700,32850
"AL","2014-10-02",2014,10,275,2210,15800,14600,32610
"AL","2014-10-03",2014,10,276,4890,16100,14600,35590
"AL","2014-10-04",2014,10,277,40700,24000,21500,86200
"AL","2014-10-05",2014,10,278,23600,24300,25900,73800
"AL","2014-10-06",2014,10,279,4010,18900,18400,41310
"AL","2014-10-07",2014,10,280,0,17400,15300,32700
"AL","2014-10-08",2014,10,281,2120,17400,15400,34920
"AL","2014-10-09",2014,10,282,0,17100,15100,32200
"AL","2014-10-10",2014,10,283,0,17000,15000,32000
"AL","2014-10-11",2014,10,284,0,16800,14900,31700
"AL","2014-10-12",2014,10,285,0,16700,14800,31500
"AL","2014-10-13",2014,10,286,0,16600,14800,31400
"AL","2014-10-14",2014,10,287,1140,16600,14800,32540
"AL","2014-10-15",2014,10,288,47700,30600,32000,110300
"AL","2014-10-16",2014,10,289,9610,20900,20600,51110
"AL","2014-10-17",2014,10,290,0,17900,15900,33800
"AL","2014-10-18",2014,10,291,3220,17900,15700,36820
"AL","2014-10-19",2014,10,292,4680,18300,16000,38980
"AL","2014-10-20",2014,10,293,243,17400,15400,33043
"AL","2014-10-21",2014,10,294,1060,17400,15500,33960
"AL","2014-10-22",2014,10,295,1640,17300,15400,34340
"AL","2014-10-23",2014,10,296,0,16900,15200,32100
"AL","2014-10-24",2014,10,297,1180,16900,15200,33280
"AL","2014-10-25",2014,10,298,6200,17800,15600,39600
"AL","2014-10-26",2014,10,299,0,16900,15400,32300
"AL","2014-10-27",2014,10,300,0,16500,15000,31500
"AL","2014-10-28",2014,10,301,17600,21700,18700,58000
"AL","2014-10-29",2014,10,302,5350,19000,17900,42250
"AL","2014-10-30",2014,10,303,4000,18400,17400,39800
"AL","2014-10-31",2014,10,304,922,17200,15200,33322
"AL","2014-11-01",2014,11,305,15300,17100,14900,47300
"AL","2014-11-02",2014,11,306,0,16900,15100,32000
"AL","2014-11-03",2014,11,307,0,16900,15400,32300
"AL","2014-11-04",2014,11,308,0,18800,18900,37700
"AL","2014-11-05",2014,11,309,5650,17800,16500,39950
"AL","2014-11-06",2014,11,310,675,17100,15600,33375
"AL","2014-11-07",2014,11,311,14400,17500,15900,47800
"AL","2014-11-08",2014,11,312,0,16900,15200,32100
"AL","2014-11-09",2014,11,313,11200,16700,15100,43000
"AL","2014-11-10",2014,11,314,5780,16600,15000,37380
"AL","2014-11-11",2014,11,315,0,16600,15100,31700
"AL","2014-11-12",2014,11,316,38600,16500,14500,69600
"AL","2014-11-13",2014,11,317,20800,16400,14300,51500
"AL","2014-11-14",2014,11,318,7240,16400,14500,38140
"AL","2014-11-15",2014,11,319,2060,16300,14800,33160
"AL","2014-11-16",2014,11,320,0,16300,14900,31200
"AL","2014-11-17",2014,11,321,1250,16300,14900,32450
"AL","2014-11-18",2014,11,322,0,16200,14900,31100
"AL","2014-11-19",2014,11,323,875,16200,14900,31975
"AL","2014-11-20",2014,11,324,2130,16100,14800,33030
"AL","2014-11-21",2014,11,325,980,16100,14900,31980
"AL","2014-11-22",2014,11,326,0,16100,14800,30900
"AL","2014-11-23",2014,11,327,0,16000,14800,30800
"AL","2014-11-24",2014,11,328,524,16000,14800,31324
"AL","2014-11-25",2014,11,329,8830,16200,15300,40330
"AL","2014-11-26",2014,11,330,32400,16000,14200,62600
"AL","2014-11-27",2014,11,331,0,15900,14300,30200
"AL","2014-11-28",2014,11,332,4900,15900,14500,35300
"AL","2014-11-29",2014,11,333,0,15800,14500,30300
"AL","2014-11-30",2014,11,334,1060,15800,14600,31460
"AL","2014-12-01",2014,12,335,0,15700,14600,30300
"AL","2014-12-02",2014,12,336,0,15700,14600,30300
"AL","2014-12-03",2014,12,337,0,15700,14600,30300
"AL","2014-12-04",2014,12,338,1870,15600,14500,31970
"AL","2014-12-05",2014,12,339,0,15600,14500,30100
"AL","2014-12-06",2014,12,340,0,15500,14500,30000
"AL","2014-12-07",2014,12,341,0,15500,14500,30000
"AL","2014-12-08",2014,12,342,0,15500,14400,29900
"AL","2014-12-09",2014,12,343,1180,15400,14400,30980
"AL","2014-12-10",2014,12,344,0,15400,14400,29800
"AL","2014-12-11",2014,12,345,0,15400,14300,29700
"AL","2014-12-12",2014,12,346,0,15300,14300,29600
"AL","2014-12-13",2014,12,347,0,15300,14300,29600
"AL","2014-12-14",2014,12,348,0,15300,14300,29600
"AL","2014-12-15",2014,12,349,361,15200,14200,29761
"AL","2014-12-16",2014,12,350,803,16300,16100,33203
"AL","2014-12-17",2014,12,351,15900,16400,16300,48600
"AL","2014-12-18",2014,12,352,5070,15500,14100,34670
"AL","2014-12-19",2014,12,353,0,15300,14100,29400
"AL","2014-12-20",2014,12,354,0,15300,14100,29400
"AL","2014-12-21",2014,12,355,0,15200,14100,29300
"AL","2014-12-22",2014,12,356,0,15200,14100,29300
"AL","2014-12-23",2014,12,357,7430,15100,14000,36530
"AL","2014-12-24",2014,12,358,3050,15100,13900,32050
"AL","2014-12-25",2014,12,359,7760,15000,13900,36660
"AL","2014-12-26",2014,12,360,0,15000,13900,28900
"AL","2014-12-27",2014,12,361,1900,15000,13900,30800
"AL","2014-12-28",2014,12,362,8450,14900,13800,37150
"AL","2014-12-29",2014,12,363,6530,14900,13700,35130
"AL","2014-12-30",2014,12,364,4680,14800,13700,33180
"AL","2014-12-31",2014,12,365,0,14800,13800,28600
"AL","2015-01-01",2015,1,1,0,14800,13800,28600
"AL","2015-01-02",2015,1,2,2620,14700,13800,31120
"AL","2015-01-03",2015,1,3,488,14700,13700,28888
"AL","2015-01-04",2015,1,4,0,14700,13800,28500
"AL","2015-01-05",2015,1,5,6760,14600,13600,34960
"AL","2015-01-06",2015,1,6,0,14600,13600,28200
"AL","2015-01-07",2015,1,7,0,14600,13700,28300
"AL","2015-01-08",2015,1,8,2440,14500,13600,30540
"AL","2015-01-09",2015,1,9,0,14500,13600,28100
"AL","2015-01-10",2015,1,10,8190,14500,13500,36190
"AL","2015-01-11",2015,1,11,0,14400,13500,27900
"AL","2015-01-12",2015,1,12,0,14400,13500,27900
"AL","2015-01-13",2015,1,13,957,14400,13500,28857
"AL","2015-01-14",2015,1,14,0,14300,13500,27800
"AL","2015-01-15",2015,1,15,312,14300,13500,28112
"AL","2015-01-16",2015,1,16,0,14300,13500,27800
"AL","2015-01-17",2015,1,17,0,14200,13500,27700
"AL","2015-01-18",2015,1,18,0,14200,13400,27600
"AL","2015-01-19",2015,1,19,0,14200,13400,27600
"AL","2015-01-20",2015,1,20,468,14100,13400,27968
"AL","2015-01-21",2015,1,21,1290,14100,13300,28690
"AL","2015-01-22",2015,1,22,0,14100,13300,27400
"AL","2015-01-23",2015,1,23,0,14000,13300,27300
"AL","2015-01-24",2015,1,24,0,14000,13300,27300
"AL","2015-01-25",2015,1,25,0,14000,13300,27300
"AL","2015-01-26",2015,1,26,0,14000,13200,27200
"AL","2015-01-27",2015,1,27,312,13900,13200,27412
"AL","2015-01-28",2015,1,28,9120,13900,13000,36020
"AL","2015-01-29",2015,1,29,0,13900,13000,26900
"AL","2015-01-30",2015,1,30,0,13800,13100,26900
"AL","2015-01-31",2015,1,31,1500,13800,13000,28300
"AL","2015-02-01",2015,2,32,0,13800,13000,26800
"AL","2015-02-02",2015,2,33,0,13800,13000,26800
"AL","2015-02-03",2015,2,34,0,13700,13000,26700
"AL","2015-02-04",2015,2,35,0,13700,13000,26700
"AL","2015-02-05",2015,2,36,340,13700,13000,27040
"AL","2015-02-06",2015,2,37,0,13700,12900,26600
"AL","2015-02-07",2015,2,38,0,13600,12900,26500
"AL","2015-02-08",2015,2,39,0,13600,12900,26500
"AL","2015-02-09",2015,2,40,0,13600,12800,26400
"AL","2015-02-10",2015,2,41,0,13500,12800,26300
"AL","2015-02-11",2015,2,42,0,13500,12800,26300
"AL","2015-02-12",2015,2,43,2590,13500,12700,28790
"AL","2015-02-13",2015,2,44,1560,13500,12700,27760
"AL","2015-02-14",2015,2,45,0,13400,12700,26100
"AL","2015-02-15",2015,2,46,2400,13400,12600,28400
"AL","2015-02-16",2015,2,47,0,13400,12600,26000
"AL","2015-02-17",2015,2,48,0,13300,12600,25900
"AL","2015-02-18",2015,2,49,0,13300,12600,25900
"AL","2015-02-19",2015,2,50,211,13300,12600,26111
"AL","2015-02-20",2015,2,51,0,13300,12600,25900
"AL","2015-02-21",2015,2,52,0,13200,12600,25800
"AL","2015-02-22",2015,2,53,2630,13200,12500,28330
"AL","2015-02-23",2015,2,54,0,13200,12500,25700
"AL","2015-02-24",2015,2,55,0,13200,12500,25700
"AL","2015-02-25",2015,2,56,93.8,13100,12400,25593.8
"AL","2015-02-26",2015,2,57,1150,13100,12400,26650
"AL","2015-02-27",2015,2,58,0,13100,12400,25500
"AL","2015-02-28",2015,2,59,0,13100,12400,25500
"AL","2015-03-01",2015,3,60,0,13000,12400,25400
"AL","2015-03-02",2015,3,61,0,13000,12400,25400
"AL","2015-03-03",2015,3,62,0,13000,12300,25300
"AL","2015-03-04",2015,3,63,0,13000,12300,25300
"AL","2015-03-05",2015,3,64,6660,12900,12200,31760
"AL","2015-03-06",2015,3,65,0,12900,12200,25100
"AL","2015-03-07",2015,3,66,0,12900,12200,25100
"AL","2015-03-08",2015,3,67,0,12900,12200,25100
"AL","2015-03-09",2015,3,68,0,12800,12200,25000
"AL","2015-03-10",2015,3,69,0,12800,12200,25000
"AL","2015-03-11",2015,3,70,0,12800,12300,25100
"AL","2015-03-12",2015,3,71,0,12800,12300,25100
"AL","2015-03-13",2015,3,72,0,12700,12300,25000
"AL","2015-03-14",2015,3,73,0,12700,12300,25000
"AL","2015-03-15",2015,3,74,0,12700,12400,25100
"AL","2015-03-16",2015,3,75,0,13400,13800,27200
"AL","2015-03-17",2015,3,76,0,20100,27000,47100
"AL","2015-03-18",2015,3,77,7630,16300,18800,42730
"AL","2015-03-19",2015,3,78,0,14000,13300,27300
"AL","2015-03-20",2015,3,79,0,14300,13700,28000
"AL","2015-03-21",2015,3,80,0,15200,15500,30700
"AL","2015-03-22",2015,3,81,1900,17000,19900,38800
"AL","2015-03-23",2015,3,82,0,14200,13500,27700
"AL","2015-03-24",2015,3,83,0,13900,12900,26800
"AL","2015-03-25",2015,3,84,0,14000,13800,27800
"AL","2015-03-26",2015,3,85,13000,15700,17200,45900
"AL","2015-03-27",2015,3,86,1160,14000,13300,28460
"AL","2015-03-28",2015,3,87,0,13700,12800,26500
"AL","2015-03-29",2015,3,88,0,13600,12800,26400
"AL","2015-03-30",2015,3,89,0,13500,12700,26200
"AL","2015-03-31",2015,3,90,13400,13400,12500,39300
"AL","2015-04-01",2015,4,91,712,16000,18500,35212
"AL","2015-04-02",2015,4,92,0,19700,25100,44800
"AL","2015-04-03",2015,4,93,5690,39200,66800,111690
"AL","2015-04-04",2015,4,94,0,19200,20600,39800
"AL","2015-04-05",2015,4,95,0,15900,14400,30300
"AL","2015-04-06",2015,4,96,0,16700,15200,31900
"AL","2015-04-07",2015,4,97,20700,17500,17600,55800
"AL","2015-04-08",2015,4,98,628,18100,18000,36728
"AL","2015-04-09",2015,4,99,5380,16800,15600,37780
"AL","2015-04-10",2015,4,100,28000,20200,22800,71000
"AL","2015-04-11",2015,4,101,33500,19100,19800,72400
"AL","2015-04-12",2015,4,102,0,19200,20500,39700
"AL","2015-04-13",2015,4,103,0,19000,19600,38600
"AL","2015-04-14",2015,4,104,11700,18800,18300,48800
"AL","2015-04-15",2015,4,105,0,15900,14600,30500
"AL","2015-04-16",2015,4,106,0,15700,14500,30200
"AL","2015-04-17",2015,4,107,0,15500,14400,29900
"AL","2015-04-18",2015,4,108,0,15300,14300,29600
"AL","2015-04-19",2015,4,109,0,15200,14200,29400
"AL","2015-04-20",2015,4,110,2940,15400,14200,32540
"AL","2015-04-21",2015,4,111,9470,16500,14400,40370
"AL","2015-04-22",2015,4,112,21800,16700,16300,54800
"AL","2015-04-23",2015,4,113,15100,17100,18100,50300
"AL","2015-04-24",2015,4,114,2190,15700,14800,32690
"AL","2015-04-25",2015,4,115,0,17200,18500,35700
"AL","2015-04-26",2015,4,116,512,16800,15800,33112
"AL","2015-04-27",2015,4,117,0,15300,14200,29500
"AL","2015-04-28",2015,4,118,0,15200,14200,29400
"AL","2015-04-29",2015,4,119,0,15100,14100,29200
"AL","2015-04-30",2015,4,120,0,15000,13900,28900
"AL","2015-05-01",2015,5,121,0,14900,13900,28800
"AL","2015-05-02",2015,5,122,0,14800,13900,28700
"AL","2015-05-03",2015,5,123,0,14800,13900,28700
"AL","2015-05-04",2015,5,124,0,14700,13900,28600
"AL","2015-05-05",2015,5,125,31200,22100,21600,74900
"AL","2015-05-06",2015,5,126,0,15100,13600,28700
"AL","2015-05-07",2015,5,127,2240,15200,13700,31140
"AL","2015-05-08",2015,5,128,10400,16800,14000,41200
"AL","2015-05-09",2015,5,129,12600,16600,15100,44300
"AL","2015-05-10",2015,5,130,1960,15100,13800,30860
"AL","2015-05-11",2015,5,131,0,14400,13700,28100
"AL","2015-05-12",2015,5,132,16300,16400,15700,48400
"AL","2015-05-13",2015,5,133,10700,17200,16700,44600
"AL","2015-05-14",2015,5,134,3420,15400,14300,33120
"AL","2015-05-15",2015,5,135,0,14700,13900,28600
"AL","2015-05-16",2015,5,136,31700,22300,25200,79200
"AL","2015-05-17",2015,5,137,254,15200,14400,29854
"AL","2015-05-18",2015,5,138,0,14700,14000,28700
"AL","2015-05-19",2015,5,139,5890,14900,14000,34790
"AL","2015-05-20",2015,5,140,597,14300,13900,28797
"AL","2015-05-21",2015,5,141,0,14100,13800,27900
"AL","2015-05-22",2015,5,142,0,14100,13800,27900
"AL","2015-05-23",2015,5,143,0,13700,13700,27400
"AL","2015-05-24",2015,5,144,0,13300,13500,26800
"AL","2015-05-25",2015,5,145,0,13100,13400,26500
"AL","2015-05-26",2015,5,146,59900,22300,18800,101000
"AL","2015-05-27",2015,5,147,11900,17100,16100,45100
"AL","2015-05-28",2015,5,148,43500,27800,31200,102500
"AL","2015-05-29",2015,5,149,4780,17200,15400,37380
"AL","2015-05-30",2015,5,150,208,15400,14100,29708
"AL","2015-05-31",2015,5,151,32400,22500,21300,76200
"AL","2015-06-01",2015,6,152,1450,16300,14200,31950
"AL","2015-06-02",2015,6,153,0,15700,14300,30000
"AL","2015-06-03",2015,6,154,0,15400,14300,29700
"AL","2015-06-04",2015,6,155,0,14800,14200,29000
"AL","2015-06-05",2015,6,156,81500,36600,42300,160400
"AL","2015-06-06",2015,6,157,2880,17700,17200,37780
"AL","2015-06-07",2015,6,158,0,16300,14900,31200
"AL","2015-06-08",2015,6,159,33900,24900,25700,84500
"AL","2015-06-09",2015,6,160,3500,17400,15400,36300
"AL","2015-06-10",2015,6,161,1980,16600,15300,33880
"AL","2015-06-11",2015,6,162,5680,16700,15300,37680
"AL","2015-06-12",2015,6,163,0,15700,15200,30900
"AL","2015-06-13",2015,6,164,414,15400,15000,30814
"AL","2015-06-14",2015,6,165,0,15100,14900,30000
"AL","2015-06-15",2015,6,166,18300,16800,15100,50200
"AL","2015-06-16",2015,6,167,0,15400,14700,30100
"AL","2015-06-17",2015,6,168,27100,19300,18100,64500
"AL","2015-06-18",2015,6,169,854,15900,14700,31454
"AL","2015-06-19",2015,6,170,10300,16800,15500,42600
"AL","2015-06-20",2015,6,171,0,15400,14800,30200
"AL","2015-06-21",2015,6,172,0,14800,14600,29400
"AL","2015-06-22",2015,6,173,21700,17700,15900,55300
"AL","2015-06-23",2015,6,174,30200,25200,23700,79100
"AL","2015-06-24",2015,6,175,30400,24300,26300,81000
"AL","2015-06-25",2015,6,176,0,16700,14800,31500
"AL","2015-06-26",2015,6,177,16000,18800,17800,52600
"AL","2015-06-27",2015,6,178,5820,17500,15400,38720
"AL","2015-06-28",2015,6,179,0,16200,15100,31300
"AL","2015-06-29",2015,6,180,0,15700,15000,30700
"AL","2015-06-30",2015,6,181,6330,15800,14800,36930
"AL","2015-07-01",2015,7,182,9900,16500,14900,41300
"AL","2015-07-02",2015,7,183,0,15400,14700,30100
"AL","2015-07-03",2015,7,184,0,15200,14800,30000
"AL","2015-07-04",2015,7,185,0,14500,14600,29100
"AL","2015-07-05",2015,7,186,12800,15700,14500,43000
"AL","2015-07-06",2015,7,187,0,14600,14400,29000
"AL","2015-07-07",2015,7,188,5130,14700,14300,34130
"AL","2015-07-08",2015,7,189,24900,17900,14800,57600
"AL","2015-07-09",2015,7,190,0,15300,14200,29500
"AL","2015-07-10",2015,7,191,0,14800,14300,29100
"AL","2015-07-11",2015,7,192,0,14400,14200,28600
"AL","2015-07-12",2015,7,193,0,14100,14100,28200
"AL","2015-07-13",2015,7,194,0,14000,14000,28000
"AL","2015-07-14",2015,7,195,23400,16700,14000,54100
"AL","2015-07-15",2015,7,196,25600,19100,14600,59300
"AL","2015-07-16",2015,7,197,0,15300,13900,29200
"AL","2015-07-17",2015,7,198,0,14600,14000,28600
"AL","2015-07-18",2015,7,199,24000,17500,14200,55700
"AL","2015-07-19",2015,7,200,8630,16500,14000,39130
"AL","2015-07-20",2015,7,201,993,15200,14000,30193
"AL","2015-07-21",2015,7,202,20500,19000,15300,54800
"AL","2015-07-22",2015,7,203,0,15400,14000,29400
"AL","2015-07-23",2015,7,204,0,14900,14000,28900
"AL","2015-07-24",2015,7,205,0,14500,13900,28400
"AL","2015-07-25",2015,7,206,0,14200,13900,28100
"AL","2015-07-26",2015,7,207,47000,21400,17700,86100
"AL","2015-07-27",2015,7,208,0,15600,13700,29300
"AL","2015-07-28",2015,7,209,0,15100,14100,29200
"AL","2015-07-29",2015,7,210,0,14300,13900,28200
"AL","2015-07-30",2015,7,211,394,14200,13700,28294
"AL","2015-07-31",2015,7,212,0,14000,13500,27500
"AL","2015-08-01",2015,8,213,5770,14400,13400,33570
"AL","2015-08-02",2015,8,214,6170,14700,13300,34170
"AL","2015-08-03",2015,8,215,0,14100,13200,27300
"AL","2015-08-04",2015,8,216,8620,15100,13200,36920
"AL","2015-08-05",2015,8,217,1950,14700,13200,29850
"AL","2015-08-06",2015,8,218,0,14200,13200,27400
"AL","2015-08-07",2015,8,219,0,14000,13200,27200
"AL","2015-08-08",2015,8,220,25700,17300,13400,56400
"AL","2015-08-09",2015,8,221,8170,15900,13200,37270
"AL","2015-08-10",2015,8,222,9120,15800,13500,38420
"AL","2015-08-11",2015,8,223,11900,16600,13600,42100
"AL","2015-08-12",2015,8,224,0,14900,13300,28200
"AL","2015-08-13",2015,8,225,0,14600,13400,28000
"AL","2015-08-14",2015,8,226,0,14000,13300,27300
"AL","2015-08-15",2015,8,227,0,13700,13200,26900
"AL","2015-08-16",2015,8,228,0,13600,13300,26900
"AL","2015-08-17",2015,8,229,0,13500,13200,26700
"AL","2015-08-18",2015,8,230,14100,15100,13000,42200
"AL","2015-08-19",2015,8,231,4270,14600,12900,31770
"AL","2015-08-20",2015,8,232,27900,18400,13400,59700
"AL","2015-08-21",2015,8,233,15900,17300,13300,46500
"AL","2015-08-22",2015,8,234,4380,15600,13000,32980
"AL","2015-08-23",2015,8,235,0,14900,13100,28000
"AL","2015-08-24",2015,8,236,15100,16500,13400,45000
"AL","2015-08-25",2015,8,237,45500,28400,27100,101000
"AL","2015-08-26",2015,8,238,395,16200,14100,30695
"AL","2015-08-27",2015,8,239,0,15900,13400,29300
"AL","2015-08-28",2015,8,240,0,15700,13600,29300
"AL","2015-08-29",2015,8,241,0,15000,13500,28500
"AL","2015-08-30",2015,8,242,0,14400,13200,27600
"AL","2015-08-31",2015,8,243,0,14200,13100,27300
"AL","2015-09-01",2015,9,244,0,14000,13000,27000
"AL","2015-09-02",2015,9,245,0,13900,13000,26900
"AL","2015-09-03",2015,9,246,7690,14200,12900,34790
"AL","2015-09-04",2015,9,247,38700,20600,14500,73800
"AL","2015-09-05",2015,9,248,0,15200,12700,27900
"AL","2015-09-06",2015,9,249,0,14900,13000,27900
"AL","2015-09-07",2015,9,250,0,14400,12900,27300
"AL","2015-09-08",2015,9,251,16400,16000,13000,45400
"AL","2015-09-09",2015,9,252,2070,14900,12900,29870
"AL","2015-09-10",2015,9,253,6910,15400,12900,35210
"AL","2015-09-11",2015,9,254,3790,15100,12900,31790
"AL","2015-09-12",2015,9,255,0,14500,12800,27300
"AL","2015-09-13",2015,9,256,247,14400,12800,27447
"AL","2015-09-14",2015,9,257,0,14200,12700,26900
"AL","2015-09-15",2015,9,258,0,14000,12700,26700
"AL","2015-09-16",2015,9,259,0,13800,12600,26400
"AL","2015-09-17",2015,9,260,110,13600,12600,26310
"AL","2015-09-18",2015,9,261,0,13300,12600,25900
"AL","2015-09-19",2015,9,262,12500,14500,12500,39500
"AL","2015-09-20",2015,9,263,6020,14600,12400,33020
"AL","2015-09-21",2015,9,264,0,13900,12400,26300
"AL","2015-09-22",2015,9,265,0,13800,12400,26200
"AL","2015-09-23",2015,9,266,0,13600,12400,26000
"AL","2015-09-24",2015,9,267,550,13300,12300,26150
"AL","2015-09-25",2015,9,268,701,13200,12300,26201
"AL","2015-09-26",2015,9,269,467,13000,12200,25667
"AL","2015-09-27",2015,9,270,0,12900,12200,25100
"AL","2015-09-28",2015,9,271,0,12900,12200,25100
"AL","2015-09-29",2015,9,272,1100,12800,12100,26000
"AL","2015-09-30",2015,9,273,3420,13100,12000,28520
"AL","2015-10-01",2015,10,274,0,12900,12000,24900
