"Lake","Date","Year","Month","DOY","Precip","SW_Inflw","TOTAL_GW_INTO_LAKE","Total_Inputs"
"TR","1975-09-30",1975,9,273,0,0,0,0
"TR","1975-10-01",1975,10,274,34000,39400,22100,95500
"TR","1975-10-02",1975,10,275,19600,36100,22400,78100
"TR","1975-10-03",1975,10,276,0,35400,22700,58100
"TR","1975-10-04",1975,10,277,0,34800,23100,57900
"TR","1975-10-05",1975,10,278,0,34400,23400,57800
"TR","1975-10-06",1975,10,279,0,34200,23800,58000
"TR","1975-10-07",1975,10,280,0,34100,24200,58300
"TR","1975-10-08",1975,10,281,0,33900,24400,58300
"TR","1975-10-09",1975,10,282,0,33800,24600,58400
"TR","1975-10-10",1975,10,283,0,33600,24800,58400
"TR","1975-10-11",1975,10,284,20900,33900,24900,79700
"TR","1975-10-12",1975,10,285,3470,33900,24900,62270
"TR","1975-10-13",1975,10,286,38600,34400,24900,97900
"TR","1975-10-14",1975,10,287,22100,34600,24800,81500
"TR","1975-10-15",1975,10,288,20900,34500,24900,80300
"TR","1975-10-16",1975,10,289,0,34200,25000,59200
"TR","1975-10-17",1975,10,290,0,34200,25000,59200
"TR","1975-10-18",1975,10,291,0,34200,25000,59200
"TR","1975-10-19",1975,10,292,0,34200,25000,59200
"TR","1975-10-20",1975,10,293,0,34200,25100,59300
"TR","1975-10-21",1975,10,294,0,34200,25100,59300
"TR","1975-10-22",1975,10,295,0,34100,25200,59300
"TR","1975-10-23",1975,10,296,8050,34200,25200,67450
"TR","1975-10-24",1975,10,297,187000,38000,25000,250000
"TR","1975-10-25",1975,10,298,171000,40200,24300,235500
"TR","1975-10-26",1975,10,299,275000,45700,24200,344900
"TR","1975-10-27",1975,10,300,0,43000,23100,66100
"TR","1975-10-28",1975,10,301,0,42300,23900,66200
"TR","1975-10-29",1975,10,302,0,41700,24400,66100
"TR","1975-10-30",1975,10,303,0,41400,24600,66000
"TR","1975-10-31",1975,10,304,0,41100,24800,65900
"TR","1975-11-01",1975,11,305,0,40900,24900,65800
"TR","1975-11-02",1975,11,306,0,40600,25100,65700
"TR","1975-11-03",1975,11,307,0,40200,25200,65400
"TR","1975-11-04",1975,11,308,0,39800,25200,65000
"TR","1975-11-05",1975,11,309,0,39400,25200,64600
"TR","1975-11-06",1975,11,310,0,39000,25200,64200
"TR","1975-11-07",1975,11,311,0,38700,25400,64100
"TR","1975-11-08",1975,11,312,13400,38600,25600,77600
"TR","1975-11-09",1975,11,313,52800,39700,25600,118100
"TR","1975-11-10",1975,11,314,42100,40000,25400,107500
"TR","1975-11-11",1975,11,315,1030000,53000,23200,1106200
"TR","1975-11-12",1975,11,316,14500,50700,27000,92200
"TR","1975-11-13",1975,11,317,192000,55600,30700,278300
"TR","1975-11-14",1975,11,318,21300,52900,22500,96700
"TR","1975-11-15",1975,11,319,0,50400,22500,72900
"TR","1975-11-16",1975,11,320,0,48200,22900,71100
"TR","1975-11-17",1975,11,321,0,48400,27100,75500
"TR","1975-11-18",1975,11,322,0,49000,31400,80400
"TR","1975-11-19",1975,11,323,0,49400,32900,82300
"TR","1975-11-20",1975,11,324,14400,71900,56900,143200
"TR","1975-11-21",1975,11,325,114000,58800,34500,207300
"TR","1975-11-22",1975,11,326,266000,61100,23200,350300
"TR","1975-11-23",1975,11,327,0,57100,23100,80200
"TR","1975-11-24",1975,11,328,0,54000,23500,77500
"TR","1975-11-25",1975,11,329,0,51700,23800,75500
"TR","1975-11-26",1975,11,330,0,50300,24000,74300
"TR","1975-11-27",1975,11,331,0,49800,24200,74000
"TR","1975-11-28",1975,11,332,0,49300,24400,73700
"TR","1975-11-29",1975,11,333,0,48800,24600,73400
"TR","1975-11-30",1975,11,334,133000,49200,24200,206400
"TR","1975-12-01",1975,12,335,401000,56700,22800,480500
"TR","1975-12-02",1975,12,336,11200,54300,22700,88200
"TR","1975-12-03",1975,12,337,0,52000,23100,75100
"TR","1975-12-04",1975,12,338,0,50200,23400,73600
"TR","1975-12-05",1975,12,339,18100,49500,23600,91200
"TR","1975-12-06",1975,12,340,0,49100,23800,72900
"TR","1975-12-07",1975,12,341,6060,48600,24000,78660
"TR","1975-12-08",1975,12,342,0,48200,24200,72400
"TR","1975-12-09",1975,12,343,0,47800,24300,72100
"TR","1975-12-10",1975,12,344,0,47500,24500,72000
"TR","1975-12-11",1975,12,345,38900,47400,24400,110700
"TR","1975-12-12",1975,12,346,3640,47100,24400,75140
"TR","1975-12-13",1975,12,347,0,46800,24600,71400
"TR","1975-12-14",1975,12,348,0,46500,24700,71200
"TR","1975-12-15",1975,12,349,274000,48100,23600,345700
"TR","1975-12-16",1975,12,350,67900,48400,23300,139600
"TR","1975-12-17",1975,12,351,0,48000,23500,71500
"TR","1975-12-18",1975,12,352,0,47700,23800,71500
"TR","1975-12-19",1975,12,353,0,47300,24000,71300
"TR","1975-12-20",1975,12,354,0,47000,24200,71200
"TR","1975-12-21",1975,12,355,60600,47100,24100,131800
"TR","1975-12-22",1975,12,356,1210,46800,24200,72210
"TR","1975-12-23",1975,12,357,0,46500,24300,70800
"TR","1975-12-24",1975,12,358,0,46200,24500,70700
"TR","1975-12-25",1975,12,359,0,45900,24600,70500
"TR","1975-12-26",1975,12,360,6000,45700,24600,76300
"TR","1975-12-27",1975,12,361,1210,45500,24700,71410
"TR","1975-12-28",1975,12,362,0,45200,24700,69900
"TR","1975-12-29",1975,12,363,0,45000,24800,69800
"TR","1975-12-30",1975,12,364,0,44800,24800,69600
"TR","1975-12-31",1975,12,365,0,44600,24900,69500
"TR","1976-01-01",1976,1,1,0,44300,24900,69200
"TR","1976-01-02",1976,1,2,0,44100,25000,69100
"TR","1976-01-03",1976,1,3,177000,45000,24200,246200
"TR","1976-01-04",1976,1,4,30100,45100,24000,99200
"TR","1976-01-05",1976,1,5,0,44900,24200,69100
"TR","1976-01-06",1976,1,6,0,44600,24400,69000
"TR","1976-01-07",1976,1,7,75200,45000,24200,144400
"TR","1976-01-08",1976,1,8,43300,45100,24000,112400
"TR","1976-01-09",1976,1,9,0,44800,24100,68900
"TR","1976-01-10",1976,1,10,0,44600,24300,68900
"TR","1976-01-11",1976,1,11,0,44400,24400,68800
"TR","1976-01-12",1976,1,12,169000,45300,23800,238100
"TR","1976-01-13",1976,1,13,0,45100,23800,68900
"TR","1976-01-14",1976,1,14,0,44900,24000,68900
"TR","1976-01-15",1976,1,15,0,44600,24200,68800
"TR","1976-01-16",1976,1,16,18800,44500,24200,87500
"TR","1976-01-17",1976,1,17,40100,44500,24100,108700
"TR","1976-01-18",1976,1,18,0,44300,24200,68500
"TR","1976-01-19",1976,1,19,0,44100,24300,68400
"TR","1976-01-20",1976,1,20,112000,44600,23900,180500
"TR","1976-01-21",1976,1,21,56100,44800,23600,124500
"TR","1976-01-22",1976,1,22,33700,44800,23600,102100
"TR","1976-01-23",1976,1,23,6070,44600,23800,74470
"TR","1976-01-24",1976,1,24,69100,44800,23600,137500
"TR","1976-01-25",1976,1,25,74800,45100,23400,143300
"TR","1976-01-26",1976,1,26,34400,45100,23400,102900
"TR","1976-01-27",1976,1,27,14200,44900,23500,82600
"TR","1976-01-28",1976,1,28,0,44600,23700,68300
"TR","1976-01-29",1976,1,29,6070,44400,23800,74270
"TR","1976-01-30",1976,1,30,104000,44800,23500,172300
"TR","1976-01-31",1976,1,31,114000,45300,23000,182300
"TR","1976-02-01",1976,2,32,0,45000,23100,68100
"TR","1976-02-02",1976,2,33,27400,44900,23300,95600
"TR","1976-02-03",1976,2,34,0,44600,23400,68000
"TR","1976-02-04",1976,2,35,9750,44400,23600,77750
"TR","1976-02-05",1976,2,36,21700,44300,23600,89600
"TR","1976-02-06",1976,2,37,0,44000,23700,67700
"TR","1976-02-07",1976,2,38,0,43800,23800,67600
"TR","1976-02-08",1976,2,39,0,43500,23900,67400
"TR","1976-02-09",1976,2,40,0,43300,24000,67300
"TR","1976-02-10",1976,2,41,0,43000,24000,67000
"TR","1976-02-11",1976,2,42,14600,42900,24000,81500
"TR","1976-02-12",1976,2,43,7120,42700,24000,73820
"TR","1976-02-13",1976,2,44,0,42500,24100,66600
"TR","1976-02-14",1976,2,45,0,42300,24100,66400
"TR","1976-02-15",1976,2,46,0,42100,24100,66200
"TR","1976-02-16",1976,2,47,217000,43400,23300,283700
"TR","1976-02-17",1976,2,48,2430,43200,23100,68730
"TR","1976-02-18",1976,2,49,0,43000,23400,66400
"TR","1976-02-19",1976,2,50,33000,43000,23400,99400
"TR","1976-02-20",1976,2,51,28600,42900,23400,94900
"TR","1976-02-21",1976,2,52,7980,42700,23500,74180
"TR","1976-02-22",1976,2,53,0,42500,23600,66100
"TR","1976-02-23",1976,2,54,3380,42300,23700,69380
"TR","1976-02-24",1976,2,55,0,42100,23800,65900
"TR","1976-02-25",1976,2,56,0,41800,23900,65700
"TR","1976-02-26",1976,2,57,0,41600,23900,65500
"TR","1976-02-27",1976,2,58,0,41400,24000,65400
"TR","1976-02-28",1976,2,59,0,41200,24000,65200
"TR","1976-02-29",1976,2,60,0,41000,24000,65000
"TR","1976-03-01",1976,3,61,9630,40900,24000,74530
"TR","1976-03-02",1976,3,62,99300,41200,23600,164100
"TR","1976-03-03",1976,3,63,221000,42700,22700,286400
"TR","1976-03-04",1976,3,64,15600,42600,22600,80800
"TR","1976-03-05",1976,3,65,29000,42500,22800,94300
"TR","1976-03-06",1976,3,66,146000,43400,22400,211800
"TR","1976-03-07",1976,3,67,0,43100,22500,65600
"TR","1976-03-08",1976,3,68,8930,42900,22700,74530
"TR","1976-03-09",1976,3,69,0,42600,22900,65500
"TR","1976-03-10",1976,3,70,0,42300,23100,65400
"TR","1976-03-11",1976,3,71,0,42000,23300,65300
"TR","1976-03-12",1976,3,72,0,41700,23400,65100
"TR","1976-03-13",1976,3,73,284000,43200,22300,349500
"TR","1976-03-14",1976,3,74,90000,43600,21900,155500
"TR","1976-03-15",1976,3,75,0,43200,22100,65300
"TR","1976-03-16",1976,3,76,0,42900,22400,65300
"TR","1976-03-17",1976,3,77,10300,42600,22600,75500
"TR","1976-03-18",1976,3,78,2230,42300,22800,67330
"TR","1976-03-19",1976,3,79,27900,42000,22900,92800
"TR","1976-03-20",1976,3,80,0,41600,23100,64700
"TR","1976-03-21",1976,3,81,0,41100,23300,64400
"TR","1976-03-22",1976,3,82,0,40700,23500,64200
"TR","1976-03-23",1976,3,83,0,40400,23600,64000
"TR","1976-03-24",1976,3,84,0,40100,23600,63700
"TR","1976-03-25",1976,3,85,0,39700,23800,63500
"TR","1976-03-26",1976,3,86,4460,39300,23800,67560
"TR","1976-03-27",1976,3,87,6700,39000,23900,69600
"TR","1976-03-28",1976,3,88,11600,40200,23900,75700
"TR","1976-03-29",1976,3,89,13100,40600,23900,77600
"TR","1976-03-30",1976,3,90,29500,43900,33500,106900
"TR","1976-03-31",1976,3,91,272000,75200,136000,483200
"TR","1976-04-01",1976,4,92,81000,50200,29600,160800
"TR","1976-04-02",1976,4,93,19300,49500,27700,96500
"TR","1976-04-03",1976,4,94,0,49200,28100,77300
"TR","1976-04-04",1976,4,95,0,50500,34100,84600
"TR","1976-04-05",1976,4,96,0,49200,27500,76700
"TR","1976-04-06",1976,4,97,0,50200,31600,81800
"TR","1976-04-07",1976,4,98,0,51000,35100,86100
"TR","1976-04-08",1976,4,99,0,51100,34100,85200
"TR","1976-04-09",1976,4,100,0,50900,31500,82400
"TR","1976-04-10",1976,4,101,0,52500,34800,87300
"TR","1976-04-11",1976,4,102,54700,128000,255000,437700
"TR","1976-04-12",1976,4,103,4920,85700,40900,131520
"TR","1976-04-13",1976,4,104,0,76600,30900,107500
"TR","1976-04-14",1976,4,105,0,74100,38600,112700
"TR","1976-04-15",1976,4,106,16000,98700,152000,266700
"TR","1976-04-16",1976,4,107,0,89900,54100,144000
"TR","1976-04-17",1976,4,108,9120,84100,27700,120920
"TR","1976-04-18",1976,4,109,0,79600,28000,107600
"TR","1976-04-19",1976,4,110,88600,78700,28800,196100
"TR","1976-04-20",1976,4,111,103000,76900,29500,209400
"TR","1976-04-21",1976,4,112,0,69600,29000,98600
"TR","1976-04-22",1976,4,113,102000,69500,30400,201900
"TR","1976-04-23",1976,4,114,127000,73400,37200,237600
"TR","1976-04-24",1976,4,115,0,66400,29400,95800
"TR","1976-04-25",1976,4,116,0,62200,29700,91900
"TR","1976-04-26",1976,4,117,0,59000,29800,88800
"TR","1976-04-27",1976,4,118,0,56700,29900,86600
"TR","1976-04-28",1976,4,119,0,54900,29900,84800
"TR","1976-04-29",1976,4,120,0,53300,30000,83300
"TR","1976-04-30",1976,4,121,0,52000,30100,82100
"TR","1976-05-01",1976,5,122,39500,52100,30100,121700
"TR","1976-05-02",1976,5,123,84700,54600,30500,169800
"TR","1976-05-03",1976,5,124,268000,68300,38300,374600
"TR","1976-05-04",1976,5,125,52000,62700,32800,147500
"TR","1976-05-05",1976,5,126,0,58500,29900,88400
"TR","1976-05-06",1976,5,127,0,55200,30400,85600
"TR","1976-05-07",1976,5,128,4780,53300,30100,88180
"TR","1976-05-08",1976,5,129,0,51900,30100,82000
"TR","1976-05-09",1976,5,130,0,50600,30100,80700
"TR","1976-05-10",1976,5,131,0,49600,30200,79800
"TR","1976-05-11",1976,5,132,0,48300,30000,78300
"TR","1976-05-12",1976,5,133,0,47500,30000,77500
"TR","1976-05-13",1976,5,134,0,46600,29800,76400
"TR","1976-05-14",1976,5,135,0,46000,29800,75800
"TR","1976-05-15",1976,5,136,4780,45600,29800,80180
"TR","1976-05-16",1976,5,137,0,44900,29900,74800
"TR","1976-05-17",1976,5,138,211000,48300,30000,289300
"TR","1976-05-18",1976,5,139,55800,47600,29300,132700
"TR","1976-05-19",1976,5,140,0,46700,29200,75900
"TR","1976-05-20",1976,5,141,0,46000,29400,75400
"TR","1976-05-21",1976,5,142,0,44800,29600,74400
"TR","1976-05-22",1976,5,143,0,43900,29500,73400
"TR","1976-05-23",1976,5,144,0,43400,29500,72900
"TR","1976-05-24",1976,5,145,0,42900,29500,72400
"TR","1976-05-25",1976,5,146,0,42500,29400,71900
"TR","1976-05-26",1976,5,147,0,42200,29400,71600
"TR","1976-05-27",1976,5,148,0,41600,29500,71100
"TR","1976-05-28",1976,5,149,0,40900,29500,70400
"TR","1976-05-29",1976,5,150,0,40500,29400,69900
"TR","1976-05-30",1976,5,151,173000,43000,29200,245200
"TR","1976-05-31",1976,5,152,271000,47800,29100,347900
"TR","1976-06-01",1976,6,153,42300,45700,28100,116100
"TR","1976-06-02",1976,6,154,0,44500,28300,72800
"TR","1976-06-03",1976,6,155,0,43800,28600,72400
"TR","1976-06-04",1976,6,156,0,42900,29000,71900
"TR","1976-06-05",1976,6,157,0,42000,29300,71300
"TR","1976-06-06",1976,6,158,0,41100,29500,70600
"TR","1976-06-07",1976,6,159,0,40400,29600,70000
"TR","1976-06-08",1976,6,160,0,39800,29700,69500
"TR","1976-06-09",1976,6,161,92500,40900,29500,162900
"TR","1976-06-10",1976,6,162,50100,40900,29300,120300
"TR","1976-06-11",1976,6,163,0,40000,29200,69200
"TR","1976-06-12",1976,6,164,210000,43900,29200,283100
"TR","1976-06-13",1976,6,165,0,42200,28600,70800
"TR","1976-06-14",1976,6,166,357000,48900,29300,435200
"TR","1976-06-15",1976,6,167,22300,45500,28000,95800
"TR","1976-06-16",1976,6,168,538000,61800,29200,629000
"TR","1976-06-17",1976,6,169,46100,51600,26700,124400
"TR","1976-06-18",1976,6,170,0,48500,27000,75500
"TR","1976-06-19",1976,6,171,324000,60800,28000,412800
"TR","1976-06-20",1976,6,172,57200,55400,26900,139500
"TR","1976-06-21",1976,6,173,9770,52000,27000,88770
"TR","1976-06-22",1976,6,174,0,48700,27500,76200
"TR","1976-06-23",1976,6,175,0,47400,27800,75200
"TR","1976-06-24",1976,6,176,0,46400,27900,74300
"TR","1976-06-25",1976,6,177,0,45500,27900,73400
"TR","1976-06-26",1976,6,178,72100,46000,28000,146100
"TR","1976-06-27",1976,6,179,0,44900,27700,72600
"TR","1976-06-28",1976,6,180,6630,44200,27900,78730
"TR","1976-06-29",1976,6,181,0,43400,27900,71300
"TR","1976-06-30",1976,6,182,397000,52700,28400,478100
"TR","1976-07-01",1976,7,183,14300,47400,27100,88800
"TR","1976-07-02",1976,7,184,0,45900,27200,73100
"TR","1976-07-03",1976,7,185,0,44500,27400,71900
"TR","1976-07-04",1976,7,186,0,42800,27300,70100
"TR","1976-07-05",1976,7,187,0,41400,27400,68800
"TR","1976-07-06",1976,7,188,0,40000,27400,67400
"TR","1976-07-07",1976,7,189,0,38600,27500,66100
"TR","1976-07-08",1976,7,190,75900,39100,27300,142300
"TR","1976-07-09",1976,7,191,0,37900,27000,64900
"TR","1976-07-10",1976,7,192,0,37200,27100,64300
"TR","1976-07-11",1976,7,193,0,36300,27200,63500
"TR","1976-07-12",1976,7,194,11500,35800,27200,74500
"TR","1976-07-13",1976,7,195,0,34800,27200,62000
"TR","1976-07-14",1976,7,196,0,34300,27200,61500
"TR","1976-07-15",1976,7,197,0,33700,27200,60900
"TR","1976-07-16",1976,7,198,5610,33300,27200,66110
"TR","1976-07-17",1976,7,199,18500,33200,27100,78800
"TR","1976-07-18",1976,7,200,0,32900,27000,59900
"TR","1976-07-19",1976,7,201,0,32200,27100,59300
"TR","1976-07-20",1976,7,202,0,31800,27200,59000
"TR","1976-07-21",1976,7,203,264000,36200,26900,327100
"TR","1976-07-22",1976,7,204,0,34600,25800,60400
"TR","1976-07-23",1976,7,205,0,33500,26200,59700
"TR","1976-07-24",1976,7,206,0,32600,26400,59000
"TR","1976-07-25",1976,7,207,0,32000,26500,58500
"TR","1976-07-26",1976,7,208,0,31600,26600,58200
"TR","1976-07-27",1976,7,209,0,31200,26600,57800
"TR","1976-07-28",1976,7,210,0,30900,26600,57500
"TR","1976-07-29",1976,7,211,35000,31100,26500,92600
"TR","1976-07-30",1976,7,212,0,30600,26500,57100
"TR","1976-07-31",1976,7,213,18200,30500,26500,75200
"TR","1976-08-01",1976,8,214,120000,32400,26300,178700
"TR","1976-08-02",1976,8,215,0,31500,26100,57600
"TR","1976-08-03",1976,8,216,0,30800,26600,57400
"TR","1976-08-04",1976,8,217,0,30300,26900,57200
"TR","1976-08-05",1976,8,218,183000,33000,26700,242700
"TR","1976-08-06",1976,8,219,996000,60100,67000,1123100
"TR","1976-08-07",1976,8,220,0,47100,22300,69400
"TR","1976-08-08",1976,8,221,0,46100,23100,69200
"TR","1976-08-09",1976,8,222,0,44900,24400,69300
"TR","1976-08-10",1976,8,223,0,43700,24900,68600
"TR","1976-08-11",1976,8,224,85800,44100,25400,155300
"TR","1976-08-12",1976,8,225,96600,45000,25600,167200
"TR","1976-08-13",1976,8,226,0,43300,25500,68800
"TR","1976-08-14",1976,8,227,35800,42800,25700,104300
"TR","1976-08-15",1976,8,228,0,41800,25800,67600
"TR","1976-08-16",1976,8,229,0,41000,25900,66900
"TR","1976-08-17",1976,8,230,0,40100,26200,66300
"TR","1976-08-18",1976,8,231,0,38900,26500,65400
"TR","1976-08-19",1976,8,232,0,37500,26800,64300
"TR","1976-08-20",1976,8,233,0,36500,26800,63300
"TR","1976-08-21",1976,8,234,0,35700,26800,62500
"TR","1976-08-22",1976,8,235,0,35000,26900,61900
"TR","1976-08-23",1976,8,236,0,34400,26900,61300
"TR","1976-08-24",1976,8,237,0,33400,27100,60500
"TR","1976-08-25",1976,8,238,0,32800,27300,60100
"TR","1976-08-26",1976,8,239,0,32000,27500,59500
"TR","1976-08-27",1976,8,240,10500,31700,27400,69600
"TR","1976-08-28",1976,8,241,0,31300,27300,58600
"TR","1976-08-29",1976,8,242,0,30700,27500,58200
"TR","1976-08-30",1976,8,243,0,30300,27500,57800
"TR","1976-08-31",1976,8,244,59000,31100,27200,117300
"TR","1976-09-01",1976,9,245,0,30600,27000,57600
"TR","1976-09-02",1976,9,246,69500,31600,26900,128000
"TR","1976-09-03",1976,9,247,0,31300,26600,57900
"TR","1976-09-04",1976,9,248,0,31100,26700,57800
"TR","1976-09-05",1976,9,249,0,30800,26800,57600
"TR","1976-09-06",1976,9,250,0,30600,26800,57400
"TR","1976-09-07",1976,9,251,10600,30500,26800,67900
"TR","1976-09-08",1976,9,252,0,30200,26900,57100
"TR","1976-09-09",1976,9,253,0,29800,27000,56800
"TR","1976-09-10",1976,9,254,0,29500,27100,56600
"TR","1976-09-11",1976,9,255,0,29400,27000,56400
"TR","1976-09-12",1976,9,256,0,29200,27000,56200
"TR","1976-09-13",1976,9,257,0,29000,27000,56000
"TR","1976-09-14",1976,9,258,0,28800,27100,55900
"TR","1976-09-15",1976,9,259,119000,30700,26800,176500
"TR","1976-09-16",1976,9,260,0,30100,26400,56500
"TR","1976-09-17",1976,9,261,0,30000,26400,56400
"TR","1976-09-18",1976,9,262,0,29900,26400,56300
"TR","1976-09-19",1976,9,263,0,29700,26500,56200
"TR","1976-09-20",1976,9,264,0,29500,26500,56000
"TR","1976-09-21",1976,9,265,21000,29600,26400,77000
"TR","1976-09-22",1976,9,266,2500,29600,26300,58400
"TR","1976-09-23",1976,9,267,23000,30100,26100,79200
"TR","1976-09-24",1976,9,268,0,30000,26000,56000
"TR","1976-09-25",1976,9,269,0,30000,25900,55900
"TR","1976-09-26",1976,9,270,0,30000,25900,55900
"TR","1976-09-27",1976,9,271,1320,29900,25900,57120
"TR","1976-09-28",1976,9,272,16400,30100,25800,72300
"TR","1976-09-29",1976,9,273,0,30100,25700,55800
"TR","1976-09-30",1976,9,274,0,30100,25700,55800
"TR","1976-10-01",1976,10,275,0,30000,25700,55700
"TR","1976-10-02",1976,10,276,0,29900,25900,55800
"TR","1976-10-03",1976,10,277,0,29600,26100,55700
"TR","1976-10-04",1976,10,278,0,29400,26100,55500
"TR","1976-10-05",1976,10,279,37000,29900,26100,93000
"TR","1976-10-06",1976,10,280,37100,30600,25700,93400
"TR","1976-10-07",1976,10,281,0,30700,25400,56100
"TR","1976-10-08",1976,10,282,0,30700,25400,56100
"TR","1976-10-09",1976,10,283,0,30700,25400,56100
"TR","1976-10-10",1976,10,284,44400,31600,25400,101400
"TR","1976-10-11",1976,10,285,0,31400,25200,56600
"TR","1976-10-12",1976,10,286,0,31300,25400,56700
"TR","1976-10-13",1976,10,287,0,31300,25500,56800
"TR","1976-10-14",1976,10,288,0,31400,25600,57000
"TR","1976-10-15",1976,10,289,0,31500,25600,57100
"TR","1976-10-16",1976,10,290,16100,31800,25500,73400
"TR","1976-10-17",1976,10,291,51500,32800,25200,109500
"TR","1976-10-18",1976,10,292,11200,32900,24900,69000
"TR","1976-10-19",1976,10,293,0,32800,24800,57600
"TR","1976-10-20",1976,10,294,13500,32900,24800,71200
"TR","1976-10-21",1976,10,295,0,32900,24800,57700
"TR","1976-10-22",1976,10,296,2280,32900,24800,59980
"TR","1976-10-23",1976,10,297,0,32900,24700,57600
"TR","1976-10-24",1976,10,298,0,33000,24600,57600
"TR","1976-10-25",1976,10,299,0,33000,24600,57600
"TR","1976-10-26",1976,10,300,0,33100,24500,57600
"TR","1976-10-27",1976,10,301,0,33100,24500,57600
"TR","1976-10-28",1976,10,302,0,33200,24500,57700
"TR","1976-10-29",1976,10,303,0,33200,24500,57700
"TR","1976-10-30",1976,10,304,0,33200,24500,57700
"TR","1976-10-31",1976,10,305,0,33100,24600,57700
"TR","1976-11-01",1976,11,306,0,33100,24600,57700
"TR","1976-11-02",1976,11,307,0,33100,24600,57700
"TR","1976-11-03",1976,11,308,18500,33400,24700,76600
"TR","1976-11-04",1976,11,309,0,33000,24600,57600
"TR","1976-11-05",1976,11,310,26700,33200,24500,84400
"TR","1976-11-06",1976,11,311,0,33300,24400,57700
"TR","1976-11-07",1976,11,312,0,33200,24400,57600
"TR","1976-11-08",1976,11,313,4010,33300,24300,61610
"TR","1976-11-09",1976,11,314,2160,33300,24200,59660
"TR","1976-11-10",1976,11,315,0,33400,24100,57500
"TR","1976-11-11",1976,11,316,48300,33700,23900,105900
"TR","1976-11-12",1976,11,317,2160,33700,23800,59660
"TR","1976-11-13",1976,11,318,2160,33700,23700,59560
"TR","1976-11-14",1976,11,319,0,33700,23800,57500
"TR","1976-11-15",1976,11,320,0,33700,23800,57500
"TR","1976-11-16",1976,11,321,0,33700,23800,57500
"TR","1976-11-17",1976,11,322,0,33700,23800,57500
"TR","1976-11-18",1976,11,323,0,33600,23700,57300
"TR","1976-11-19",1976,11,324,0,33500,23700,57200
"TR","1976-11-20",1976,11,325,0,33400,23800,57200
"TR","1976-11-21",1976,11,326,0,33400,23800,57200
"TR","1976-11-22",1976,11,327,18500,33500,23700,75700
"TR","1976-11-23",1976,11,328,0,33500,23600,57100
"TR","1976-11-24",1976,11,329,0,33500,23500,57000
"TR","1976-11-25",1976,11,330,0,33500,23500,57000
"TR","1976-11-26",1976,11,331,36000,33700,23300,93000
"TR","1976-11-27",1976,11,332,163000,34900,22600,220500
"TR","1976-11-28",1976,11,333,14300,35000,22500,71800
"TR","1976-11-29",1976,11,334,0,34900,22500,57400
"TR","1976-11-30",1976,11,335,0,34800,22600,57400
"TR","1976-12-01",1976,12,336,0,34800,22600,57400
"TR","1976-12-02",1976,12,337,0,34700,22600,57300
"TR","1976-12-03",1976,12,338,0,34600,22600,57200
"TR","1976-12-04",1976,12,339,7870,34600,22600,65070
"TR","1976-12-05",1976,12,340,12600,34700,22500,69800
"TR","1976-12-06",1976,12,341,0,34600,22400,57000
"TR","1976-12-07",1976,12,342,14800,34600,22400,71800
"TR","1976-12-08",1976,12,343,0,34600,22300,56900
"TR","1976-12-09",1976,12,344,0,34500,22300,56800
"TR","1976-12-10",1976,12,345,2340,34500,22300,59140
"TR","1976-12-11",1976,12,346,3550,34400,22300,60250
"TR","1976-12-12",1976,12,347,0,34400,22300,56700
"TR","1976-12-13",1976,12,348,0,34300,22300,56600
"TR","1976-12-14",1976,12,349,0,34300,22200,56500
"TR","1976-12-15",1976,12,350,0,34200,22200,56400
"TR","1976-12-16",1976,12,351,0,34100,22200,56300
"TR","1976-12-17",1976,12,352,0,34100,22200,56300
"TR","1976-12-18",1976,12,353,0,34000,22200,56200
"TR","1976-12-19",1976,12,354,0,33900,22200,56100
"TR","1976-12-20",1976,12,355,0,33900,22100,56000
"TR","1976-12-21",1976,12,356,38300,34100,22000,94400
"TR","1976-12-22",1976,12,357,1210,34000,21900,57110
"TR","1976-12-23",1976,12,358,3370,34000,21900,59270
"TR","1976-12-24",1976,12,359,4260,34000,21900,60160
"TR","1976-12-25",1976,12,360,6830,34000,21800,62630
"TR","1976-12-26",1976,12,361,7390,34000,21800,63190
"TR","1976-12-27",1976,12,362,0,33900,21800,55700
"TR","1976-12-28",1976,12,363,33200,34100,21700,89000
"TR","1976-12-29",1976,12,364,1210,34100,21600,56910
"TR","1976-12-30",1976,12,365,0,34000,21700,55700
"TR","1976-12-31",1976,12,366,0,33900,21700,55600
"TR","1977-01-01",1977,1,1,0,33900,21700,55600
"TR","1977-01-02",1977,1,2,0,33800,21700,55500
"TR","1977-01-03",1977,1,3,2020,33700,21700,57420
"TR","1977-01-04",1977,1,4,40900,33900,21500,96300
"TR","1977-01-05",1977,1,5,4050,33900,21400,59350
"TR","1977-01-06",1977,1,6,0,33800,21500,55300
"TR","1977-01-07",1977,1,7,0,33800,21500,55300
"TR","1977-01-08",1977,1,8,0,33700,21500,55200
"TR","1977-01-09",1977,1,9,24200,33900,21400,79500
"TR","1977-01-10",1977,1,10,0,33800,21400,55200
"TR","1977-01-11",1977,1,11,0,33700,21400,55100
"TR","1977-01-12",1977,1,12,0,33600,21400,55000
"TR","1977-01-13",1977,1,13,0,33600,21400,55000
"TR","1977-01-14",1977,1,14,37500,33800,21300,92600
"TR","1977-01-15",1977,1,15,7800,33800,21200,62800
"TR","1977-01-16",1977,1,16,0,33700,21200,54900
"TR","1977-01-17",1977,1,17,0,33600,21300,54900
"TR","1977-01-18",1977,1,18,0,33500,21300,54800
"TR","1977-01-19",1977,1,19,3750,33500,21300,58550
"TR","1977-01-20",1977,1,20,0,33400,21300,54700
"TR","1977-01-21",1977,1,21,0,33300,21300,54600
"TR","1977-01-22",1977,1,22,0,33200,21300,54500
"TR","1977-01-23",1977,1,23,0,33200,21300,54500
"TR","1977-01-24",1977,1,24,28200,33300,21200,82700
"TR","1977-01-25",1977,1,25,13400,33300,21100,67800
"TR","1977-01-26",1977,1,26,25200,33400,21000,79600
"TR","1977-01-27",1977,1,27,26600,33500,20900,81000
"TR","1977-01-28",1977,1,28,0,33400,21000,54400
"TR","1977-01-29",1977,1,29,9380,33400,21000,63780
"TR","1977-01-30",1977,1,30,9530,33300,21000,63830
"TR","1977-01-31",1977,1,31,0,33200,21000,54200
"TR","1977-02-01",1977,2,32,3750,33200,21000,57950
"TR","1977-02-02",1977,2,33,0,33100,21000,54100
"TR","1977-02-03",1977,2,34,0,33000,21000,54000
"TR","1977-02-04",1977,2,35,9610,33000,21000,63610
"TR","1977-02-05",1977,2,36,0,32900,21000,53900
"TR","1977-02-06",1977,2,37,0,32800,21000,53800
"TR","1977-02-07",1977,2,38,0,32700,21000,53700
"TR","1977-02-08",1977,2,39,0,32700,21000,53700
"TR","1977-02-09",1977,2,40,9010,32600,21000,62610
"TR","1977-02-10",1977,2,41,0,32500,21000,53500
"TR","1977-02-11",1977,2,42,0,32400,21000,53400
"TR","1977-02-12",1977,2,43,0,32300,21100,53400
"TR","1977-02-13",1977,2,44,0,32200,21200,53400
"TR","1977-02-14",1977,2,45,16000,32300,21000,69300
"TR","1977-02-15",1977,2,46,4060,32200,21000,57260
"TR","1977-02-16",1977,2,47,0,32200,21000,53200
"TR","1977-02-17",1977,2,48,0,32100,21000,53100
"TR","1977-02-18",1977,2,49,0,32100,21000,53100
"TR","1977-02-19",1977,2,50,0,32000,21000,53000
"TR","1977-02-20",1977,2,51,0,31900,21000,52900
"TR","1977-02-21",1977,2,52,0,31900,21000,52900
"TR","1977-02-22",1977,2,53,0,31800,21000,52800
"TR","1977-02-23",1977,2,54,0,31800,21000,52800
"TR","1977-02-24",1977,2,55,14600,31800,20900,67300
"TR","1977-02-25",1977,2,56,75900,32300,20600,128800
"TR","1977-02-26",1977,2,57,48000,32600,20400,101000
"TR","1977-02-27",1977,2,58,0,32500,20400,52900
"TR","1977-02-28",1977,2,59,2430,32400,20500,55330
"TR","1977-03-01",1977,3,60,0,32300,20600,52900
"TR","1977-03-02",1977,3,61,0,32200,20600,52800
"TR","1977-03-03",1977,3,62,0,32000,20700,52700
"TR","1977-03-04",1977,3,63,92900,32600,20300,145800
"TR","1977-03-05",1977,3,64,224000,34200,19500,277700
"TR","1977-03-06",1977,3,65,148000,35300,19000,202300
"TR","1977-03-07",1977,3,66,0,34900,19100,54000
"TR","1977-03-08",1977,3,67,0,34500,19500,54000
"TR","1977-03-09",1977,3,68,0,34000,19700,53700
"TR","1977-03-10",1977,3,69,0,33400,20100,53500
"TR","1977-03-11",1977,3,70,0,33900,20800,54700
"TR","1977-03-12",1977,3,71,0,34500,21300,55800
"TR","1977-03-13",1977,3,72,241000,172000,260000,673000
"TR","1977-03-14",1977,3,73,93500,69800,37100,200400
"TR","1977-03-15",1977,3,74,10200,58600,19400,88200
"TR","1977-03-16",1977,3,75,0,51000,18400,69400
"TR","1977-03-17",1977,3,76,0,46000,18600,64600
"TR","1977-03-18",1977,3,77,0,43500,18700,62200
"TR","1977-03-19",1977,3,78,226000,45800,18100,289900
"TR","1977-03-20",1977,3,79,0,43400,18100,61500
"TR","1977-03-21",1977,3,80,0,42600,18500,61100
"TR","1977-03-22",1977,3,81,0,41900,18800,60700
"TR","1977-03-23",1977,3,82,0,41500,19100,60600
"TR","1977-03-24",1977,3,83,2230,41800,19900,63930
"TR","1977-03-25",1977,3,84,0,40100,19800,59900
"TR","1977-03-26",1977,3,85,0,39100,19900,59000
"TR","1977-03-27",1977,3,86,0,38200,20000,58200
"TR","1977-03-28",1977,3,87,107000,39900,20400,167300
"TR","1977-03-29",1977,3,88,4820,38200,19600,62620
"TR","1977-03-30",1977,3,89,190000,41700,23100,254800
"TR","1977-03-31",1977,3,90,55500,40200,22000,117700
"TR","1977-04-01",1977,4,91,13100,39000,19300,71400
"TR","1977-04-02",1977,4,92,13400,38500,19300,71200
"TR","1977-04-03",1977,4,93,248000,40800,19000,307800
"TR","1977-04-04",1977,4,94,87000,41200,18700,146900
"TR","1977-04-05",1977,4,95,17900,41700,20700,80300
"TR","1977-04-06",1977,4,96,176000,41700,18600,236300
"TR","1977-04-07",1977,4,97,0,41100,18600,59700
"TR","1977-04-08",1977,4,98,6700,40600,18900,66200
"TR","1977-04-09",1977,4,99,0,40100,19200,59300
"TR","1977-04-10",1977,4,100,0,40000,19400,59400
"TR","1977-04-11",1977,4,101,0,40800,30800,71600
"TR","1977-04-12",1977,4,102,0,39700,37900,77600
"TR","1977-04-13",1977,4,103,10600,38800,19800,69200
"TR","1977-04-14",1977,4,104,272000,45800,34600,352400
"TR","1977-04-15",1977,4,105,0,41800,19000,60800
"TR","1977-04-16",1977,4,106,120000,43800,24800,188600
"TR","1977-04-17",1977,4,107,126000,45500,22500,194000
"TR","1977-04-18",1977,4,108,101000,45900,21200,168100
"TR","1977-04-19",1977,4,109,183000,50700,27000,260700
"TR","1977-04-20",1977,4,110,144000,52600,26800,223400
"TR","1977-04-21",1977,4,111,30400,48300,18900,97600
"TR","1977-04-22",1977,4,112,346000,64800,36000,446800
"TR","1977-04-23",1977,4,113,8190,55100,19400,82690
"TR","1977-04-24",1977,4,114,0,50600,18900,69500
"TR","1977-04-25",1977,4,115,7600,47300,19300,74200
"TR","1977-04-26",1977,4,116,0,45700,19500,65200
"TR","1977-04-27",1977,4,117,0,44900,19800,64700
"TR","1977-04-28",1977,4,118,0,44200,20100,64300
"TR","1977-04-29",1977,4,119,0,43500,20200,63700
"TR","1977-04-30",1977,4,120,0,42800,20300,63100
"TR","1977-05-01",1977,5,121,0,42200,20400,62600
"TR","1977-05-02",1977,5,122,0,41500,20800,62300
"TR","1977-05-03",1977,5,123,0,40900,21200,62100
"TR","1977-05-04",1977,5,124,0,40200,21500,61700
"TR","1977-05-05",1977,5,125,0,39700,21700,61400
"TR","1977-05-06",1977,5,126,238000,45800,22700,306500
"TR","1977-05-07",1977,5,127,16700,41600,21500,79800
"TR","1977-05-08",1977,5,128,0,40200,21500,61700
"TR","1977-05-09",1977,5,129,0,39700,21400,61100
"TR","1977-05-10",1977,5,130,0,39100,21600,60700
"TR","1977-05-11",1977,5,131,0,38000,21600,59600
"TR","1977-05-12",1977,5,132,0,37000,21700,58700
"TR","1977-05-13",1977,5,133,0,36000,21900,57900
"TR","1977-05-14",1977,5,134,0,34900,22000,56900
"TR","1977-05-15",1977,5,135,0,33900,22100,56000
"TR","1977-05-16",1977,5,136,0,33200,22200,55400
"TR","1977-05-17",1977,5,137,54200,33600,22100,109900
"TR","1977-05-18",1977,5,138,0,32900,22000,54900
"TR","1977-05-19",1977,5,139,69000,33500,22000,124500
"TR","1977-05-20",1977,5,140,0,32500,21800,54300
"TR","1977-05-21",1977,5,141,0,32000,22000,54000
"TR","1977-05-22",1977,5,142,91200,32900,22000,146100
"TR","1977-05-23",1977,5,143,80400,33500,21600,135500
"TR","1977-05-24",1977,5,144,0,32600,21500,54100
"TR","1977-05-25",1977,5,145,0,32000,21700,53700
"TR","1977-05-26",1977,5,146,73200,32500,21700,127400
"TR","1977-05-27",1977,5,147,4430,31600,21600,57630
"TR","1977-05-28",1977,5,148,0,30900,21800,52700
"TR","1977-05-29",1977,5,149,0,30400,21900,52300
"TR","1977-05-30",1977,5,150,0,30000,22000,52000
"TR","1977-05-31",1977,5,151,0,29600,22100,51700
"TR","1977-06-01",1977,6,152,152000,31700,21800,205500
"TR","1977-06-02",1977,6,153,311000,36600,21600,369200
"TR","1977-06-03",1977,6,154,38400,35000,20500,93900
"TR","1977-06-04",1977,6,155,0,34100,20800,54900
"TR","1977-06-05",1977,6,156,243000,38300,21400,302700
"TR","1977-06-06",1977,6,157,320000,43400,20900,384300
"TR","1977-06-07",1977,6,158,37100,39500,19900,96500
"TR","1977-06-08",1977,6,159,23700,38800,20200,82700
"TR","1977-06-09",1977,6,160,4770,38000,20600,63370
"TR","1977-06-10",1977,6,161,9540,37300,21000,67840
"TR","1977-06-11",1977,6,162,48600,37300,21300,107200
"TR","1977-06-12",1977,6,163,2380,36200,21400,59980
"TR","1977-06-13",1977,6,164,0,35300,21600,56900
"TR","1977-06-14",1977,6,165,0,34600,21700,56300
"TR","1977-06-15",1977,6,166,0,33900,21800,55700
"TR","1977-06-16",1977,6,167,0,33100,22000,55100
"TR","1977-06-17",1977,6,168,79200,33800,22000,135000
"TR","1977-06-18",1977,6,169,21500,33200,21900,76600
"TR","1977-06-19",1977,6,170,131000,34900,22000,187900
"TR","1977-06-20",1977,6,171,54700,34500,21700,110900
"TR","1977-06-21",1977,6,172,187000,37300,22000,246300
"TR","1977-06-22",1977,6,173,0,35500,21300,56800
"TR","1977-06-23",1977,6,174,0,34500,21700,56200
"TR","1977-06-24",1977,6,175,114000,35800,21800,171600
"TR","1977-06-25",1977,6,176,49500,35400,21700,106600
"TR","1977-06-26",1977,6,177,90400,36700,22000,149100
"TR","1977-06-27",1977,6,178,0,35100,21600,56700
"TR","1977-06-28",1977,6,179,150000,37000,21900,208900
"TR","1977-06-29",1977,6,180,146000,38400,21800,206200
"TR","1977-06-30",1977,6,181,58500,37500,21500,117500
"TR","1977-07-01",1977,7,182,265000,42300,22100,329400
"TR","1977-07-02",1977,7,183,138000,40900,21100,2e+05
"TR","1977-07-03",1977,7,184,0,38600,20400,59000
"TR","1977-07-04",1977,7,185,325000,45100,23600,393700
"TR","1977-07-05",1977,7,186,18200,40800,19900,78900
"TR","1977-07-06",1977,7,187,127000,41700,25000,193700
"TR","1977-07-07",1977,7,188,0,39400,20000,59400
"TR","1977-07-08",1977,7,189,0,37800,20100,57900
"TR","1977-07-09",1977,7,190,77000,38000,20300,135300
"TR","1977-07-10",1977,7,191,0,36500,20100,56600
"TR","1977-07-11",1977,7,192,0,35400,20300,55700
"TR","1977-07-12",1977,7,193,0,34300,20400,54700
"TR","1977-07-13",1977,7,194,4200,33300,20500,58000
"TR","1977-07-14",1977,7,195,16600,32500,20500,69600
"TR","1977-07-15",1977,7,196,84100,32800,20600,137500
"TR","1977-07-16",1977,7,197,39300,32200,20400,91900
"TR","1977-07-17",1977,7,198,4430,31100,20400,55930
"TR","1977-07-18",1977,7,199,55500,31200,20500,107200
"TR","1977-07-19",1977,7,200,0,30100,20500,50600
"TR","1977-07-20",1977,7,201,0,29200,20700,49900
"TR","1977-07-21",1977,7,202,22400,28700,20700,71800
"TR","1977-07-22",1977,7,203,0,28000,20800,48800
"TR","1977-07-23",1977,7,204,0,26900,20900,47800
"TR","1977-07-24",1977,7,205,0,26200,21000,47200
"TR","1977-07-25",1977,7,206,0,25500,21100,46600
"TR","1977-07-26",1977,7,207,0,24100,21300,45400
"TR","1977-07-27",1977,7,208,0,23900,21300,45200
"TR","1977-07-28",1977,7,209,0,23700,21300,45000
"TR","1977-07-29",1977,7,210,126000,26000,21100,173100
"TR","1977-07-30",1977,7,211,13600,25400,20700,59700
"TR","1977-07-31",1977,7,212,67300,26700,20600,114600
"TR","1977-08-01",1977,8,213,295000,31300,20600,346900
"TR","1977-08-02",1977,8,214,19300,29600,19500,68400
"TR","1977-08-03",1977,8,215,0,28800,19900,48700
"TR","1977-08-04",1977,8,216,2e+05,31900,20100,252000
"TR","1977-08-05",1977,8,217,62800,31000,19800,113600
"TR","1977-08-06",1977,8,218,36700,30500,19900,87100
"TR","1977-08-07",1977,8,219,0,29500,20300,49800
"TR","1977-08-08",1977,8,220,0,28900,20700,49600
"TR","1977-08-09",1977,8,221,0,28100,21000,49100
"TR","1977-08-10",1977,8,222,0,27500,21200,48700
"TR","1977-08-11",1977,8,223,90700,28500,21200,140400
"TR","1977-08-12",1977,8,224,0,27700,21000,48700
"TR","1977-08-13",1977,8,225,0,27000,21200,48200
"TR","1977-08-14",1977,8,226,196000,30000,21400,247400
"TR","1977-08-15",1977,8,227,66600,30200,20700,117500
"TR","1977-08-16",1977,8,228,0,29200,20700,49900
"TR","1977-08-17",1977,8,229,456000,39400,21600,517000
"TR","1977-08-18",1977,8,230,0,34100,19400,53500
"TR","1977-08-19",1977,8,231,0,33200,19900,53100
"TR","1977-08-20",1977,8,232,0,32500,20300,52800
"TR","1977-08-21",1977,8,233,0,31700,20700,52400
"TR","1977-08-22",1977,8,234,171000,34400,21000,226400
"TR","1977-08-23",1977,8,235,0,32900,20600,53500
"TR","1977-08-24",1977,8,236,0,32100,20900,53000
"TR","1977-08-25",1977,8,237,0,31300,21000,52300
"TR","1977-08-26",1977,8,238,0,30700,21200,51900
"TR","1977-08-27",1977,8,239,97800,31900,21400,151100
"TR","1977-08-28",1977,8,240,1190000,81900,79500,1351400
"TR","1977-08-29",1977,8,241,157000,66300,33300,256600
"TR","1977-08-30",1977,8,242,0,58900,17900,76800
"TR","1977-08-31",1977,8,243,0,52600,18500,71100
"TR","1977-09-01",1977,9,244,1710000,147000,164000,2021000
"TR","1977-09-02",1977,9,245,68700,96500,42600,207800
"TR","1977-09-03",1977,9,246,63600,93400,21300,178300
"TR","1977-09-04",1977,9,247,11400,89300,17900,118600
"TR","1977-09-05",1977,9,248,189000,91600,28500,309100
"TR","1977-09-06",1977,9,249,1460,84300,19600,105360
"TR","1977-09-07",1977,9,250,246000,88700,32600,367300
"TR","1977-09-08",1977,9,251,12800,80700,21400,114900
"TR","1977-09-09",1977,9,252,0,75600,21600,97200
"TR","1977-09-10",1977,9,253,114000,73900,22900,210800
"TR","1977-09-11",1977,9,254,0,66000,22800,88800
"TR","1977-09-12",1977,9,255,38300,61800,23400,123500
"TR","1977-09-13",1977,9,256,131000,64000,24700,219700
"TR","1977-09-14",1977,9,257,0,58200,24000,82200
"TR","1977-09-15",1977,9,258,0,54200,24500,78700
"TR","1977-09-16",1977,9,259,0,50900,24800,75700
"TR","1977-09-17",1977,9,260,58100,50400,25200,133700
"TR","1977-09-18",1977,9,261,9970,48600,25300,83870
"TR","1977-09-19",1977,9,262,26400,48200,25500,100100
"TR","1977-09-20",1977,9,263,304000,60000,34700,398700
"TR","1977-09-21",1977,9,264,7010,52700,25000,84710
"TR","1977-09-22",1977,9,265,0,49700,25400,75100
"TR","1977-09-23",1977,9,266,132000,53200,26900,212100
"TR","1977-09-24",1977,9,267,78300,54500,31300,164100
"TR","1977-09-25",1977,9,268,313000,73700,45800,432500
"TR","1977-09-26",1977,9,269,122000,71100,37100,230200
"TR","1977-09-27",1977,9,270,32700,66500,27600,126800
"TR","1977-09-28",1977,9,271,7120,61000,25200,93320
"TR","1977-09-29",1977,9,272,2850,56900,25700,85450
"TR","1977-09-30",1977,9,273,89300,58400,26400,174100
"TR","1977-10-01",1977,10,274,3330,55100,26400,84830
"TR","1977-10-02",1977,10,275,0,52300,26700,79000
"TR","1977-10-03",1977,10,276,0,50200,26900,77100
"TR","1977-10-04",1977,10,277,0,48700,27000,75700
"TR","1977-10-05",1977,10,278,20900,48200,27100,96200
"TR","1977-10-06",1977,10,279,37100,48500,27100,112700
"TR","1977-10-07",1977,10,280,0,48100,27200,75300
"TR","1977-10-08",1977,10,281,0,47400,27300,74700
"TR","1977-10-09",1977,10,282,336000,63900,38500,438400
"TR","1977-10-10",1977,10,283,38000,60100,30800,128900
"TR","1977-10-11",1977,10,284,0,56200,26800,83000
"TR","1977-10-12",1977,10,285,281000,73300,44200,398500
"TR","1977-10-13",1977,10,286,92200,70600,34500,197300
"TR","1977-10-14",1977,10,287,0,64200,27100,91300
"TR","1977-10-15",1977,10,288,0,59700,26800,86500
"TR","1977-10-16",1977,10,289,0,56400,27100,83500
"TR","1977-10-17",1977,10,290,0,53900,27300,81200
"TR","1977-10-18",1977,10,291,0,52200,27500,79700
"TR","1977-10-19",1977,10,292,119000,56300,28000,203300
"TR","1977-10-20",1977,10,293,10400,53800,27800,92000
"TR","1977-10-21",1977,10,294,0,51400,28000,79400
"TR","1977-10-22",1977,10,295,0,49600,28200,77800
"TR","1977-10-23",1977,10,296,0,48700,28200,76900
"TR","1977-10-24",1977,10,297,0,48500,28200,76700
"TR","1977-10-25",1977,10,298,0,48300,28200,76500
"TR","1977-10-26",1977,10,299,11600,48200,28300,88100
"TR","1977-10-27",1977,10,300,0,47500,28300,75800
"TR","1977-10-28",1977,10,301,0,47200,28400,75600
"TR","1977-10-29",1977,10,302,0,47000,28300,75300
"TR","1977-10-30",1977,10,303,0,46800,28300,75100
"TR","1977-10-31",1977,10,304,0,46500,28500,75000
"TR","1977-11-01",1977,11,305,64400,47800,28800,141000
"TR","1977-11-02",1977,11,306,69900,48300,28700,146900
"TR","1977-11-03",1977,11,307,2410,47400,28500,78310
"TR","1977-11-04",1977,11,308,8980,46600,28500,84080
"TR","1977-11-05",1977,11,309,0,45800,28400,74200
"TR","1977-11-06",1977,11,310,0,45500,28500,74000
"TR","1977-11-07",1977,11,311,1120,45400,28600,75120
"TR","1977-11-08",1977,11,312,1e+05,47700,29000,176700
"TR","1977-11-09",1977,11,313,14000,47200,28700,89900
"TR","1977-11-10",1977,11,314,9770,46200,28600,84570
"TR","1977-11-11",1977,11,315,13000,45700,28400,87100
"TR","1977-11-12",1977,11,316,59500,45800,27800,133100
"TR","1977-11-13",1977,11,317,0,45700,27800,73500
"TR","1977-11-14",1977,11,318,0,45700,27900,73600
"TR","1977-11-15",1977,11,319,0,45700,28000,73700
"TR","1977-11-16",1977,11,320,0,45600,28300,73900
"TR","1977-11-17",1977,11,321,1210,45100,28100,74410
"TR","1977-11-18",1977,11,322,11400,45100,28200,84700
"TR","1977-11-19",1977,11,323,2160,44700,28200,75060
"TR","1977-11-20",1977,11,324,0,44600,28100,72700
"TR","1977-11-21",1977,11,325,230000,46800,27400,304200
"TR","1977-11-22",1977,11,326,48700,48100,27700,124500
"TR","1977-11-23",1977,11,327,0,47100,27100,74200
"TR","1977-11-24",1977,11,328,79400,47000,26900,153300
"TR","1977-11-25",1977,11,329,58200,48000,26700,132900
"TR","1977-11-26",1977,11,330,37300,48200,26600,112100
"TR","1977-11-27",1977,11,331,0,47400,26600,74000
"TR","1977-11-28",1977,11,332,37300,47500,26600,111400
"TR","1977-11-29",1977,11,333,47800,48100,26400,122300
"TR","1977-11-30",1977,11,334,0,47100,26500,73600
"TR","1977-12-01",1977,12,335,0,46700,26700,73400
"TR","1977-12-02",1977,12,336,61000,46900,26500,134400
"TR","1977-12-03",1977,12,337,0,46500,26500,73000
"TR","1977-12-04",1977,12,338,0,46300,26600,72900
"TR","1977-12-05",1977,12,339,0,46100,26600,72700
"TR","1977-12-06",1977,12,340,40400,46200,26400,113000
"TR","1977-12-07",1977,12,341,26500,46100,26300,98900
"TR","1977-12-08",1977,12,342,0,45900,26400,72300
"TR","1977-12-09",1977,12,343,6920,45800,26400,79120
"TR","1977-12-10",1977,12,344,70400,46000,26100,142500
"TR","1977-12-11",1977,12,345,3640,45800,26100,75540
"TR","1977-12-12",1977,12,346,0,45600,26100,71700
"TR","1977-12-13",1977,12,347,0,45400,26200,71600
"TR","1977-12-14",1977,12,348,0,45200,26200,71400
"TR","1977-12-15",1977,12,349,0,45000,26300,71300
"TR","1977-12-16",1977,12,350,0,44800,26300,71100
"TR","1977-12-17",1977,12,351,0,44600,26300,70900
"TR","1977-12-18",1977,12,352,23100,44700,26300,94100
"TR","1977-12-19",1977,12,353,78700,48300,34000,161000
"TR","1977-12-20",1977,12,354,4160,48000,31800,83960
"TR","1977-12-21",1977,12,355,39900,47800,27100,114800
"TR","1977-12-22",1977,12,356,75500,48700,25700,149900
"TR","1977-12-23",1977,12,357,9700,47700,25600,83000
"TR","1977-12-24",1977,12,358,0,46800,25700,72500
"TR","1977-12-25",1977,12,359,23100,46600,25700,95400
"TR","1977-12-26",1977,12,360,45700,47100,25500,118300
"TR","1977-12-27",1977,12,361,0,46400,25600,72000
"TR","1977-12-28",1977,12,362,0,46100,25700,71800
"TR","1977-12-29",1977,12,363,2420,45900,25700,74020
"TR","1977-12-30",1977,12,364,0,45600,25800,71400
"TR","1977-12-31",1977,12,365,0,45300,25800,71100
"TR","1978-01-01",1978,1,1,0,45100,25800,70900
"TR","1978-01-02",1978,1,2,65600,45400,25500,136500
"TR","1978-01-03",1978,1,3,7500,45200,25400,78100
"TR","1978-01-04",1978,1,4,2020,45000,25500,72520
"TR","1978-01-05",1978,1,5,0,44700,25600,70300
"TR","1978-01-06",1978,1,6,0,44500,25600,70100
"TR","1978-01-07",1978,1,7,145000,45100,25000,215100
"TR","1978-01-08",1978,1,8,50600,45200,24700,120500
"TR","1978-01-09",1978,1,9,59900,45400,24600,129900
"TR","1978-01-10",1978,1,10,37500,45300,24600,107400
"TR","1978-01-11",1978,1,11,4050,45100,24700,73850
"TR","1978-01-12",1978,1,12,0,44800,24800,69600
"TR","1978-01-13",1978,1,13,0,44600,25000,69600
"TR","1978-01-14",1978,1,14,0,44300,25000,69300
"TR","1978-01-15",1978,1,15,0,44100,25100,69200
"TR","1978-01-16",1978,1,16,0,43900,25100,69000
"TR","1978-01-17",1978,1,17,3750,43700,25200,72650
"TR","1978-01-18",1978,1,18,0,43500,25200,68700
"TR","1978-01-19",1978,1,19,0,43300,25200,68500
"TR","1978-01-20",1978,1,20,0,43100,25200,68300
"TR","1978-01-21",1978,1,21,0,42900,25200,68100
"TR","1978-01-22",1978,1,22,0,42700,25200,67900
"TR","1978-01-23",1978,1,23,0,42500,25300,67800
"TR","1978-01-24",1978,1,24,0,42300,25300,67600
"TR","1978-01-25",1978,1,25,0,42100,25300,67400
"TR","1978-01-26",1978,1,26,11300,42000,25200,78500
"TR","1978-01-27",1978,1,27,68600,42300,24900,135800
"TR","1978-01-28",1978,1,28,10100,42200,24800,77100
"TR","1978-01-29",1978,1,29,0,42100,24900,67000
"TR","1978-01-30",1978,1,30,0,41900,25000,66900
"TR","1978-01-31",1978,1,31,0,41700,25000,66700
"TR","1978-02-01",1978,2,32,0,41600,25000,66600
"TR","1978-02-02",1978,2,33,0,41400,25000,66400
"TR","1978-02-03",1978,2,34,0,41300,25000,66300
"TR","1978-02-04",1978,2,35,0,41200,25000,66200
"TR","1978-02-05",1978,2,36,11300,41100,25000,77400
"TR","1978-02-06",1978,2,37,41900,41200,24800,107900
"TR","1978-02-07",1978,2,38,0,41100,24700,65800
"TR","1978-02-08",1978,2,39,0,41000,24800,65800
"TR","1978-02-09",1978,2,40,0,40800,24800,65600
"TR","1978-02-10",1978,2,41,0,40700,24800,65500
"TR","1978-02-11",1978,2,42,0,40500,24800,65300
"TR","1978-02-12",1978,2,43,0,40400,24800,65200
"TR","1978-02-13",1978,2,44,0,40300,24800,65100
"TR","1978-02-14",1978,2,45,0,40100,24800,64900
"TR","1978-02-15",1978,2,46,4510,40000,24800,69310
"TR","1978-02-16",1978,2,47,0,39900,24800,64700
"TR","1978-02-17",1978,2,48,0,39800,24800,64600
"TR","1978-02-18",1978,2,49,0,39700,24800,64500
"TR","1978-02-19",1978,2,50,0,39600,24800,64400
"TR","1978-02-20",1978,2,51,0,39500,24700,64200
"TR","1978-02-21",1978,2,52,0,39400,24700,64100
"TR","1978-02-22",1978,2,53,0,39300,24700,64000
"TR","1978-02-23",1978,2,54,0,39200,24700,63900
"TR","1978-02-24",1978,2,55,0,39100,24700,63800
"TR","1978-02-25",1978,2,56,20300,39100,24600,84000
"TR","1978-02-26",1978,2,57,67100,39400,24300,130800
"TR","1978-02-27",1978,2,58,1220,39300,24200,64720
"TR","1978-02-28",1978,2,59,0,39200,24300,63500
"TR","1978-03-01",1978,3,60,2250,39100,24300,65650
"TR","1978-03-02",1978,3,61,0,39000,24300,63300
"TR","1978-03-03",1978,3,62,0,38900,24400,63300
"TR","1978-03-04",1978,3,63,82400,39300,24000,145700
"TR","1978-03-05",1978,3,64,0,39200,23900,63100
"TR","1978-03-06",1978,3,65,0,39100,24000,63100
"TR","1978-03-07",1978,3,66,0,38900,24100,63000
"TR","1978-03-08",1978,3,67,0,38800,24100,62900
"TR","1978-03-09",1978,3,68,0,38600,24200,62800
"TR","1978-03-10",1978,3,69,0,38400,24300,62700
"TR","1978-03-11",1978,3,70,0,38100,24400,62500
"TR","1978-03-12",1978,3,71,0,37900,24400,62300
"TR","1978-03-13",1978,3,72,0,37800,24400,62200
"TR","1978-03-14",1978,3,73,12400,37600,24400,74400
"TR","1978-03-15",1978,3,74,24800,37500,24300,86600
"TR","1978-03-16",1978,3,75,8280,37400,24300,69980
"TR","1978-03-17",1978,3,76,62100,37800,24000,123900
"TR","1978-03-18",1978,3,77,0,37700,23900,61600
"TR","1978-03-19",1978,3,78,0,37500,24000,61500
"TR","1978-03-20",1978,3,79,0,37300,24100,61400
"TR","1978-03-21",1978,3,80,39300,37400,24000,100700
"TR","1978-03-22",1978,3,81,29000,37300,23900,90200
"TR","1978-03-23",1978,3,82,2230,37500,24000,63730
"TR","1978-03-24",1978,3,83,0,37500,24300,61800
"TR","1978-03-25",1978,3,84,0,37100,24100,61200
"TR","1978-03-26",1978,3,85,0,36900,24100,61000
"TR","1978-03-27",1978,3,86,0,36600,24200,60800
"TR","1978-03-28",1978,3,87,0,36600,24200,60800
"TR","1978-03-29",1978,3,88,0,37900,27600,65500
"TR","1978-03-30",1978,3,89,0,37900,27600,65500
"TR","1978-03-31",1978,3,90,0,38700,28900,67600
"TR","1978-04-01",1978,4,91,2230,45900,44500,92630
"TR","1978-04-02",1978,4,92,0,43800,33400,77200
"TR","1978-04-03",1978,4,93,71500,41700,25100,138300
"TR","1978-04-04",1978,4,94,171000,42200,23900,237100
"TR","1978-04-05",1978,4,95,137000,45800,27500,210300
"TR","1978-04-06",1978,4,96,0,45200,28400,73600
"TR","1978-04-07",1978,4,97,114000,52500,40800,207300
"TR","1978-04-08",1978,4,98,60600,54100,54800,169500
"TR","1978-04-09",1978,4,99,0,49000,29500,78500
"TR","1978-04-10",1978,4,100,277000,58100,33900,369000
"TR","1978-04-11",1978,4,101,260000,67400,30600,358000
"TR","1978-04-12",1978,4,102,71900,63100,31300,166300
"TR","1978-04-13",1978,4,103,61300,62300,31500,155100
"TR","1978-04-14",1978,4,104,56600,65300,40800,162700
"TR","1978-04-15",1978,4,105,2410,58800,25500,86710
"TR","1978-04-16",1978,4,106,0,55000,24700,79700
"TR","1978-04-17",1978,4,107,0,52100,25100,77200
"TR","1978-04-18",1978,4,108,0,49700,25400,75100
"TR","1978-04-19",1978,4,109,0,47800,25600,73400
"TR","1978-04-20",1978,4,110,159000,53900,27800,240700
"TR","1978-04-21",1978,4,111,71600,54300,32000,157900
"TR","1978-04-22",1978,4,112,0,50200,25800,76000
"TR","1978-04-23",1978,4,113,0,48000,26100,74100
"TR","1978-04-24",1978,4,114,13700,47200,26300,87200
"TR","1978-04-25",1978,4,115,31600,47100,26500,105200
"TR","1978-04-26",1978,4,116,0,46200,26300,72500
"TR","1978-04-27",1978,4,117,0,45700,26500,72200
"TR","1978-04-28",1978,4,118,0,45100,26400,71500
"TR","1978-04-29",1978,4,119,0,44600,26400,71000
"TR","1978-04-30",1978,4,120,0,44200,26400,70600
"TR","1978-05-01",1978,5,121,0,43700,26300,70000
"TR","1978-05-02",1978,5,122,0,43400,26300,69700
"TR","1978-05-03",1978,5,123,0,42900,26600,69500
"TR","1978-05-04",1978,5,124,0,42400,26700,69100
"TR","1978-05-05",1978,5,125,0,41900,27000,68900
"TR","1978-05-06",1978,5,126,0,41600,27200,68800
"TR","1978-05-07",1978,5,127,0,41300,27300,68600
"TR","1978-05-08",1978,5,128,0,41000,27400,68400
"TR","1978-05-09",1978,5,129,159000,44700,28200,231900
"TR","1978-05-10",1978,5,130,317000,51900,39000,407900
"TR","1978-05-11",1978,5,131,0,45700,26100,71800
"TR","1978-05-12",1978,5,132,0,44600,26400,71000
"TR","1978-05-13",1978,5,133,0,43300,26700,70000
"TR","1978-05-14",1978,5,134,0,42100,26400,68500
"TR","1978-05-15",1978,5,135,149000,44700,26900,220600
"TR","1978-05-16",1978,5,136,16700,43900,26400,87000
"TR","1978-05-17",1978,5,137,0,43000,26500,69500
"TR","1978-05-18",1978,5,138,0,41900,26700,68600
"TR","1978-05-19",1978,5,139,0,40700,26600,67300
"TR","1978-05-20",1978,5,140,0,39600,26600,66200
"TR","1978-05-21",1978,5,141,0,38800,26600,65400
"TR","1978-05-22",1978,5,142,0,38300,26600,64900
"TR","1978-05-23",1978,5,143,0,37700,26600,64300
"TR","1978-05-24",1978,5,144,0,37000,26700,63700
"TR","1978-05-25",1978,5,145,0,36400,26700,63100
"TR","1978-05-26",1978,5,146,104000,37400,26700,168100
"TR","1978-05-27",1978,5,147,414000,44900,27100,486000
"TR","1978-05-28",1978,5,148,546000,62600,48500,657100
"TR","1978-05-29",1978,5,149,253000,66800,39100,358900
"TR","1978-05-30",1978,5,150,719000,100000,64500,883500
"TR","1978-05-31",1978,5,151,264000,92900,34900,391800
"TR","1978-06-01",1978,6,152,41400,84100,23200,148700
"TR","1978-06-02",1978,6,153,499000,104000,55700,658700
"TR","1978-06-03",1978,6,154,35800,88200,24000,148000
"TR","1978-06-04",1978,6,155,49300,83300,24500,157100
"TR","1978-06-05",1978,6,156,42000,79300,25200,146500
"TR","1978-06-06",1978,6,157,0,71500,25600,97100
"TR","1978-06-07",1978,6,158,0,65600,26200,91800
"TR","1978-06-08",1978,6,159,81800,63300,26900,172000
"TR","1978-06-09",1978,6,160,61100,61100,27100,149300
"TR","1978-06-10",1978,6,161,0,57000,27300,84300
"TR","1978-06-11",1978,6,162,28700,54100,27700,110500
"TR","1978-06-12",1978,6,163,84000,53700,28000,165700
"TR","1978-06-13",1978,6,164,259000,64300,29500,352800
"TR","1978-06-14",1978,6,165,0,58300,28000,86300
"TR","1978-06-15",1978,6,166,155000,61400,29000,245400
"TR","1978-06-16",1978,6,167,310000,79200,42700,431900
"TR","1978-06-17",1978,6,168,72700,71100,28200,172000
"TR","1978-06-18",1978,6,169,262000,82800,49400,394200
"TR","1978-06-19",1978,6,170,59600,73000,29500,162100
"TR","1978-06-20",1978,6,171,0,66100,28000,94100
"TR","1978-06-21",1978,6,172,4420,61600,28500,94520
"TR","1978-06-22",1978,6,173,42800,59600,28800,131200
"TR","1978-06-23",1978,6,174,0,56100,28800,84900
"TR","1978-06-24",1978,6,175,0,53400,29100,82500
"TR","1978-06-25",1978,6,176,57200,53200,29500,139900
"TR","1978-06-26",1978,6,177,30900,51700,29400,112000
"TR","1978-06-27",1978,6,178,57100,51800,29800,138700
"TR","1978-06-28",1978,6,179,0,49800,29500,79300
"TR","1978-06-29",1978,6,180,0,48900,29700,78600
"TR","1978-06-30",1978,6,181,0,48000,29800,77800
"TR","1978-07-01",1978,7,182,35400,47700,29800,112900
"TR","1978-07-02",1978,7,183,251000,52200,30300,333500
"TR","1978-07-03",1978,7,184,257000,59000,30600,346600
"TR","1978-07-04",1978,7,185,174000,61700,30400,266100
"TR","1978-07-05",1978,7,186,0,55700,28900,84600
"TR","1978-07-06",1978,7,187,112000,56700,29800,198500
"TR","1978-07-07",1978,7,188,16200,52800,29400,98400
"TR","1978-07-08",1978,7,189,71500,51600,29500,152600
"TR","1978-07-09",1978,7,190,61800,51000,29500,142300
"TR","1978-07-10",1978,7,191,46200,50200,29400,125800
"TR","1978-07-11",1978,7,192,4540,48600,29100,82240
"TR","1978-07-12",1978,7,193,0,47600,29100,76700
"TR","1978-07-13",1978,7,194,8410,46800,29100,84310
"TR","1978-07-14",1978,7,195,57000,47000,29300,133300
"TR","1978-07-15",1978,7,196,0,45700,29000,74700
"TR","1978-07-16",1978,7,197,0,44800,29100,73900
"TR","1978-07-17",1978,7,198,0,43900,29100,73000
"TR","1978-07-18",1978,7,199,67300,44100,29200,140600
"TR","1978-07-19",1978,7,200,338000,51000,30100,419100
"TR","1978-07-20",1978,7,201,84600,48800,29200,162600
"TR","1978-07-21",1978,7,202,12400,47100,28900,88400
"TR","1978-07-22",1978,7,203,14000,46000,29000,89000
"TR","1978-07-23",1978,7,204,122000,47600,29300,198900
"TR","1978-07-24",1978,7,205,187000,50400,30100,267500
"TR","1978-07-25",1978,7,206,0,48000,28700,76700
"TR","1978-07-26",1978,7,207,237000,52800,30200,320000
"TR","1978-07-27",1978,7,208,61000,50400,28600,140000
"TR","1978-07-28",1978,7,209,3020,48100,28300,79420
"TR","1978-07-29",1978,7,210,25200,47400,28400,101000
"TR","1978-07-30",1978,7,211,14300,46500,28400,89200
"TR","1978-07-31",1978,7,212,0,45600,28300,73900
"TR","1978-08-01",1978,8,213,23800,45200,28400,97400
"TR","1978-08-02",1978,8,214,0,44300,28500,72800
"TR","1978-08-03",1978,8,215,784000,80100,38400,902500
"TR","1978-08-04",1978,8,216,0,60600,26800,87400
"TR","1978-08-05",1978,8,217,0,55900,27600,83500
"TR","1978-08-06",1978,8,218,0,52200,28100,80300
"TR","1978-08-07",1978,8,219,0,49400,28400,77800
"TR","1978-08-08",1978,8,220,0,48100,28600,76700
"TR","1978-08-09",1978,8,221,0,46900,28700,75600
"TR","1978-08-10",1978,8,222,0,45800,28800,74600
"TR","1978-08-11",1978,8,223,0,44900,28800,73700
"TR","1978-08-12",1978,8,224,0,44200,28900,73100
"TR","1978-08-13",1978,8,225,0,43400,29000,72400
"TR","1978-08-14",1978,8,226,0,42600,29200,71800
"TR","1978-08-15",1978,8,227,0,41800,29300,71100
"TR","1978-08-16",1978,8,228,233000,45700,29700,308400
"TR","1978-08-17",1978,8,229,492000,59500,31100,582600
"TR","1978-08-18",1978,8,230,123000,57200,30400,210600
"TR","1978-08-19",1978,8,231,229000,64300,35600,328900
"TR","1978-08-20",1978,8,232,445000,89100,62600,596700
"TR","1978-08-21",1978,8,233,0,72900,27800,100700
"TR","1978-08-22",1978,8,234,0,65700,27500,93200
"TR","1978-08-23",1978,8,235,0,60100,27900,88000
"TR","1978-08-24",1978,8,236,2180000,214000,246000,2640000
"TR","1978-08-25",1978,8,237,119000,122000,63300,304300
"TR","1978-08-26",1978,8,238,0,113000,33500,146500
"TR","1978-08-27",1978,8,239,2660,106000,26000,134660
"TR","1978-08-28",1978,8,240,1020000,168000,198000,1386000
"TR","1978-08-29",1978,8,241,555000,166000,181000,902000
"TR","1978-08-30",1978,8,242,0,136000,41200,177200
"TR","1978-08-31",1978,8,243,38600,129000,30500,198100
"TR","1978-09-01",1978,9,244,0,122000,32500,154500
"TR","1978-09-02",1978,9,245,0,116000,34600,150600
"TR","1978-09-03",1978,9,246,17200,111000,36000,164200
"TR","1978-09-04",1978,9,247,69700,110000,38300,218000
"TR","1978-09-05",1978,9,248,0,105000,38200,143200
"TR","1978-09-06",1978,9,249,5280,102000,39000,146280
"TR","1978-09-07",1978,9,250,2850,99000,39200,141050
"TR","1978-09-08",1978,9,251,0,95900,39300,135200
"TR","1978-09-09",1978,9,252,0,92400,39500,131900
"TR","1978-09-10",1978,9,253,0,88800,39500,128300
"TR","1978-09-11",1978,9,254,0,84600,39600,124200
"TR","1978-09-12",1978,9,255,35000,80800,39900,155700
"TR","1978-09-13",1978,9,256,270000,91600,43000,404600
"TR","1978-09-14",1978,9,257,154000,91800,43300,289100
"TR","1978-09-15",1978,9,258,220000,100000,46200,366200
"TR","1978-09-16",1978,9,259,11400,91200,41500,144100
"TR","1978-09-17",1978,9,260,51500,87600,42400,181500
"TR","1978-09-18",1978,9,261,49400,85700,42900,178000
"TR","1978-09-19",1978,9,262,42700,82900,42900,168500
"TR","1978-09-20",1978,9,263,69900,83700,43700,197300
"TR","1978-09-21",1978,9,264,20200,79000,42600,141800
"TR","1978-09-22",1978,9,265,23200,76800,42500,142500
"TR","1978-09-23",1978,9,266,2850,74000,42100,118950
"TR","1978-09-24",1978,9,267,0,71500,41800,113300
"TR","1978-09-25",1978,9,268,0,69600,41700,111300
"TR","1978-09-26",1978,9,269,0,67700,41300,109000
"TR","1978-09-27",1978,9,270,14200,66700,41100,122000
"TR","1978-09-28",1978,9,271,236000,81900,44700,362600
"TR","1978-09-29",1978,9,272,0,76600,41800,118400
"TR","1978-09-30",1978,9,273,172000,89200,48600,309800
"TR","1978-10-01",1978,10,274,114000,92800,52600,259400
"TR","1978-10-02",1978,10,275,3470,86500,43800,133770
"TR","1978-10-03",1978,10,276,27600,82900,41400,151900
"TR","1978-10-04",1978,10,277,75600,83700,41900,201200
"TR","1978-10-05",1978,10,278,10200,81800,43400,135400
"TR","1978-10-06",1978,10,279,143000,89800,50000,282800
"TR","1978-10-07",1978,10,280,37900,86700,46200,170800
"TR","1978-10-08",1978,10,281,78800,87000,46000,211800
"TR","1978-10-09",1978,10,282,4570,82700,41700,128970
"TR","1978-10-10",1978,10,283,0,78800,40800,119600
"TR","1978-10-11",1978,10,284,0,75900,40700,116600
"TR","1978-10-12",1978,10,285,0,73300,40300,113600
"TR","1978-10-13",1978,10,286,16800,72600,40200,129600
"TR","1978-10-14",1978,10,287,22500,71700,40100,134300
"TR","1978-10-15",1978,10,288,0,70000,39600,109600
"TR","1978-10-16",1978,10,289,57100,72400,40100,169600
"TR","1978-10-17",1978,10,290,11400,71700,40100,123200
"TR","1978-10-18",1978,10,291,0,69900,39800,109700
"TR","1978-10-19",1978,10,292,0,68500,39800,108300
"TR","1978-10-20",1978,10,293,0,67300,39500,106800
"TR","1978-10-21",1978,10,294,0,66500,39300,105800
"TR","1978-10-22",1978,10,295,0,65400,39100,104500
"TR","1978-10-23",1978,10,296,0,64700,38900,103600
"TR","1978-10-24",1978,10,297,0,64300,38700,103000
"TR","1978-10-25",1978,10,298,0,64000,38800,102800
"TR","1978-10-26",1978,10,299,0,63600,38900,102500
"TR","1978-10-27",1978,10,300,0,63200,38900,102100
"TR","1978-10-28",1978,10,301,0,62900,38900,101800
"TR","1978-10-29",1978,10,302,0,62700,38900,101600
"TR","1978-10-30",1978,10,303,0,62400,38900,101300
"TR","1978-10-31",1978,10,304,0,62100,38900,101000
"TR","1978-11-01",1978,11,305,0,61700,38900,100600
"TR","1978-11-02",1978,11,306,0,61400,38900,100300
"TR","1978-11-03",1978,11,307,0,60900,38800,99700
"TR","1978-11-04",1978,11,308,0,60400,38800,99200
"TR","1978-11-05",1978,11,309,0,59900,38800,98700
"TR","1978-11-06",1978,11,310,17500,60200,38800,116500
"TR","1978-11-07",1978,11,311,0,59800,38600,98400
"TR","1978-11-08",1978,11,312,0,59600,38500,98100
"TR","1978-11-09",1978,11,313,0,59300,38400,97700
"TR","1978-11-10",1978,11,314,0,58900,38400,97300
"TR","1978-11-11",1978,11,315,15700,59200,38300,113200
"TR","1978-11-12",1978,11,316,4320,58800,38100,101220
"TR","1978-11-13",1978,11,317,0,58700,38000,96700
"TR","1978-11-14",1978,11,318,140000,63600,37700,241300
"TR","1978-11-15",1978,11,319,17300,65300,39500,122100
"TR","1978-11-16",1978,11,320,0,63000,37100,100100
"TR","1978-11-17",1978,11,321,0,61700,37200,98900
"TR","1978-11-18",1978,11,322,407000,70800,35700,513500
"TR","1978-11-19",1978,11,323,240000,74800,34400,349200
"TR","1978-11-20",1978,11,324,4010,71700,34400,110110
"TR","1978-11-21",1978,11,325,0,69100,34800,103900
"TR","1978-11-22",1978,11,326,0,67200,35000,102200
"TR","1978-11-23",1978,11,327,0,65700,35100,100800
"TR","1978-11-24",1978,11,328,65600,66000,35000,166600
"TR","1978-11-25",1978,11,329,10800,64700,35000,110500
"TR","1978-11-26",1978,11,330,0,63500,35100,98600
"TR","1978-11-27",1978,11,331,0,62500,35300,97800
"TR","1978-11-28",1978,11,332,4320,61700,35300,101320
"TR","1978-11-29",1978,11,333,12800,61400,35300,109500
"TR","1978-11-30",1978,11,334,31800,61600,35300,128700
"TR","1978-12-01",1978,12,335,0,61000,35200,96200
"TR","1978-12-02",1978,12,336,0,60500,35200,95700
"TR","1978-12-03",1978,12,337,0,60100,35200,95300
"TR","1978-12-04",1978,12,338,36200,60600,35000,131800
"TR","1978-12-05",1978,12,339,18700,60500,34800,114000
"TR","1978-12-06",1978,12,340,5260,60100,34800,100160
"TR","1978-12-07",1978,12,341,2250,59700,34800,96750
"TR","1978-12-08",1978,12,342,0,59200,34800,94000
"TR","1978-12-09",1978,12,343,0,58900,34700,93600
"TR","1978-12-10",1978,12,344,0,58600,34700,93300
"TR","1978-12-11",1978,12,345,0,58300,34700,93000
"TR","1978-12-12",1978,12,346,1120,58000,34600,93720
"TR","1978-12-13",1978,12,347,0,57800,34600,92400
"TR","1978-12-14",1978,12,348,10700,57700,34500,102900
"TR","1978-12-15",1978,12,349,0,57400,34400,91800
"TR","1978-12-16",1978,12,350,0,57100,34400,91500
"TR","1978-12-17",1978,12,351,0,56900,34400,91300
"TR","1978-12-18",1978,12,352,0,56700,34300,91000
"TR","1978-12-19",1978,12,353,0,56500,34300,90800
"TR","1978-12-20",1978,12,354,2250,56300,34200,92750
"TR","1978-12-21",1978,12,355,87100,58000,33700,178800
"TR","1978-12-22",1978,12,356,59800,59100,33400,152300
"TR","1978-12-23",1978,12,357,0,58200,33300,91500
"TR","1978-12-24",1978,12,358,36000,58200,33300,127500
"TR","1978-12-25",1978,12,359,60800,59100,33000,152900
"TR","1978-12-26",1978,12,360,0,58200,33000,91200
"TR","1978-12-27",1978,12,361,0,57400,33100,90500
"TR","1978-12-28",1978,12,362,0,56800,33200,90000
"TR","1978-12-29",1978,12,363,0,56300,33200,89500
"TR","1978-12-30",1978,12,364,51300,56900,33000,141200
"TR","1978-12-31",1978,12,365,80300,58400,32600,171300
"TR","1979-01-01",1979,1,1,0,57500,32500,90000
"TR","1979-01-02",1979,1,2,0,56700,32600,89300
"TR","1979-01-03",1979,1,3,0,56100,32700,88800
"TR","1979-01-04",1979,1,4,0,55500,32700,88200
"TR","1979-01-05",1979,1,5,0,55100,32700,87800
"TR","1979-01-06",1979,1,6,0,54700,32700,87400
"TR","1979-01-07",1979,1,7,0,54400,32700,87100
"TR","1979-01-08",1979,1,8,0,54100,32700,86800
"TR","1979-01-09",1979,1,9,0,53900,32700,86600
"TR","1979-01-10",1979,1,10,4050,53700,32600,90350
"TR","1979-01-11",1979,1,11,0,53500,32600,86100
"TR","1979-01-12",1979,1,12,0,53300,32600,85900
"TR","1979-01-13",1979,1,13,0,53100,32500,85600
"TR","1979-01-14",1979,1,14,11700,53200,32500,97400
"TR","1979-01-15",1979,1,15,0,52900,32400,85300
"TR","1979-01-16",1979,1,16,0,52700,32400,85100
"TR","1979-01-17",1979,1,17,0,52500,32400,84900
"TR","1979-01-18",1979,1,18,98000,54700,31900,184600
"TR","1979-01-19",1979,1,19,0,54000,31800,85800
"TR","1979-01-20",1979,1,20,43300,54300,31700,129300
"TR","1979-01-21",1979,1,21,107000,56500,31200,194700
"TR","1979-01-22",1979,1,22,21400,55700,31100,108200
"TR","1979-01-23",1979,1,23,5920,54800,31300,92020
"TR","1979-01-24",1979,1,24,196000,58700,30600,285300
"TR","1979-01-25",1979,1,25,60000,58600,30300,148900
"TR","1979-01-26",1979,1,26,0,57000,30400,87400
"TR","1979-01-27",1979,1,27,0,55600,30700,86300
"TR","1979-01-28",1979,1,28,25800,55100,30700,111600
"TR","1979-01-29",1979,1,29,26700,54700,30700,112100
"TR","1979-01-30",1979,1,30,5920,53800,30800,90520
"TR","1979-01-31",1979,1,31,3750,53200,30900,87850
"TR","1979-02-01",1979,2,32,0,52500,30900,83400
"TR","1979-02-02",1979,2,33,0,52000,31000,83000
"TR","1979-02-03",1979,2,34,0,51800,31000,82800
"TR","1979-02-04",1979,2,35,0,51700,31000,82700
"TR","1979-02-05",1979,2,36,2430,51500,31000,84930
"TR","1979-02-06",1979,2,37,1220,51400,31000,83620
"TR","1979-02-07",1979,2,38,14300,51300,31000,96600
"TR","1979-02-08",1979,2,39,0,51200,31000,82200
"TR","1979-02-09",1979,2,40,0,51000,31000,82000
"TR","1979-02-10",1979,2,41,0,50900,31000,81900
"TR","1979-02-11",1979,2,42,0,50700,31000,81700
"TR","1979-02-12",1979,2,43,18000,50700,30900,99600
"TR","1979-02-13",1979,2,44,0,50500,30800,81300
"TR","1979-02-14",1979,2,45,24200,50600,30700,105500
"TR","1979-02-15",1979,2,46,38700,50700,30500,119900
"TR","1979-02-16",1979,2,47,66400,50900,30200,147500
"TR","1979-02-17",1979,2,48,39800,51200,30100,121100
"TR","1979-02-18",1979,2,49,0,50900,30100,81000
"TR","1979-02-19",1979,2,50,0,50700,30200,80900
"TR","1979-02-20",1979,2,51,0,50500,30300,80800
"TR","1979-02-21",1979,2,52,0,50300,30300,80600
"TR","1979-02-22",1979,2,53,76100,50700,30000,156800
"TR","1979-02-23",1979,2,54,0,50500,30000,80500
"TR","1979-02-24",1979,2,55,176000,53600,29300,258900
"TR","1979-02-25",1979,2,56,0,52400,29300,81700
"TR","1979-02-26",1979,2,57,0,51400,29500,80900
"TR","1979-02-27",1979,2,58,0,50700,29600,80300
"TR","1979-02-28",1979,2,59,0,50500,29700,80200
"TR","1979-03-01",1979,3,60,0,50200,29800,80000
"TR","1979-03-02",1979,3,61,0,49900,29900,79800
"TR","1979-03-03",1979,3,62,0,49600,30000,79600
"TR","1979-03-04",1979,3,63,51700,49500,29800,131000
"TR","1979-03-05",1979,3,64,228000,52300,28800,309100
"TR","1979-03-06",1979,3,65,271000,58300,27800,357100
"TR","1979-03-07",1979,3,66,0,55800,27800,83600
"TR","1979-03-08",1979,3,67,0,53700,28200,81900
"TR","1979-03-09",1979,3,68,0,51900,28500,80400
"TR","1979-03-10",1979,3,69,36100,51500,28600,116200
"TR","1979-03-11",1979,3,70,0,50500,28800,79300
"TR","1979-03-12",1979,3,71,4140,50300,28900,83340
"TR","1979-03-13",1979,3,72,0,50000,29000,79000
"TR","1979-03-14",1979,3,73,0,49600,29100,78700
"TR","1979-03-15",1979,3,74,19400,49400,29100,97900
"TR","1979-03-16",1979,3,75,0,49200,29200,78400
"TR","1979-03-17",1979,3,76,0,48900,29200,78100
"TR","1979-03-18",1979,3,77,0,48500,29400,77900
"TR","1979-03-19",1979,3,78,2410,48200,29500,80110
"TR","1979-03-20",1979,3,79,68200,48600,29100,145900
"TR","1979-03-21",1979,3,80,4820,52900,31200,88920
"TR","1979-03-22",1979,3,81,0,50100,32000,82100
"TR","1979-03-23",1979,3,82,0,50700,34700,85400
"TR","1979-03-24",1979,3,83,258000,138000,277000,673000
"TR","1979-03-25",1979,3,84,308000,84200,28600,420800
"TR","1979-03-26",1979,3,85,8930,75700,26800,111430
"TR","1979-03-27",1979,3,86,0,69300,27300,96600
"TR","1979-03-28",1979,3,87,0,64600,27700,92300
"TR","1979-03-29",1979,3,88,10500,61000,28100,99600
"TR","1979-03-30",1979,3,89,6700,58000,28400,93100
"TR","1979-03-31",1979,3,90,204000,60100,27900,292000
"TR","1979-04-01",1979,4,91,0,57100,28000,85100
"TR","1979-04-02",1979,4,92,0,55000,28300,83300
"TR","1979-04-03",1979,4,93,0,53300,28600,81900
"TR","1979-04-04",1979,4,94,0,52000,28800,80800
"TR","1979-04-05",1979,4,95,0,51300,29000,80300
"TR","1979-04-06",1979,4,96,2230,52200,29100,83530
"TR","1979-04-07",1979,4,97,14500,51300,29100,94900
"TR","1979-04-08",1979,4,98,0,50700,29200,79900
"TR","1979-04-09",1979,4,99,0,50400,29300,79700
"TR","1979-04-10",1979,4,100,41900,50400,29100,121400
"TR","1979-04-11",1979,4,101,0,50100,29200,79300
"TR","1979-04-12",1979,4,102,0,49700,29300,79000
"TR","1979-04-13",1979,4,103,33800,50500,29300,113600
"TR","1979-04-14",1979,4,104,29300,58400,41700,129400
"TR","1979-04-15",1979,4,105,3280,58300,42700,104280
"TR","1979-04-16",1979,4,106,0,56100,34300,90400
"TR","1979-04-17",1979,4,107,0,56500,34800,91300
"TR","1979-04-18",1979,4,108,0,59000,38800,97800
"TR","1979-04-19",1979,4,109,0,61800,41300,103100
"TR","1979-04-20",1979,4,110,0,68000,48200,116200
"TR","1979-04-21",1979,4,111,14000,269000,325000,608000
"TR","1979-04-22",1979,4,112,1e+05,212000,158000,470000
"TR","1979-04-23",1979,4,113,0,111000,42600,153600
"TR","1979-04-24",1979,4,114,0,104000,46200,150200
"TR","1979-04-25",1979,4,115,0,98500,31900,130400
"TR","1979-04-26",1979,4,116,37700,95400,31400,164500
"TR","1979-04-27",1979,4,117,86500,94800,34700,216000
"TR","1979-04-28",1979,4,118,0,90100,32100,122200
"TR","1979-04-29",1979,4,119,0,86400,32300,118700
"TR","1979-04-30",1979,4,120,0,83400,32400,115800
"TR","1979-05-01",1979,5,121,4920,79300,32500,116720
"TR","1979-05-02",1979,5,122,0,74200,32600,106800
"TR","1979-05-03",1979,5,123,41000,72000,33100,146100
"TR","1979-05-04",1979,5,124,0,67700,32900,100600
"TR","1979-05-05",1979,5,125,0,64500,33000,97500
"TR","1979-05-06",1979,5,126,165000,69300,34100,268400
"TR","1979-05-07",1979,5,127,184000,76100,44000,304100
"TR","1979-05-08",1979,5,128,26300,74400,35000,135700
"TR","1979-05-09",1979,5,129,125000,74500,39200,238700
"TR","1979-05-10",1979,5,130,449000,103000,69800,621800
"TR","1979-05-11",1979,5,131,12000,87200,32900,132100
"TR","1979-05-12",1979,5,132,296000,98300,52900,447200
"TR","1979-05-13",1979,5,133,7180,85200,31800,124180
"TR","1979-05-14",1979,5,134,122000,84000,34100,240100
"TR","1979-05-15",1979,5,135,66400,81500,36100,184000
"TR","1979-05-16",1979,5,136,0,74900,33600,108500
"TR","1979-05-17",1979,5,137,0,70800,34000,104800
"TR","1979-05-18",1979,5,138,0,66900,34000,100900
"TR","1979-05-19",1979,5,139,104000,67200,34900,206100
"TR","1979-05-20",1979,5,140,242000,80400,43000,365400
"TR","1979-05-21",1979,5,141,9040,71400,34200,114640
"TR","1979-05-22",1979,5,142,0,67200,34200,101400
"TR","1979-05-23",1979,5,143,57700,66500,34900,159100
"TR","1979-05-24",1979,5,144,30700,64800,34800,130300
"TR","1979-05-25",1979,5,145,0,62000,34500,96500
"TR","1979-05-26",1979,5,146,0,59600,34600,94200
"TR","1979-05-27",1979,5,147,0,56800,34100,90900
"TR","1979-05-28",1979,5,148,0,55000,33700,88700
"TR","1979-05-29",1979,5,149,0,54100,33700,87800
"TR","1979-05-30",1979,5,150,0,53200,33700,86900
"TR","1979-05-31",1979,5,151,65600,53700,33600,152900
"TR","1979-06-01",1979,6,152,149000,57200,34200,240400
"TR","1979-06-02",1979,6,153,113000,60300,34600,207900
"TR","1979-06-03",1979,6,154,61100,59900,34500,155500
"TR","1979-06-04",1979,6,155,9540,57200,34400,101140
"TR","1979-06-05",1979,6,156,39400,56400,34600,130400
"TR","1979-06-06",1979,6,157,79300,58300,35000,172600
"TR","1979-06-07",1979,6,158,95000,59300,35100,189400
"TR","1979-06-08",1979,6,159,109000,62100,35600,206700
"TR","1979-06-09",1979,6,160,118000,65800,36300,220100
"TR","1979-06-10",1979,6,161,13700,61500,34700,109900
"TR","1979-06-11",1979,6,162,391000,81600,39300,511900
"TR","1979-06-12",1979,6,163,88700,75200,35500,199400
"TR","1979-06-13",1979,6,164,0,68600,33900,102500
"TR","1979-06-14",1979,6,165,0,64700,34100,98800
"TR","1979-06-15",1979,6,166,0,61200,34000,95200
"TR","1979-06-16",1979,6,167,0,58100,33900,92000
"TR","1979-06-17",1979,6,168,385000,72400,37000,494400
"TR","1979-06-18",1979,6,169,660000,112000,86400,858400
"TR","1979-06-19",1979,6,170,0,91700,32300,124000
"TR","1979-06-20",1979,6,171,0,86300,33000,119300
"TR","1979-06-21",1979,6,172,32900,80300,33600,146800
"TR","1979-06-22",1979,6,173,130000,80100,35300,245400
"TR","1979-06-23",1979,6,174,7150,73800,34100,115050
"TR","1979-06-24",1979,6,175,0,69300,34000,103300
"TR","1979-06-25",1979,6,176,0,66000,34200,100200
"TR","1979-06-26",1979,6,177,0,62800,34200,97000
"TR","1979-06-27",1979,6,178,0,60000,34200,94200
"TR","1979-06-28",1979,6,179,181000,66100,36100,283200
"TR","1979-06-29",1979,6,180,0,62100,34500,96600
"TR","1979-06-30",1979,6,181,26500,60300,34600,121400
"TR","1979-07-01",1979,7,182,0,57700,34400,92100
"TR","1979-07-02",1979,7,183,0,55200,34300,89500
"TR","1979-07-03",1979,7,184,0,54000,34000,88000
"TR","1979-07-04",1979,7,185,310000,64100,36200,410300
"TR","1979-07-05",1979,7,186,51200,61100,34500,146800
"TR","1979-07-06",1979,7,187,0,57100,34100,91200
"TR","1979-07-07",1979,7,188,0,54700,33900,88600
"TR","1979-07-08",1979,7,189,0,53400,33800,87200
"TR","1979-07-09",1979,7,190,0,52300,33600,85900
"TR","1979-07-10",1979,7,191,0,51300,33400,84700
"TR","1979-07-11",1979,7,192,0,50200,33300,83500
"TR","1979-07-12",1979,7,193,0,49300,33100,82400
"TR","1979-07-13",1979,7,194,0,48500,33100,81600
"TR","1979-07-14",1979,7,195,29500,48100,33000,110600
"TR","1979-07-15",1979,7,196,13600,47500,32900,94000
"TR","1979-07-16",1979,7,197,0,46700,32800,79500
"TR","1979-07-17",1979,7,198,0,46100,32800,78900
"TR","1979-07-18",1979,7,199,0,45700,32700,78400
"TR","1979-07-19",1979,7,200,0,45200,32700,77900
"TR","1979-07-20",1979,7,201,36400,45200,32600,114200
"TR","1979-07-21",1979,7,202,34100,45300,32600,112000
"TR","1979-07-22",1979,7,203,0,44500,32400,76900
"TR","1979-07-23",1979,7,204,5610,44000,32500,82110
"TR","1979-07-24",1979,7,205,0,43300,32500,75800
"TR","1979-07-25",1979,7,206,0,42800,32500,75300
"TR","1979-07-26",1979,7,207,228000,46800,32700,307500
"TR","1979-07-27",1979,7,208,98100,47300,31800,177200
"TR","1979-07-28",1979,7,209,255000,51500,32400,338900
"TR","1979-07-29",1979,7,210,0,48700,31400,80100
"TR","1979-07-30",1979,7,211,0,47700,31800,79500
"TR","1979-07-31",1979,7,212,46900,47600,31900,126400
"TR","1979-08-01",1979,8,213,30200,47100,31900,109200
"TR","1979-08-02",1979,8,214,0,46200,31900,78100
"TR","1979-08-03",1979,8,215,0,45700,32200,77900
"TR","1979-08-04",1979,8,216,0,45100,32400,77500
"TR","1979-08-05",1979,8,217,54800,45400,32500,132700
"TR","1979-08-06",1979,8,218,0,44400,32400,76800
"TR","1979-08-07",1979,8,219,0,43900,32500,76400
"TR","1979-08-08",1979,8,220,0,43400,32600,76000
"TR","1979-08-09",1979,8,221,0,42800,32600,75400
"TR","1979-08-10",1979,8,222,23200,42600,32600,98400
"TR","1979-08-11",1979,8,223,104000,44300,32800,181100
"TR","1979-08-12",1979,8,224,0,43500,32300,75800
"TR","1979-08-13",1979,8,225,150000,46400,32600,229000
"TR","1979-08-14",1979,8,226,292000,52400,33100,377500
"TR","1979-08-15",1979,8,227,40100,48700,32000,120800
"TR","1979-08-16",1979,8,228,0,47500,32000,79500
"TR","1979-08-17",1979,8,229,24000,47300,32300,103600
"TR","1979-08-18",1979,8,230,31300,47200,32500,111000
"TR","1979-08-19",1979,8,231,0,46300,32400,78700
"TR","1979-08-20",1979,8,232,0,45500,32500,78000
"TR","1979-08-21",1979,8,233,0,44800,32500,77300
"TR","1979-08-22",1979,8,234,0,44100,32400,76500
"TR","1979-08-23",1979,8,235,187000,47700,32800,267500
"TR","1979-08-24",1979,8,236,334000,53700,34700,422400
"TR","1979-08-25",1979,8,237,98400,52200,32000,182600
"TR","1979-08-26",1979,8,238,6820,50400,31400,88620
"TR","1979-08-27",1979,8,239,145000,53100,32200,230300
"TR","1979-08-28",1979,8,240,239000,61200,33000,333200
"TR","1979-08-29",1979,8,241,0,55000,30700,85700
"TR","1979-08-30",1979,8,242,69800,55400,31500,156700
"TR","1979-08-31",1979,8,243,160000,59200,32700,251900
"TR","1979-09-01",1979,9,244,4220,54000,30800,89020
"TR","1979-09-02",1979,9,245,103000,56800,31800,191600
"TR","1979-09-03",1979,9,246,146000,60000,36100,242100
"TR","1979-09-04",1979,9,247,4270,55200,30900,90370
"TR","1979-09-05",1979,9,248,0,51900,31100,83000
"TR","1979-09-06",1979,9,249,0,50700,31300,82000
"TR","1979-09-07",1979,9,250,6600,49600,31300,87500
"TR","1979-09-08",1979,9,251,23600,49100,31300,104000
"TR","1979-09-09",1979,9,252,0,48400,31100,79500
"TR","1979-09-10",1979,9,253,0,48000,31200,79200
"TR","1979-09-11",1979,9,254,0,47200,31300,78500
"TR","1979-09-12",1979,9,255,136000,49500,31600,217100
"TR","1979-09-13",1979,9,256,185000,53100,32000,270100
"TR","1979-09-14",1979,9,257,118000,52800,31900,202700
"TR","1979-09-15",1979,9,258,7120,51000,30900,89020
"TR","1979-09-16",1979,9,259,2850,49800,31100,83750
"TR","1979-09-17",1979,9,260,0,48900,31200,80100
"TR","1979-09-18",1979,9,261,0,48200,31300,79500
"TR","1979-09-19",1979,9,262,0,47300,31200,78500
"TR","1979-09-20",1979,9,263,0,46700,31100,77800
"TR","1979-09-21",1979,9,264,0,46200,31000,77200
"TR","1979-09-22",1979,9,265,0,45700,31000,76700
"TR","1979-09-23",1979,9,266,0,45300,30900,76200
"TR","1979-09-24",1979,9,267,0,44900,30800,75700
"TR","1979-09-25",1979,9,268,0,44500,30800,75300
"TR","1979-09-26",1979,9,269,0,44100,30800,74900
"TR","1979-09-27",1979,9,270,0,43600,30800,74400
"TR","1979-09-28",1979,9,271,0,43200,30700,73900
"TR","1979-09-29",1979,9,272,0,42700,30800,73500
"TR","1979-09-30",1979,9,273,0,42300,30700,73000
"TR","1979-10-01",1979,10,274,0,42000,30600,72600
"TR","1979-10-02",1979,10,275,38600,42400,30700,111700
"TR","1979-10-03",1979,10,276,152000,45500,31000,228500
"TR","1979-10-04",1979,10,277,5080,45000,30500,80580
"TR","1979-10-05",1979,10,278,38200,45200,30800,114200
"TR","1979-10-06",1979,10,279,8680,44700,30700,84080
"TR","1979-10-07",1979,10,280,91100,46600,30800,168500
"TR","1979-10-08",1979,10,281,13900,46200,30600,90700
"TR","1979-10-09",1979,10,282,0,45500,30500,76000
"TR","1979-10-10",1979,10,283,53900,46400,30500,130800
"TR","1979-10-11",1979,10,284,22200,46600,30400,99200
"TR","1979-10-12",1979,10,285,23900,46500,30500,100900
"TR","1979-10-13",1979,10,286,35500,46700,30500,112700
"TR","1979-10-14",1979,10,287,15600,46500,30300,92400
"TR","1979-10-15",1979,10,288,4570,46100,30200,80870
"TR","1979-10-16",1979,10,289,0,45700,30200,75900
"TR","1979-10-17",1979,10,290,0,45300,30300,75600
"TR","1979-10-18",1979,10,291,0,45000,30200,75200
"TR","1979-10-19",1979,10,292,0,45000,30100,75100
"TR","1979-10-20",1979,10,293,2e+05,50500,30900,281400
"TR","1979-10-21",1979,10,294,31300,48500,29900,109700
"TR","1979-10-22",1979,10,295,156000,51700,30200,237900
"TR","1979-10-23",1979,10,296,533000,86900,40100,660000
"TR","1979-10-24",1979,10,297,558000,84800,32200,675000
"TR","1979-10-25",1979,10,298,4570,79100,26300,109970
"TR","1979-10-26",1979,10,299,0,72400,26300,98700
"TR","1979-10-27",1979,10,300,0,67500,26700,94200
"TR","1979-10-28",1979,10,301,63200,65700,27000,155900
"TR","1979-10-29",1979,10,302,0,63800,28100,91900
"TR","1979-10-30",1979,10,303,0,63700,33600,97300
"TR","1979-10-31",1979,10,304,0,64400,35800,100200
"TR","1979-11-01",1979,11,305,0,65400,40300,105700
"TR","1979-11-02",1979,11,306,160000,79900,63600,303500
"TR","1979-11-03",1979,11,307,21400,72900,33500,127800
"TR","1979-11-04",1979,11,308,2160,67400,28300,97860
"TR","1979-11-05",1979,11,309,0,63200,28400,91600
"TR","1979-11-06",1979,11,310,0,60400,28700,89100
"TR","1979-11-07",1979,11,311,28000,59900,28600,116500
"TR","1979-11-08",1979,11,312,0,58400,28700,87100
"TR","1979-11-09",1979,11,313,83700,59000,28400,171100
"TR","1979-11-10",1979,11,314,18500,57900,28400,104800
"TR","1979-11-11",1979,11,315,0,56700,28700,85400
"TR","1979-11-12",1979,11,316,0,55700,28900,84600
"TR","1979-11-13",1979,11,317,0,54700,29000,83700
"TR","1979-11-14",1979,11,318,0,53900,29200,83100
"TR","1979-11-15",1979,11,319,0,53200,29300,82500
"TR","1979-11-16",1979,11,320,17100,53100,29400,99600
"TR","1979-11-17",1979,11,321,0,52700,29500,82200
"TR","1979-11-18",1979,11,322,0,52600,29700,82300
"TR","1979-11-19",1979,11,323,0,52100,29900,82000
"TR","1979-11-20",1979,11,324,0,51700,29600,81300
"TR","1979-11-21",1979,11,325,34300,52200,29600,116100
"TR","1979-11-22",1979,11,326,47100,52700,29500,129300
"TR","1979-11-23",1979,11,327,131000,55500,28900,215400
"TR","1979-11-24",1979,11,328,33000,54900,28700,116600
"TR","1979-11-25",1979,11,329,4320,53800,28900,87020
"TR","1979-11-26",1979,11,330,0,52900,29100,82000
"TR","1979-11-27",1979,11,331,74600,54100,28800,157500
"TR","1979-11-28",1979,11,332,10800,53400,28800,93000
"TR","1979-11-29",1979,11,333,6010,52700,29000,87710
"TR","1979-11-30",1979,11,334,54700,53000,28900,136600
"TR","1979-12-01",1979,12,335,0,52300,28900,81200
"TR","1979-12-02",1979,12,336,3370,52100,29000,84470
"TR","1979-12-03",1979,12,337,0,51900,29000,80900
"TR","1979-12-04",1979,12,338,0,51700,29000,80700
"TR","1979-12-05",1979,12,339,0,51600,29000,80600
"TR","1979-12-06",1979,12,340,0,51500,29000,80500
"TR","1979-12-07",1979,12,341,0,51300,29100,80400
"TR","1979-12-08",1979,12,342,115000,52100,28500,195600
"TR","1979-12-09",1979,12,343,2250,51800,28400,82450
"TR","1979-12-10",1979,12,344,4500,51600,28500,84600
"TR","1979-12-11",1979,12,345,0,51400,28600,80000
"TR","1979-12-12",1979,12,346,0,51200,28700,79900
"TR","1979-12-13",1979,12,347,0,51100,28700,79800
"TR","1979-12-14",1979,12,348,0,50900,28700,79600
"TR","1979-12-15",1979,12,349,0,50800,28700,79500
"TR","1979-12-16",1979,12,350,0,50600,28700,79300
"TR","1979-12-17",1979,12,351,1210,50500,28700,80410
"TR","1979-12-18",1979,12,352,0,50300,28700,79000
"TR","1979-12-19",1979,12,353,0,50200,28700,78900
"TR","1979-12-20",1979,12,354,0,50100,28700,78800
"TR","1979-12-21",1979,12,355,0,49900,28700,78600
"TR","1979-12-22",1979,12,356,0,49800,28700,78500
"TR","1979-12-23",1979,12,357,0,49600,28700,78300
"TR","1979-12-24",1979,12,358,45500,49900,28400,123800
"TR","1979-12-25",1979,12,359,3640,49800,28400,81840
"TR","1979-12-26",1979,12,360,0,49600,28400,78000
"TR","1979-12-27",1979,12,361,0,49500,28400,77900
"TR","1979-12-28",1979,12,362,0,49400,28400,77800
"TR","1979-12-29",1979,12,363,0,49200,28400,77600
"TR","1979-12-30",1979,12,364,0,49100,28400,77500
"TR","1979-12-31",1979,12,365,0,49000,28400,77400
"TR","1980-01-01",1980,1,1,0,48800,28400,77200
"TR","1980-01-02",1980,1,2,0,48700,28400,77100
"TR","1980-01-03",1980,1,3,0,48600,28400,77000
"TR","1980-01-04",1980,1,4,3900,48500,28400,80800
"TR","1980-01-05",1980,1,5,0,48400,28300,76700
"TR","1980-01-06",1980,1,6,0,48300,28300,76600
"TR","1980-01-07",1980,1,7,49500,48500,28100,126100
"TR","1980-01-08",1980,1,8,287000,50900,26900,364800
"TR","1980-01-09",1980,1,9,0,50400,26700,77100
"TR","1980-01-10",1980,1,10,0,50200,27000,77200
"TR","1980-01-11",1980,1,11,0,50000,27200,77200
"TR","1980-01-12",1980,1,12,53700,50200,27100,131000
"TR","1980-01-13",1980,1,13,32500,50200,27000,109700
"TR","1980-01-14",1980,1,14,66300,50500,26800,143600
"TR","1980-01-15",1980,1,15,0,50200,26900,77100
"TR","1980-01-16",1980,1,16,86300,50400,26700,163400
"TR","1980-01-17",1980,1,17,193000,54800,26000,273800
"TR","1980-01-18",1980,1,18,192000,58000,25400,275400
"TR","1980-01-19",1980,1,19,0,55500,25500,81000
"TR","1980-01-20",1980,1,20,0,53500,25800,79300
"TR","1980-01-21",1980,1,21,0,52000,26100,78100
"TR","1980-01-22",1980,1,22,0,50800,26300,77100
"TR","1980-01-23",1980,1,23,25400,50500,26400,102300
"TR","1980-01-24",1980,1,24,20100,50400,26400,96900
"TR","1980-01-25",1980,1,25,13300,50200,26400,89900
"TR","1980-01-26",1980,1,26,5920,50000,26500,82420
"TR","1980-01-27",1980,1,27,0,49800,26600,76400
"TR","1980-01-28",1980,1,28,0,49500,26700,76200
"TR","1980-01-29",1980,1,29,0,49300,26800,76100
"TR","1980-01-30",1980,1,30,0,49000,26800,75800
"TR","1980-01-31",1980,1,31,0,48800,26900,75700
"TR","1980-02-01",1980,2,32,0,48600,26900,75500
"TR","1980-02-02",1980,2,33,0,48400,26900,75300
"TR","1980-02-03",1980,2,34,0,48200,26900,75100
"TR","1980-02-04",1980,2,35,0,48100,27000,75100
"TR","1980-02-05",1980,2,36,0,47900,27000,74900
"TR","1980-02-06",1980,2,37,0,47700,27000,74700
"TR","1980-02-07",1980,2,38,0,47500,27000,74500
"TR","1980-02-08",1980,2,39,0,47400,27000,74400
"TR","1980-02-09",1980,2,40,0,47200,27000,74200
"TR","1980-02-10",1980,2,41,3380,47100,27000,77480
"TR","1980-02-11",1980,2,42,2250,46900,27000,76150
"TR","1980-02-12",1980,2,43,13300,46900,26900,87100
"TR","1980-02-13",1980,2,44,0,46700,26900,73600
"TR","1980-02-14",1980,2,45,0,46600,26900,73500
"TR","1980-02-15",1980,2,46,0,46400,26900,73300
"TR","1980-02-16",1980,2,47,0,46300,26900,73200
"TR","1980-02-17",1980,2,48,12400,46200,26800,85400
"TR","1980-02-18",1980,2,49,0,46100,26800,72900
"TR","1980-02-19",1980,2,50,0,46000,26800,72800
"TR","1980-02-20",1980,2,51,0,45900,26800,72700
"TR","1980-02-21",1980,2,52,17700,45900,26800,90400
"TR","1980-02-22",1980,2,53,0,45700,26800,72500
"TR","1980-02-23",1980,2,54,4510,45600,26800,76910
"TR","1980-02-24",1980,2,55,0,45400,26800,72200
"TR","1980-02-25",1980,2,56,0,45300,26800,72100
"TR","1980-02-26",1980,2,57,0,45200,26800,72000
"TR","1980-02-27",1980,2,58,0,45100,26800,71900
"TR","1980-02-28",1980,2,59,5720,45000,26700,77420
"TR","1980-02-29",1980,2,60,0,44900,26700,71600
"TR","1980-03-01",1980,3,61,0,44800,26700,71500
"TR","1980-03-02",1980,3,62,0,44700,26700,71400
"TR","1980-03-03",1980,3,63,0,44600,26700,71300
"TR","1980-03-04",1980,3,64,0,44500,26700,71200
"TR","1980-03-05",1980,3,65,0,44400,26700,71100
"TR","1980-03-06",1980,3,66,17000,44400,26600,88000
"TR","1980-03-07",1980,3,67,0,44300,26500,70800
"TR","1980-03-08",1980,3,68,0,44200,26500,70700
"TR","1980-03-09",1980,3,69,0,44100,26600,70700
"TR","1980-03-10",1980,3,70,0,43900,26600,70500
"TR","1980-03-11",1980,3,71,46200,44100,26400,116700
"TR","1980-03-12",1980,3,72,0,44100,26300,70400
"TR","1980-03-13",1980,3,73,0,44000,26300,70300
"TR","1980-03-14",1980,3,74,0,43800,26400,70200
"TR","1980-03-15",1980,3,75,0,43600,26400,70000
"TR","1980-03-16",1980,3,76,0,43500,26500,70000
"TR","1980-03-17",1980,3,77,22800,43400,26400,92600
"TR","1980-03-18",1980,3,78,123000,44100,25800,192900
"TR","1980-03-19",1980,3,79,0,43900,25800,69700
"TR","1980-03-20",1980,3,80,0,43700,26000,69700
"TR","1980-03-21",1980,3,81,0,43400,26100,69500
"TR","1980-03-22",1980,3,82,0,43100,26200,69300
"TR","1980-03-23",1980,3,83,0,43000,26300,69300
"TR","1980-03-24",1980,3,84,67200,43200,26000,136400
"TR","1980-03-25",1980,3,85,8930,43100,26000,78030
"TR","1980-03-26",1980,3,86,0,42900,26100,69000
"TR","1980-03-27",1980,3,87,0,42700,26100,68800
"TR","1980-03-28",1980,3,88,72100,42900,25900,140900
"TR","1980-03-29",1980,3,89,0,43100,25900,69000
"TR","1980-03-30",1980,3,90,0,43500,26100,69600
"TR","1980-03-31",1980,3,91,0,44400,26800,71200
"TR","1980-04-01",1980,4,92,0,45000,30100,75100
"TR","1980-04-02",1980,4,93,0,45700,32600,78300
"TR","1980-04-03",1980,4,94,0,46700,33900,80600
"TR","1980-04-04",1980,4,95,0,47600,34200,81800
"TR","1980-04-05",1980,4,96,58300,49700,34000,142000
"TR","1980-04-06",1980,4,97,0,50800,35100,85900
"TR","1980-04-07",1980,4,98,57700,73200,97900,228800
"TR","1980-04-08",1980,4,99,92300,63900,52500,208700
"TR","1980-04-09",1980,4,100,110000,67600,34600,212200
"TR","1980-04-10",1980,4,101,104000,66900,31600,202500
"TR","1980-04-11",1980,4,102,48100,64400,29100,141600
"TR","1980-04-12",1980,4,103,18800,61400,29700,109900
"TR","1980-04-13",1980,4,104,11500,59100,27500,98100
"TR","1980-04-14",1980,4,105,15100,57100,27100,99300
"TR","1980-04-15",1980,4,106,0,55000,27100,82100
"TR","1980-04-16",1980,4,107,0,53200,27300,80500
"TR","1980-04-17",1980,4,108,0,51600,27300,78900
"TR","1980-04-18",1980,4,109,0,50600,27400,78000
"TR","1980-04-19",1980,4,110,0,50000,27300,77300
"TR","1980-04-20",1980,4,111,0,49400,27200,76600
"TR","1980-04-21",1980,4,112,0,48800,27100,75900
"TR","1980-04-22",1980,4,113,0,48200,27000,75200
"TR","1980-04-23",1980,4,114,0,47600,27000,74600
"TR","1980-04-24",1980,4,115,9120,47300,26800,83220
"TR","1980-04-25",1980,4,116,0,46900,27000,73900
"TR","1980-04-26",1980,4,117,4820,46600,27100,78520
"TR","1980-04-27",1980,4,118,0,46300,27200,73500
"TR","1980-04-28",1980,4,119,0,45900,27400,73300
"TR","1980-04-29",1980,4,120,0,45600,27500,73100
"TR","1980-04-30",1980,4,121,0,45300,27600,72900
"TR","1980-05-01",1980,5,122,0,44900,27800,72700
"TR","1980-05-02",1980,5,123,0,44500,28000,72500
"TR","1980-05-03",1980,5,124,0,44000,28300,72300
"TR","1980-05-04",1980,5,125,0,43500,28500,72000
"TR","1980-05-05",1980,5,126,0,43000,28800,71800
"TR","1980-05-06",1980,5,127,0,42600,29000,71600
"TR","1980-05-07",1980,5,128,0,42400,29000,71400
"TR","1980-05-08",1980,5,129,15600,42500,28900,87000
"TR","1980-05-09",1980,5,130,6880,42300,28700,77880
"TR","1980-05-10",1980,5,131,0,41700,28500,70200
"TR","1980-05-11",1980,5,132,57700,42400,28400,128500
"TR","1980-05-12",1980,5,133,183000,46100,29200,258300
"TR","1980-05-13",1980,5,134,0,43800,27700,71500
"TR","1980-05-14",1980,5,135,7000,43100,27800,77900
"TR","1980-05-15",1980,5,136,0,42500,27700,70200
"TR","1980-05-16",1980,5,137,0,42000,27600,69600
"TR","1980-05-17",1980,5,138,0,41400,27700,69100
"TR","1980-05-18",1980,5,139,0,40700,27400,68100
"TR","1980-05-19",1980,5,140,62100,41300,27500,130900
"TR","1980-05-20",1980,5,141,0,40400,27300,67700
"TR","1980-05-21",1980,5,142,0,39600,27300,66900
"TR","1980-05-22",1980,5,143,0,38700,27300,66000
"TR","1980-05-23",1980,5,144,0,38000,27300,65300
"TR","1980-05-24",1980,5,145,0,37300,27300,64600
"TR","1980-05-25",1980,5,146,0,36700,27300,64000
"TR","1980-05-26",1980,5,147,0,36300,27200,63500
"TR","1980-05-27",1980,5,148,0,35700,27300,63000
"TR","1980-05-28",1980,5,149,210000,39500,27000,276500
"TR","1980-05-29",1980,5,150,136000,41000,26300,203300
"TR","1980-05-30",1980,5,151,0,39700,26000,65700
"TR","1980-05-31",1980,5,152,443000,49200,27000,519200
"TR","1980-06-01",1980,6,153,225000,49400,26000,300400
"TR","1980-06-02",1980,6,154,13300,47000,24900,85200
"TR","1980-06-03",1980,6,155,34800,46600,25500,106900
"TR","1980-06-04",1980,6,156,0,45500,25700,71200
"TR","1980-06-05",1980,6,157,0,44700,26000,70700
"TR","1980-06-06",1980,6,158,49400,44700,26100,120200
"TR","1980-06-07",1980,6,159,267000,49900,26900,343800
"TR","1980-06-08",1980,6,160,183000,55400,26500,264900
"TR","1980-06-09",1980,6,161,129000,57400,29900,216300
"TR","1980-06-10",1980,6,162,27900,54200,25600,107700
"TR","1980-06-11",1980,6,163,0,50800,25600,76400
"TR","1980-06-12",1980,6,164,0,48200,25900,74100
"TR","1980-06-13",1980,6,165,0,46800,26000,72800
"TR","1980-06-14",1980,6,166,86200,47400,26100,159700
"TR","1980-06-15",1980,6,167,116000,49100,26300,191400
"TR","1980-06-16",1980,6,168,0,47000,25800,72800
"TR","1980-06-17",1980,6,169,0,46000,26000,72000
"TR","1980-06-18",1980,6,170,0,45100,26000,71100
"TR","1980-06-19",1980,6,171,204000,48500,26700,279200
"TR","1980-06-20",1980,6,172,259000,57400,27300,343700
"TR","1980-06-21",1980,6,173,0,51000,25400,76400
"TR","1980-06-22",1980,6,174,4420,47900,25700,78020
"TR","1980-06-23",1980,6,175,14300,46700,25800,86800
"TR","1980-06-24",1980,6,176,0,45500,25800,71300
"TR","1980-06-25",1980,6,177,0,44600,25900,70500
"TR","1980-06-26",1980,6,178,0,43800,25900,69700
"TR","1980-06-27",1980,6,179,5580,42900,26000,74480
"TR","1980-06-28",1980,6,180,117000,44100,25900,187000
"TR","1980-06-29",1980,6,181,308000,49500,26900,384400
"TR","1980-06-30",1980,6,182,101000,48600,26100,175700
"TR","1980-07-01",1980,7,183,7150,46900,25600,79650
"TR","1980-07-02",1980,7,184,38200,46400,25700,110300
"TR","1980-07-03",1980,7,185,28700,45200,25700,99600
"TR","1980-07-04",1980,7,186,0,43700,25300,69000
"TR","1980-07-05",1980,7,187,0,42700,25300,68000
"TR","1980-07-06",1980,7,188,31700,42100,25200,99000
"TR","1980-07-07",1980,7,189,0,41100,25000,66100
"TR","1980-07-08",1980,7,190,0,40300,25100,65400
"TR","1980-07-09",1980,7,191,41500,39600,25200,106300
"TR","1980-07-10",1980,7,192,0,38400,25000,63400
"TR","1980-07-11",1980,7,193,0,37500,25100,62600
"TR","1980-07-12",1980,7,194,266000,41500,25400,332900
"TR","1980-07-13",1980,7,195,37200,40200,24400,101800
"TR","1980-07-14",1980,7,196,0,38900,24500,63400
"TR","1980-07-15",1980,7,197,105000,39700,24700,169400
"TR","1980-07-16",1980,7,198,8590,38200,24400,71190
"TR","1980-07-17",1980,7,199,90600,38800,24600,154000
"TR","1980-07-18",1980,7,200,45900,38300,24400,108600
"TR","1980-07-19",1980,7,201,105000,39000,24400,168400
"TR","1980-07-20",1980,7,202,121000,40100,24500,185600
"TR","1980-07-21",1980,7,203,461000,50000,25900,536900
"TR","1980-07-22",1980,7,204,71500,44900,23300,139700
"TR","1980-07-23",1980,7,205,0,43000,23300,66300
"TR","1980-07-24",1980,7,206,0,41900,23600,65500
"TR","1980-07-25",1980,7,207,0,40800,23800,64600
"TR","1980-07-26",1980,7,208,172000,43200,24500,239700
"TR","1980-07-27",1980,7,209,0,41300,23700,65000
"TR","1980-07-28",1980,7,210,0,40300,23900,64200
"TR","1980-07-29",1980,7,211,0,39300,23900,63200
"TR","1980-07-30",1980,7,212,102000,40400,24300,166700
"TR","1980-07-31",1980,7,213,35800,39800,23900,99500
"TR","1980-08-01",1980,8,214,13600,38900,23900,76400
"TR","1980-08-02",1980,8,215,0,37800,24100,61900
"TR","1980-08-03",1980,8,216,4220,37100,24400,65720
"TR","1980-08-04",1980,8,217,0,36300,24600,60900
"TR","1980-08-05",1980,8,218,182000,39000,25000,246000
"TR","1980-08-06",1980,8,219,43500,38600,24600,106700
"TR","1980-08-07",1980,8,220,0,37400,24600,62000
"TR","1980-08-08",1980,8,221,212000,41100,25600,278700
"TR","1980-08-09",1980,8,222,3e+05,46200,26800,373000
"TR","1980-08-10",1980,8,223,0,42400,24200,66600
"TR","1980-08-11",1980,8,224,0,41200,24600,65800
"TR","1980-08-12",1980,8,225,295000,47000,26300,368300
"TR","1980-08-13",1980,8,226,0,43800,24100,67900
"TR","1980-08-14",1980,8,227,0,42700,24500,67200
"TR","1980-08-15",1980,8,228,22700,42000,24700,89400
"TR","1980-08-16",1980,8,229,0,41000,24700,65700
"TR","1980-08-17",1980,8,230,0,40400,24800,65200
"TR","1980-08-18",1980,8,231,43700,40300,24900,108900
"TR","1980-08-19",1980,8,232,11400,39600,24900,75900
"TR","1980-08-20",1980,8,233,592000,55700,28200,675900
"TR","1980-08-21",1980,8,234,275000,52700,34400,362100
"TR","1980-08-22",1980,8,235,229000,55300,35900,320200
"TR","1980-08-23",1980,8,236,0,49100,22700,71800
"TR","1980-08-24",1980,8,237,0,47500,23200,70700
"TR","1980-08-25",1980,8,238,3e+05,56900,24800,381700
"TR","1980-08-26",1980,8,239,331000,70500,54200,455700
"TR","1980-08-27",1980,8,240,697000,102000,73200,872200
"TR","1980-08-28",1980,8,241,508000,111000,63700,682700
"TR","1980-08-29",1980,8,242,8210,96300,21400,125910
"TR","1980-08-30",1980,8,243,4940,90900,22300,118140
"TR","1980-08-31",1980,8,244,160000,91300,28400,279700
"TR","1980-09-01",1980,9,245,63600,86700,24700,175000
"TR","1980-09-02",1980,9,246,176000,90300,36800,303100
"TR","1980-09-03",1980,9,247,0,82300,24600,106900
"TR","1980-09-04",1980,9,248,169000,84500,26300,279800
"TR","1980-09-05",1980,9,249,345000,98300,56300,499600
"TR","1980-09-06",1980,9,250,0,85500,24900,110400
"TR","1980-09-07",1980,9,251,0,79100,25800,104900
"TR","1980-09-08",1980,9,252,0,72000,26400,98400
"TR","1980-09-09",1980,9,253,0,66400,26900,93300
"TR","1980-09-10",1980,9,254,50900,64400,27500,142800
"TR","1980-09-11",1980,9,255,0,60500,27600,88100
"TR","1980-09-12",1980,9,256,0,57700,28000,85700
"TR","1980-09-13",1980,9,257,22900,55800,28200,106900
"TR","1980-09-14",1980,9,258,712000,101000,54400,867400
"TR","1980-09-15",1980,9,259,43500,81800,30800,156100
"TR","1980-09-16",1980,9,260,1420,73800,27700,102920
"TR","1980-09-17",1980,9,261,12800,69300,28500,110600
"TR","1980-09-18",1980,9,262,0,65300,28800,94100
"TR","1980-09-19",1980,9,263,9170,62800,29300,101270
"TR","1980-09-20",1980,9,264,0,60100,29500,89600
"TR","1980-09-21",1980,9,265,40600,59600,30000,130200
"TR","1980-09-22",1980,9,266,620000,105000,70700,795700
"TR","1980-09-23",1980,9,267,0,85600,30500,116100
"TR","1980-09-24",1980,9,268,0,77800,29100,106900
"TR","1980-09-25",1980,9,269,41700,75400,29700,146800
"TR","1980-09-26",1980,9,270,68500,76900,31500,176900
"TR","1980-09-27",1980,9,271,8030,73500,32400,113930
"TR","1980-09-28",1980,9,272,6670,69400,30600,106670
"TR","1980-09-29",1980,9,273,0,66100,30800,96900
"TR","1980-09-30",1980,9,274,0,63500,31200,94700
"TR","1980-10-01",1980,10,275,7610,61100,31200,99910
"TR","1980-10-02",1980,10,276,11400,59400,31300,102100
"TR","1980-10-03",1980,10,277,49900,59400,31600,140900
"TR","1980-10-04",1980,10,278,80800,63000,31900,175700
"TR","1980-10-05",1980,10,279,0,61600,31700,93300
"TR","1980-10-06",1980,10,280,0,60100,31700,91800
"TR","1980-10-07",1980,10,281,0,58800,31800,90600
"TR","1980-10-08",1980,10,282,0,57400,31900,89300
"TR","1980-10-09",1980,10,283,0,56200,31900,88100
"TR","1980-10-10",1980,10,284,0,55600,31800,87400
"TR","1980-10-11",1980,10,285,0,55200,31800,87000
"TR","1980-10-12",1980,10,286,32400,56300,31800,120500
"TR","1980-10-13",1980,10,287,7610,55800,31600,95010
"TR","1980-10-14",1980,10,288,0,55300,31700,87000
"TR","1980-10-15",1980,10,289,4570,55100,31900,91570
"TR","1980-10-16",1980,10,290,2280,54700,32000,88980
"TR","1980-10-17",1980,10,291,11300,54800,32000,98100
"TR","1980-10-18",1980,10,292,117000,60600,32800,210400
"TR","1980-10-19",1980,10,293,28200,59600,32400,120200
"TR","1980-10-20",1980,10,294,11100,58100,32000,101200
"TR","1980-10-21",1980,10,295,0,56900,32000,88900
"TR","1980-10-22",1980,10,296,10600,56300,32100,99000
"TR","1980-10-23",1980,10,297,0,55500,31900,87400
"TR","1980-10-24",1980,10,298,41500,57100,32000,130600
"TR","1980-10-25",1980,10,299,376000,79900,44900,500800
"TR","1980-10-26",1980,10,300,184000,77400,36200,297600
"TR","1980-10-27",1980,10,301,30500,73000,30800,134300
"TR","1980-10-28",1980,10,302,0,69500,30400,99900
"TR","1980-10-29",1980,10,303,0,66900,30600,97500
"TR","1980-10-30",1980,10,304,0,65300,30900,96200
"TR","1980-10-31",1980,10,305,0,64900,34500,99400
"TR","1980-11-01",1980,11,306,0,64800,38400,103200
"TR","1980-11-02",1980,11,307,0,62700,36000,98700
"TR","1980-11-03",1980,11,308,0,60200,31200,91400
"TR","1980-11-04",1980,11,309,1120,58700,31100,90920
"TR","1980-11-05",1980,11,310,0,57600,31000,88600
"TR","1980-11-06",1980,11,311,0,56800,30800,87600
"TR","1980-11-07",1980,11,312,0,56000,30800,86800
"TR","1980-11-08",1980,11,313,22000,56000,30700,108700
"TR","1980-11-09",1980,11,314,47600,56500,30100,134200
"TR","1980-11-10",1980,11,315,68200,59300,30500,158000
"TR","1980-11-11",1980,11,316,8640,58700,30500,97840
"TR","1980-11-12",1980,11,317,0,57700,30700,88400
"TR","1980-11-13",1980,11,318,87100,59300,30300,176700
"TR","1980-11-14",1980,11,319,52000,59700,30100,141800
"TR","1980-11-15",1980,11,320,17300,58900,30200,106400
"TR","1980-11-16",1980,11,321,0,57900,30300,88200
"TR","1980-11-17",1980,11,322,0,57100,30500,87600
"TR","1980-11-18",1980,11,323,0,56300,30600,86900
"TR","1980-11-19",1980,11,324,0,55900,30700,86600
"TR","1980-11-20",1980,11,325,0,55400,30800,86200
"TR","1980-11-21",1980,11,326,0,55200,31000,86200
"TR","1980-11-22",1980,11,327,26200,58700,31900,116800
"TR","1980-11-23",1980,11,328,0,56100,30800,86900
"TR","1980-11-24",1980,11,329,0,54800,30800,85600
"TR","1980-11-25",1980,11,330,9750,54200,30500,94450
"TR","1980-11-26",1980,11,331,0,53800,30400,84200
"TR","1980-11-27",1980,11,332,0,53600,30400,84000
"TR","1980-11-28",1980,11,333,0,53200,30300,83500
"TR","1980-11-29",1980,11,334,0,52700,30200,82900
"TR","1980-11-30",1980,11,335,0,52400,30100,82500
"TR","1980-12-01",1980,12,336,0,52100,30000,82100
"TR","1980-12-02",1980,12,337,0,52000,29900,81900
"TR","1980-12-03",1980,12,338,3640,52100,29800,85540
"TR","1980-12-04",1980,12,339,10100,52300,29800,92200
"TR","1980-12-05",1980,12,340,13100,52600,29700,95400
"TR","1980-12-06",1980,12,341,1120,52300,29700,83120
"TR","1980-12-07",1980,12,342,2420,52600,29900,84920
"TR","1980-12-08",1980,12,343,12700,53000,29900,95600
"TR","1980-12-09",1980,12,344,23900,53300,29800,107000
"TR","1980-12-10",1980,12,345,1120,52900,29700,83720
"TR","1980-12-11",1980,12,346,4260,52700,29700,86660
"TR","1980-12-12",1980,12,347,0,52500,29700,82200
"TR","1980-12-13",1980,12,348,14600,52500,29600,96700
"TR","1980-12-14",1980,12,349,2420,52300,29600,84320
"TR","1980-12-15",1980,12,350,0,52000,29600,81600
"TR","1980-12-16",1980,12,351,0,51800,29600,81400
"TR","1980-12-17",1980,12,352,9290,51900,29500,90690
"TR","1980-12-18",1980,12,353,10400,51800,29400,91600
"TR","1980-12-19",1980,12,354,13800,52000,29400,95200
"TR","1980-12-20",1980,12,355,0,51700,29300,81000
"TR","1980-12-21",1980,12,356,0,51500,29300,80800
"TR","1980-12-22",1980,12,357,0,51300,29300,80600
"TR","1980-12-23",1980,12,358,14200,51500,29200,94900
"TR","1980-12-24",1980,12,359,10800,51500,29100,91400
"TR","1980-12-25",1980,12,360,10900,51400,29100,91400
"TR","1980-12-26",1980,12,361,0,51100,29000,80100
"TR","1980-12-27",1980,12,362,0,50900,29000,79900
"TR","1980-12-28",1980,12,363,0,50600,29000,79600
"TR","1980-12-29",1980,12,364,0,50500,29000,79500
"TR","1980-12-30",1980,12,365,0,50400,29000,79400
"TR","1980-12-31",1980,12,366,8990,50300,28900,88190
"TR","1981-01-01",1981,1,1,85500,52200,28500,166200
"TR","1981-01-02",1981,1,2,0,51500,28400,79900
"TR","1981-01-03",1981,1,3,15200,51400,28500,95100
"TR","1981-01-04",1981,1,4,6070,51100,28400,85570
"TR","1981-01-05",1981,1,5,0,50600,28500,79100
"TR","1981-01-06",1981,1,6,0,50300,28500,78800
"TR","1981-01-07",1981,1,7,0,50200,28500,78700
"TR","1981-01-08",1981,1,8,0,50000,28500,78500
"TR","1981-01-09",1981,1,9,0,49900,28500,78400
"TR","1981-01-10",1981,1,10,0,49800,28500,78300
"TR","1981-01-11",1981,1,11,0,49700,28400,78100
"TR","1981-01-12",1981,1,12,0,49500,28400,77900
"TR","1981-01-13",1981,1,13,0,49400,28400,77800
"TR","1981-01-14",1981,1,14,0,49300,28400,77700
"TR","1981-01-15",1981,1,15,11300,49200,28300,88800
"TR","1981-01-16",1981,1,16,21100,49200,28200,98500
"TR","1981-01-17",1981,1,17,39000,49400,28000,116400
"TR","1981-01-18",1981,1,18,0,49300,28000,77300
"TR","1981-01-19",1981,1,19,0,49100,28000,77100
"TR","1981-01-20",1981,1,20,0,48900,28100,77000
"TR","1981-01-21",1981,1,21,0,48800,28100,76900
"TR","1981-01-22",1981,1,22,0,48600,28100,76700
"TR","1981-01-23",1981,1,23,0,48500,28100,76600
"TR","1981-01-24",1981,1,24,0,48300,28100,76400
"TR","1981-01-25",1981,1,25,0,48100,28100,76200
"TR","1981-01-26",1981,1,26,0,47900,28100,76000
"TR","1981-01-27",1981,1,27,0,48600,28500,77100
"TR","1981-01-28",1981,1,28,2020,48100,28100,78220
"TR","1981-01-29",1981,1,29,0,47800,28100,75900
"TR","1981-01-30",1981,1,30,0,47600,28000,75600
"TR","1981-01-31",1981,1,31,0,47500,28000,75500
"TR","1981-02-01",1981,2,32,0,47400,27900,75300
"TR","1981-02-02",1981,2,33,45200,47600,27700,120500
"TR","1981-02-03",1981,2,34,2430,47600,27600,77630
"TR","1981-02-04",1981,2,35,0,47500,27600,75100
"TR","1981-02-05",1981,2,36,0,47400,27600,75000
"TR","1981-02-06",1981,2,37,10100,47300,27600,85000
"TR","1981-02-07",1981,2,38,1220,47200,27500,75920
"TR","1981-02-08",1981,2,39,15700,47200,27500,90400
"TR","1981-02-09",1981,2,40,18200,47200,27400,92800
"TR","1981-02-10",1981,2,41,1220,47100,27300,75620
"TR","1981-02-11",1981,2,42,31500,47100,27200,105800
"TR","1981-02-12",1981,2,43,17000,47200,27100,91300
"TR","1981-02-13",1981,2,44,0,47000,27100,74100
"TR","1981-02-14",1981,2,45,0,46900,27200,74100
"TR","1981-02-15",1981,2,46,0,46800,27200,74000
"TR","1981-02-16",1981,2,47,0,46600,27200,73800
"TR","1981-02-17",1981,2,48,0,46600,27300,73900
"TR","1981-02-18",1981,2,49,0,48700,28100,76800
"TR","1981-02-19",1981,2,50,19500,53700,40300,113500
"TR","1981-02-20",1981,2,51,24000,50100,28100,102200
"TR","1981-02-21",1981,2,52,0,48900,27100,76000
"TR","1981-02-22",1981,2,53,0,48400,27100,75500
"TR","1981-02-23",1981,2,54,119000,52600,33600,205200
"TR","1981-02-24",1981,2,55,201000,56100,28400,285500
"TR","1981-02-25",1981,2,56,31200,54400,26000,111600
"TR","1981-02-26",1981,2,57,0,52600,26000,78600
"TR","1981-02-27",1981,2,58,0,51300,26200,77500
"TR","1981-02-28",1981,2,59,10100,50300,26300,86700
"TR","1981-03-01",1981,3,60,55600,50800,26200,132600
"TR","1981-03-02",1981,3,61,0,49700,26300,76000
"TR","1981-03-03",1981,3,62,0,49300,26400,75700
"TR","1981-03-04",1981,3,63,0,49000,26500,75500
"TR","1981-03-05",1981,3,64,0,48700,26600,75300
"TR","1981-03-06",1981,3,65,0,48500,26600,75100
"TR","1981-03-07",1981,3,66,2230,48200,26700,77130
"TR","1981-03-08",1981,3,67,0,48000,26700,74700
"TR","1981-03-09",1981,3,68,0,47600,26800,74400
"TR","1981-03-10",1981,3,69,0,47300,26900,74200
"TR","1981-03-11",1981,3,70,0,47000,26900,73900
"TR","1981-03-12",1981,3,71,0,46700,27000,73700
"TR","1981-03-13",1981,3,72,0,46700,27000,73700
"TR","1981-03-14",1981,3,73,0,46900,28400,75300
"TR","1981-03-15",1981,3,74,0,46300,27200,73500
"TR","1981-03-16",1981,3,75,0,45900,27700,73600
"TR","1981-03-17",1981,3,76,0,45500,28100,73600
"TR","1981-03-18",1981,3,77,48000,45200,26500,119700
"TR","1981-03-19",1981,3,78,0,45100,26500,71600
"TR","1981-03-20",1981,3,79,0,45000,26600,71600
"TR","1981-03-21",1981,3,80,0,44900,26600,71500
"TR","1981-03-22",1981,3,81,0,44700,26700,71400
"TR","1981-03-23",1981,3,82,0,44300,26600,70900
"TR","1981-03-24",1981,3,83,0,43900,26400,70300
"TR","1981-03-25",1981,3,84,0,43600,26200,69800
"TR","1981-03-26",1981,3,85,0,43100,26100,69200
"TR","1981-03-27",1981,3,86,20600,43300,25900,89800
"TR","1981-03-28",1981,3,87,4460,42900,25700,73060
"TR","1981-03-29",1981,3,88,4470,42600,25600,72670
"TR","1981-03-30",1981,3,89,29800,42800,25600,98200
"TR","1981-03-31",1981,3,90,43400,42900,25900,112200
"TR","1981-04-01",1981,4,91,4820,42100,25600,72520
"TR","1981-04-02",1981,4,92,53200,43000,26000,122200
"TR","1981-04-03",1981,4,93,4820,42400,25700,72920
"TR","1981-04-04",1981,4,94,38000,42800,25800,106600
"TR","1981-04-05",1981,4,95,786000,75400,66600,928000
"TR","1981-04-06",1981,4,96,65300,66700,26800,158800
"TR","1981-04-07",1981,4,97,0,62200,24200,86400
"TR","1981-04-08",1981,4,98,0,61300,29900,91200
"TR","1981-04-09",1981,4,99,13300,59200,24700,97200
"TR","1981-04-10",1981,4,100,0,54300,24700,79000
"TR","1981-04-11",1981,4,101,23000,52700,25000,100700
"TR","1981-04-12",1981,4,102,0,50200,25000,75200
"TR","1981-04-13",1981,4,103,0,49100,25100,74200
"TR","1981-04-14",1981,4,104,18200,49000,25200,92400
"TR","1981-04-15",1981,4,105,9830,48500,25200,83530
"TR","1981-04-16",1981,4,106,0,48000,25100,73100
"TR","1981-04-17",1981,4,107,0,47500,25300,72800
"TR","1981-04-18",1981,4,108,1640,47100,25400,74140
"TR","1981-04-19",1981,4,109,0,46600,25300,71900
"TR","1981-04-20",1981,4,110,71000,47900,25700,144600
"TR","1981-04-21",1981,4,111,0,46600,25300,71900
"TR","1981-04-22",1981,4,112,0,45900,25500,71400
"TR","1981-04-23",1981,4,113,7680,45500,25700,78880
"TR","1981-04-24",1981,4,114,310000,55900,32700,398600
"TR","1981-04-25",1981,4,115,61200,52600,27700,141500
"TR","1981-04-26",1981,4,116,0,49900,25100,75000
"TR","1981-04-27",1981,4,117,9710,48600,25400,83710
"TR","1981-04-28",1981,4,118,0,47800,25400,73200
"TR","1981-04-29",1981,4,119,3840,47500,25400,76740
"TR","1981-04-30",1981,4,120,0,46900,25400,72300
"TR","1981-05-01",1981,5,121,0,46500,25400,71900
"TR","1981-05-02",1981,5,122,15400,46500,25400,87300
"TR","1981-05-03",1981,5,123,0,46000,25300,71300
"TR","1981-05-04",1981,5,124,168000,50100,26100,244200
"TR","1981-05-05",1981,5,125,573000,83400,58300,714700
"TR","1981-05-06",1981,5,126,717000,114000,81600,912600
"TR","1981-05-07",1981,5,127,0,91300,26700,118000
"TR","1981-05-08",1981,5,128,0,85600,23400,109000
"TR","1981-05-09",1981,5,129,0,80300,24000,104300
"TR","1981-05-10",1981,5,130,20700,74400,24500,119600
"TR","1981-05-11",1981,5,131,0,68600,24800,93400
"TR","1981-05-12",1981,5,132,0,64200,25300,89500
"TR","1981-05-13",1981,5,133,0,60400,25700,86100
"TR","1981-05-14",1981,5,134,0,56700,26000,82700
"TR","1981-05-15",1981,5,135,0,53300,26100,79400
"TR","1981-05-16",1981,5,136,0,50400,26300,76700
"TR","1981-05-17",1981,5,137,0,49300,26300,75600
"TR","1981-05-18",1981,5,138,0,48500,26600,75100
"TR","1981-05-19",1981,5,139,0,47600,26700,74300
"TR","1981-05-20",1981,5,140,0,46700,26900,73600
"TR","1981-05-21",1981,5,141,0,45900,27100,73000
"TR","1981-05-22",1981,5,142,0,45100,27200,72300
"TR","1981-05-23",1981,5,143,0,44300,27300,71600
"TR","1981-05-24",1981,5,144,99800,45300,27200,172300
"TR","1981-05-25",1981,5,145,664000,67700,28700,760400
"TR","1981-05-26",1981,5,146,28600,57900,25400,111900
"TR","1981-05-27",1981,5,147,47300,56200,26300,129800
"TR","1981-05-28",1981,5,148,0,53200,26500,79700
"TR","1981-05-29",1981,5,149,2220,51000,26900,80120
"TR","1981-05-30",1981,5,150,145000,55000,27700,227700
"TR","1981-05-31",1981,5,151,15500,52000,27200,94700
"TR","1981-06-01",1981,6,152,0,49500,27200,76700
"TR","1981-06-02",1981,6,153,0,48800,27500,76300
"TR","1981-06-03",1981,6,154,0,47900,27600,75500
"TR","1981-06-04",1981,6,155,66700,48600,28000,143300
"TR","1981-06-05",1981,6,156,22500,47900,27700,98100
"TR","1981-06-06",1981,6,157,0,47000,27700,74700
"TR","1981-06-07",1981,6,158,0,46300,27900,74200
"TR","1981-06-08",1981,6,159,30900,46000,27800,104700
"TR","1981-06-09",1981,6,160,77600,46800,28100,152500
"TR","1981-06-10",1981,6,161,0,45800,27800,73600
"TR","1981-06-11",1981,6,162,25500,45600,27900,99000
"TR","1981-06-12",1981,6,163,106000,47000,28200,181200
"TR","1981-06-13",1981,6,164,147000,48900,28200,224100
"TR","1981-06-14",1981,6,165,0,47100,27700,74800
"TR","1981-06-15",1981,6,166,1400000,140000,128000,1668000
"TR","1981-06-16",1981,6,167,953000,154000,111000,1218000
"TR","1981-06-17",1981,6,168,30900,122000,41600,194500
"TR","1981-06-18",1981,6,169,0,114000,23600,137600
"TR","1981-06-19",1981,6,170,0,108000,24700,132700
"TR","1981-06-20",1981,6,171,39800,103000,25700,168500
"TR","1981-06-21",1981,6,172,654000,130000,54000,838000
"TR","1981-06-22",1981,6,173,105000,115000,38700,258700
"TR","1981-06-23",1981,6,174,273000,121000,41000,435000
"TR","1981-06-24",1981,6,175,25000,109000,27300,161300
"TR","1981-06-25",1981,6,176,121000,109000,32300,262300
"TR","1981-06-26",1981,6,177,9540,103000,28900,141440
"TR","1981-06-27",1981,6,178,0,99000,29200,128200
"TR","1981-06-28",1981,6,179,0,96200,29800,126000
"TR","1981-06-29",1981,6,180,108000,95700,31000,234700
"TR","1981-06-30",1981,6,181,419000,114000,51200,584200
"TR","1981-07-01",1981,7,182,0,99700,30400,130100
"TR","1981-07-02",1981,7,183,0,95400,31000,126400
"TR","1981-07-03",1981,7,184,0,91100,31000,122100
"TR","1981-07-04",1981,7,185,0,87000,31000,118000
"TR","1981-07-05",1981,7,186,57600,82300,31300,171200
"TR","1981-07-06",1981,7,187,0,75000,31200,106200
"TR","1981-07-07",1981,7,188,0,69500,31200,100700
"TR","1981-07-08",1981,7,189,0,65200,31300,96500
"TR","1981-07-09",1981,7,190,0,61600,31400,93000
"TR","1981-07-10",1981,7,191,267000,70100,33000,370100
"TR","1981-07-11",1981,7,192,0,62900,31600,94500
"TR","1981-07-12",1981,7,193,0,59200,31600,90800
"TR","1981-07-13",1981,7,194,1770,56900,31700,90370
"TR","1981-07-14",1981,7,195,38600,56600,31900,127100
"TR","1981-07-15",1981,7,196,9810,55400,31900,97110
"TR","1981-07-16",1981,7,197,148000,59900,32600,240500
"TR","1981-07-17",1981,7,198,5050,57500,32000,94550
"TR","1981-07-18",1981,7,199,0,55400,32100,87500
"TR","1981-07-19",1981,7,200,16600,54900,32300,103800
"TR","1981-07-20",1981,7,201,0,53900,32200,86100
"TR","1981-07-21",1981,7,202,92700,55200,32500,180400
"TR","1981-07-22",1981,7,203,52900,54900,32400,140200
"TR","1981-07-23",1981,7,204,0,53900,32200,86100
"TR","1981-07-24",1981,7,205,0,53300,32300,85600
"TR","1981-07-25",1981,7,206,0,52600,32300,84900
"TR","1981-07-26",1981,7,207,18200,52200,32300,102700
"TR","1981-07-27",1981,7,208,0,51600,32200,83800
"TR","1981-07-28",1981,7,209,0,51200,32200,83400
"TR","1981-07-29",1981,7,210,15000,51000,32200,98200
"TR","1981-07-30",1981,7,211,0,50500,32200,82700
"TR","1981-07-31",1981,7,212,0,50100,32200,82300
"TR","1981-08-01",1981,8,213,0,49600,32200,81800
"TR","1981-08-02",1981,8,214,126000,51600,32400,210000
"TR","1981-08-03",1981,8,215,47300,51400,32300,131000
"TR","1981-08-04",1981,8,216,0,50300,32300,82600
"TR","1981-08-05",1981,8,217,128000,52200,32900,213100
"TR","1981-08-06",1981,8,218,0,50900,32500,83400
"TR","1981-08-07",1981,8,219,35800,50800,32800,119400
"TR","1981-08-08",1981,8,220,217000,56400,33700,307100
"TR","1981-08-09",1981,8,221,41000,55400,32900,129300
"TR","1981-08-10",1981,8,222,48200,55300,33200,136700
"TR","1981-08-11",1981,8,223,0,53100,33000,86100
"TR","1981-08-12",1981,8,224,13300,52200,33100,98600
"TR","1981-08-13",1981,8,225,0,51300,33100,84400
"TR","1981-08-14",1981,8,226,0,50600,33200,83800
"TR","1981-08-15",1981,8,227,0,49900,33100,83000
"TR","1981-08-16",1981,8,228,0,49200,33000,82200
"TR","1981-08-17",1981,8,229,0,48800,32800,81600
"TR","1981-08-18",1981,8,230,0,48200,32900,81100
"TR","1981-08-19",1981,8,231,0,47700,32800,80500
"TR","1981-08-20",1981,8,232,0,47300,32700,80000
"TR","1981-08-21",1981,8,233,0,46900,32600,79500
"TR","1981-08-22",1981,8,234,0,46500,32600,79100
"TR","1981-08-23",1981,8,235,11400,46300,32600,90300
"TR","1981-08-24",1981,8,236,0,45800,32500,78300
"TR","1981-08-25",1981,8,237,0,45500,32500,78000
"TR","1981-08-26",1981,8,238,20900,45300,32500,98700
"TR","1981-08-27",1981,8,239,119000,47200,32500,198700
"TR","1981-08-28",1981,8,240,6820,46300,32000,85120
"TR","1981-08-29",1981,8,241,0,45700,32100,77800
"TR","1981-08-30",1981,8,242,73300,46700,32200,152200
"TR","1981-08-31",1981,8,243,39500,47000,32000,118500
"TR","1981-09-01",1981,9,244,0,46100,31900,78000
"TR","1981-09-02",1981,9,245,7920,45700,32100,85720
"TR","1981-09-03",1981,9,246,0,45200,32000,77200
"TR","1981-09-04",1981,9,247,0,44900,32100,77000
"TR","1981-09-05",1981,9,248,0,44500,32100,76600
"TR","1981-09-06",1981,9,249,0,44100,32100,76200
"TR","1981-09-07",1981,9,250,0,43800,32000,75800
"TR","1981-09-08",1981,9,251,141000,46400,32100,219500
"TR","1981-09-09",1981,9,252,75900,47000,31900,154800
"TR","1981-09-10",1981,9,253,0,46200,31600,77800
"TR","1981-09-11",1981,9,254,0,45700,31800,77500
"TR","1981-09-12",1981,9,255,0,44900,31900,76800
"TR","1981-09-13",1981,9,256,0,44300,31800,76100
"TR","1981-09-14",1981,9,257,0,43900,31800,75700
"TR","1981-09-15",1981,9,258,0,43500,31800,75300
"TR","1981-09-16",1981,9,259,5280,43200,31600,80080
"TR","1981-09-17",1981,9,260,28000,43500,31500,103000
"TR","1981-09-18",1981,9,261,8540,43300,31300,83140
"TR","1981-09-19",1981,9,262,4270,43200,31300,78770
"TR","1981-09-20",1981,9,263,0,42900,31200,74100
"TR","1981-09-21",1981,9,264,0,42800,31200,74000
"TR","1981-09-22",1981,9,265,10700,42800,31100,84600
"TR","1981-09-23",1981,9,266,0,42600,31000,73600
"TR","1981-09-24",1981,9,267,0,42500,31000,73500
"TR","1981-09-25",1981,9,268,25200,42700,30900,98800
"TR","1981-09-26",1981,9,269,19800,42700,30900,93400
"TR","1981-09-27",1981,9,270,20000,42700,30900,93600
"TR","1981-09-28",1981,9,271,37900,43100,30900,111900
"TR","1981-09-29",1981,9,272,0,42700,30600,73300
"TR","1981-09-30",1981,9,273,32800,43200,30700,106700
"TR","1981-10-01",1981,10,274,85900,45000,30600,161500
"TR","1981-10-02",1981,10,275,450000,58300,32600,540900
"TR","1981-10-03",1981,10,276,48200,53600,29100,130900
"TR","1981-10-04",1981,10,277,0,51900,29100,81000
"TR","1981-10-05",1981,10,278,169000,59700,30100,258800
"TR","1981-10-06",1981,10,279,26000,57700,29100,112800
"TR","1981-10-07",1981,10,280,164000,65000,33000,262000
"TR","1981-10-08",1981,10,281,0,60700,28700,89400
"TR","1981-10-09",1981,10,282,0,57800,28700,86500
"TR","1981-10-10",1981,10,283,0,55400,28800,84200
"TR","1981-10-11",1981,10,284,41700,55100,29000,125800
"TR","1981-10-12",1981,10,285,3470,53200,28900,85570
"TR","1981-10-13",1981,10,286,0,51600,29000,80600
"TR","1981-10-14",1981,10,287,0,50500,29100,79600
"TR","1981-10-15",1981,10,288,246000,63700,29900,339600
"TR","1981-10-16",1981,10,289,56800,61900,32900,151600
"TR","1981-10-17",1981,10,290,0,58800,28800,87600
"TR","1981-10-18",1981,10,291,80500,60000,30100,170600
"TR","1981-10-19",1981,10,292,249000,73600,46500,369100
"TR","1981-10-20",1981,10,293,17900,67200,29500,114600
"TR","1981-10-21",1981,10,294,0,63300,27600,90900
"TR","1981-10-22",1981,10,295,6350,60500,27900,94750
"TR","1981-10-23",1981,10,296,8460,58400,28000,94860
"TR","1981-10-24",1981,10,297,27700,57500,28100,113300
"TR","1981-10-25",1981,10,298,0,55700,28000,83700
"TR","1981-10-26",1981,10,299,27100,55600,28100,110800
"TR","1981-10-27",1981,10,300,0,54100,28200,82300
"TR","1981-10-28",1981,10,301,0,53000,28400,81400
"TR","1981-10-29",1981,10,302,0,51800,28500,80300
"TR","1981-10-30",1981,10,303,0,51000,28500,79500
"TR","1981-10-31",1981,10,304,0,50500,28500,79000
"TR","1981-11-01",1981,11,305,0,50200,28500,78700
"TR","1981-11-02",1981,11,306,0,49900,28400,78300
"TR","1981-11-03",1981,11,307,0,49600,28200,77800
"TR","1981-11-04",1981,11,308,0,49400,28100,77500
"TR","1981-11-05",1981,11,309,0,49100,28000,77100
"TR","1981-11-06",1981,11,310,4030,48900,28200,81130
"TR","1981-11-07",1981,11,311,2410,48700,28300,79410
"TR","1981-11-08",1981,11,312,0,48500,28400,76900
"TR","1981-11-09",1981,11,313,0,48200,28500,76700
"TR","1981-11-10",1981,11,314,0,48100,28500,76600
"TR","1981-11-11",1981,11,315,0,47900,28500,76400
"TR","1981-11-12",1981,11,316,0,47700,28500,76200
"TR","1981-11-13",1981,11,317,0,47600,28500,76100
"TR","1981-11-14",1981,11,318,0,47400,28600,76000
"TR","1981-11-15",1981,11,319,0,47200,28600,75800
"TR","1981-11-16",1981,11,320,0,47100,28700,75800
"TR","1981-11-17",1981,11,321,0,46900,28700,75600
"TR","1981-11-18",1981,11,322,0,46700,28700,75400
"TR","1981-11-19",1981,11,323,0,46600,28700,75300
"TR","1981-11-20",1981,11,324,0,46500,28700,75200
"TR","1981-11-21",1981,11,325,108000,47200,28000,183200
"TR","1981-11-22",1981,11,326,0,47200,27900,75100
"TR","1981-11-23",1981,11,327,0,47100,27900,75000
"TR","1981-11-24",1981,11,328,0,47000,28000,75000
"TR","1981-11-25",1981,11,329,0,46900,28000,74900
"TR","1981-11-26",1981,11,330,10300,47000,28100,85400
"TR","1981-11-27",1981,11,331,15000,47400,28400,90800
"TR","1981-11-28",1981,11,332,21600,47200,28100,96900
"TR","1981-11-29",1981,11,333,0,46600,27900,74500
"TR","1981-11-30",1981,11,334,0,46400,27900,74300
"TR","1981-12-01",1981,12,335,0,46300,27900,74200
"TR","1981-12-02",1981,12,336,18600,46400,27600,92600
"TR","1981-12-03",1981,12,337,59600,46800,27300,133700
"TR","1981-12-04",1981,12,338,13600,46900,27200,87700
"TR","1981-12-05",1981,12,339,0,46800,27200,74000
"TR","1981-12-06",1981,12,340,0,46700,27300,74000
"TR","1981-12-07",1981,12,341,0,46600,27300,73900
"TR","1981-12-08",1981,12,342,0,46500,27300,73800
"TR","1981-12-09",1981,12,343,14000,46500,27200,87700
"TR","1981-12-10",1981,12,344,20000,46600,27100,93700
"TR","1981-12-11",1981,12,345,0,46500,27100,73600
"TR","1981-12-12",1981,12,346,0,46500,27100,73600
"TR","1981-12-13",1981,12,347,0,46400,27000,73400
"TR","1981-12-14",1981,12,348,1210,46300,27000,74510
"TR","1981-12-15",1981,12,349,92400,46800,26600,165800
"TR","1981-12-16",1981,12,350,0,46700,26500,73200
"TR","1981-12-17",1981,12,351,0,46600,26600,73200
"TR","1981-12-18",1981,12,352,3370,46500,26600,76470
"TR","1981-12-19",1981,12,353,1120,46400,26600,74120
"TR","1981-12-20",1981,12,354,0,46300,26600,72900
"TR","1981-12-21",1981,12,355,0,46200,26600,72800
"TR","1981-12-22",1981,12,356,27300,46300,26500,100100
"TR","1981-12-23",1981,12,357,0,46200,26500,72700
"TR","1981-12-24",1981,12,358,6740,46100,26500,79340
"TR","1981-12-25",1981,12,359,4850,46000,26500,77350
"TR","1981-12-26",1981,12,360,0,45900,26500,72400
"TR","1981-12-27",1981,12,361,9340,45900,26400,81640
"TR","1981-12-28",1981,12,362,43400,46100,26200,115700
"TR","1981-12-29",1981,12,363,0,46000,26200,72200
"TR","1981-12-30",1981,12,364,0,45900,26200,72100
"TR","1981-12-31",1981,12,365,6740,45800,26200,78740
"TR","1982-01-01",1982,1,1,75500,46300,25900,147700
"TR","1982-01-02",1982,1,2,52700,46600,25600,124900
"TR","1982-01-03",1982,1,3,11300,46500,25600,83400
"TR","1982-01-04",1982,1,4,123000,47300,25300,195600
"TR","1982-01-05",1982,1,5,0,47100,25200,72300
"TR","1982-01-06",1982,1,6,0,46900,25400,72300
"TR","1982-01-07",1982,1,7,0,46800,25500,72300
"TR","1982-01-08",1982,1,8,0,46600,25600,72200
"TR","1982-01-09",1982,1,9,3750,46400,25600,75750
"TR","1982-01-10",1982,1,10,0,46200,25600,71800
"TR","1982-01-11",1982,1,11,11300,46100,25600,83000
"TR","1982-01-12",1982,1,12,0,45900,25600,71500
"TR","1982-01-13",1982,1,13,0,45800,25700,71500
"TR","1982-01-14",1982,1,14,0,45600,25700,71300
"TR","1982-01-15",1982,1,15,0,45500,25700,71200
"TR","1982-01-16",1982,1,16,15000,45400,25600,86000
"TR","1982-01-17",1982,1,17,51300,45700,25400,122400
"TR","1982-01-18",1982,1,18,0,45500,25400,70900
"TR","1982-01-19",1982,1,19,0,45400,25500,70900
"TR","1982-01-20",1982,1,20,0,45200,25500,70700
"TR","1982-01-21",1982,1,21,1880,45100,25500,72480
"TR","1982-01-22",1982,1,22,6070,45000,25500,76570
"TR","1982-01-23",1982,1,23,51000,45100,25300,121400
"TR","1982-01-24",1982,1,24,360000,47400,24000,431400
"TR","1982-01-25",1982,1,25,28000,47500,23700,99200
"TR","1982-01-26",1982,1,26,0,47200,24000,71200
"TR","1982-01-27",1982,1,27,0,47000,24200,71200
"TR","1982-01-28",1982,1,28,0,46700,24400,71100
"TR","1982-01-29",1982,1,29,0,46400,24600,71000
"TR","1982-01-30",1982,1,30,57700,46500,24400,128600
"TR","1982-01-31",1982,1,31,49600,46700,24300,120600
"TR","1982-02-01",1982,2,32,0,46400,24400,70800
"TR","1982-02-02",1982,2,33,0,46200,24500,70700
"TR","1982-02-03",1982,2,34,37700,46200,24500,108400
"TR","1982-02-04",1982,2,35,0,46000,24500,70500
"TR","1982-02-05",1982,2,36,0,45800,24600,70400
"TR","1982-02-06",1982,2,37,0,45500,24700,70200
"TR","1982-02-07",1982,2,38,0,45300,24800,70100
"TR","1982-02-08",1982,2,39,4770,45200,24800,74770
"TR","1982-02-09",1982,2,40,0,45000,24800,69800
"TR","1982-02-10",1982,2,41,0,44800,24900,69700
"TR","1982-02-11",1982,2,42,0,44600,24900,69500
"TR","1982-02-12",1982,2,43,0,44400,24900,69300
"TR","1982-02-13",1982,2,44,0,44300,24900,69200
"TR","1982-02-14",1982,2,45,2250,44100,24900,71250
"TR","1982-02-15",1982,2,46,4860,44000,24900,73760
"TR","1982-02-16",1982,2,47,1220,43800,25000,70020
"TR","1982-02-17",1982,2,48,0,43700,25000,68700
"TR","1982-02-18",1982,2,49,0,43500,25000,68500
"TR","1982-02-19",1982,2,50,0,43400,25000,68400
"TR","1982-02-20",1982,2,51,0,43200,25000,68200
"TR","1982-02-21",1982,2,52,0,43000,25100,68100
"TR","1982-02-22",1982,2,53,0,42900,25100,68000
"TR","1982-02-23",1982,2,54,0,42700,25100,67800
"TR","1982-02-24",1982,2,55,0,42600,25100,67700
"TR","1982-02-25",1982,2,56,10700,42600,25000,78300
"TR","1982-02-26",1982,2,57,13200,42600,25000,80800
"TR","1982-02-27",1982,2,58,0,42500,24900,67400
"TR","1982-02-28",1982,2,59,0,42400,25000,67400
"TR","1982-03-01",1982,3,60,0,42200,25000,67200
"TR","1982-03-02",1982,3,61,6700,42100,25000,73800
"TR","1982-03-03",1982,3,62,0,42000,25000,67000
"TR","1982-03-04",1982,3,63,0,41900,25000,66900
"TR","1982-03-05",1982,3,64,0,41800,25000,66800
"TR","1982-03-06",1982,3,65,0,41700,25000,66700
"TR","1982-03-07",1982,3,66,0,41600,25000,66600
"TR","1982-03-08",1982,3,67,0,41500,25000,66500
"TR","1982-03-09",1982,3,68,6210,41400,24900,72510
"TR","1982-03-10",1982,3,69,40800,41700,24700,107200
"TR","1982-03-11",1982,3,70,8930,41600,24700,75230
"TR","1982-03-12",1982,3,71,0,41400,24800,66200
"TR","1982-03-13",1982,3,72,4140,41200,24800,70140
"TR","1982-03-14",1982,3,73,160000,42300,24200,226500
"TR","1982-03-15",1982,3,74,0,42100,24100,66200
"TR","1982-03-16",1982,3,75,0,41900,24300,66200
"TR","1982-03-17",1982,3,76,58500,42200,24200,124900
"TR","1982-03-18",1982,3,77,96000,42800,23800,162600
"TR","1982-03-19",1982,3,78,0,42600,23900,66500
"TR","1982-03-20",1982,3,79,0,42300,24100,66400
"TR","1982-03-21",1982,3,80,12400,42100,24200,78700
"TR","1982-03-22",1982,3,81,56500,42300,24100,122900
"TR","1982-03-23",1982,3,82,15600,42100,24100,81800
"TR","1982-03-24",1982,3,83,0,41800,24200,66000
"TR","1982-03-25",1982,3,84,0,41900,24400,66300
"TR","1982-03-26",1982,3,85,0,41600,24500,66100
"TR","1982-03-27",1982,3,86,21300,41300,24400,87000
"TR","1982-03-28",1982,3,87,0,41100,24400,65500
"TR","1982-03-29",1982,3,88,0,40900,24400,65300
"TR","1982-03-30",1982,3,89,0,40600,24500,65100
"TR","1982-03-31",1982,3,90,34100,43600,24900,102600
"TR","1982-04-01",1982,4,91,89400,52400,41200,183000
"TR","1982-04-02",1982,4,92,0,46900,29000,75900
"TR","1982-04-03",1982,4,93,73700,48000,30700,152400
"TR","1982-04-04",1982,4,94,477000,52100,27500,556600
"TR","1982-04-05",1982,4,95,193000,54600,22100,269700
"TR","1982-04-06",1982,4,96,0,51900,22300,74200
"TR","1982-04-07",1982,4,97,0,49800,22600,72400
"TR","1982-04-08",1982,4,98,0,48400,22900,71300
"TR","1982-04-09",1982,4,99,0,47800,23200,71000
"TR","1982-04-10",1982,4,100,0,47300,23400,70700
"TR","1982-04-11",1982,4,101,22900,46900,23500,93300
"TR","1982-04-12",1982,4,102,29400,47800,23600,100800
"TR","1982-04-13",1982,4,103,74400,51600,28100,154100
"TR","1982-04-14",1982,4,104,172000,64700,50900,287600
"TR","1982-04-15",1982,4,105,0,59200,30100,89300
"TR","1982-04-16",1982,4,106,64100,92100,142000,298200
"TR","1982-04-17",1982,4,107,547000,147000,412000,1106000
"TR","1982-04-18",1982,4,108,290000,206000,115000,611000
"TR","1982-04-19",1982,4,109,0,124000,33100,157100
"TR","1982-04-20",1982,4,110,270000,137000,43000,450000
"TR","1982-04-21",1982,4,111,144000,122000,30600,296600
"TR","1982-04-22",1982,4,112,0,114000,24500,138500
"TR","1982-04-23",1982,4,113,0,109000,28300,137300
"TR","1982-04-24",1982,4,114,0,104000,25700,129700
"TR","1982-04-25",1982,4,115,0,99600,26100,125700
"TR","1982-04-26",1982,4,116,3040,96200,26400,125640
"TR","1982-04-27",1982,4,117,55500,94600,27000,177100
"TR","1982-04-28",1982,4,118,0,91300,26900,118200
"TR","1982-04-29",1982,4,119,0,88900,27300,116200
"TR","1982-04-30",1982,4,120,0,85400,27500,112900
"TR","1982-05-01",1982,5,121,0,81900,27600,109500
"TR","1982-05-02",1982,5,122,0,77900,27900,105800
"TR","1982-05-03",1982,5,123,0,71300,28000,99300
"TR","1982-05-04",1982,5,124,0,66000,28500,94500
"TR","1982-05-05",1982,5,125,26600,62800,29000,118400
"TR","1982-05-06",1982,5,126,286000,73700,37200,396900
"TR","1982-05-07",1982,5,127,355000,88000,48800,491800
"TR","1982-05-08",1982,5,128,341000,97900,54200,493100
"TR","1982-05-09",1982,5,129,0,85900,28900,114800
"TR","1982-05-10",1982,5,130,57700,82700,28400,168800
"TR","1982-05-11",1982,5,131,183000,87300,36600,306900
"TR","1982-05-12",1982,5,132,4780,76900,28700,110380
"TR","1982-05-13",1982,5,133,0,70800,28900,99700
"TR","1982-05-14",1982,5,134,329000,87700,42000,458700
"TR","1982-05-15",1982,5,135,33500,77000,30700,141200
"TR","1982-05-16",1982,5,136,0,70500,29200,99700
"TR","1982-05-17",1982,5,137,54600,68000,29700,152300
"TR","1982-05-18",1982,5,138,47900,65500,29800,143200
"TR","1982-05-19",1982,5,139,150000,70200,31400,251600
"TR","1982-05-20",1982,5,140,6650,64900,30100,101650
"TR","1982-05-21",1982,5,141,13800,61700,30200,105700
"TR","1982-05-22",1982,5,142,0,58500,29900,88400
"TR","1982-05-23",1982,5,143,0,56500,30100,86600
"TR","1982-05-24",1982,5,144,0,54500,30100,84600
"TR","1982-05-25",1982,5,145,0,52600,30200,82800
"TR","1982-05-26",1982,5,146,0,51500,30100,81600
"TR","1982-05-27",1982,5,147,0,50900,30100,81000
"TR","1982-05-28",1982,5,148,0,50300,30100,80400
"TR","1982-05-29",1982,5,149,0,49700,30200,79900
"TR","1982-05-30",1982,5,150,54600,50300,30300,135200
"TR","1982-05-31",1982,5,151,0,49500,30100,79600
"TR","1982-06-01",1982,6,152,362000,60700,31300,454000
"TR","1982-06-02",1982,6,153,9540,55200,29900,94640
"TR","1982-06-03",1982,6,154,0,52800,30200,83000
"TR","1982-06-04",1982,6,155,0,51400,30500,81900
"TR","1982-06-05",1982,6,156,0,50700,30700,81400
"TR","1982-06-06",1982,6,157,0,50000,30800,80800
"TR","1982-06-07",1982,6,158,0,49300,30800,80100
"TR","1982-06-08",1982,6,159,33500,49400,30800,113700
"TR","1982-06-09",1982,6,160,0,48600,30700,79300
"TR","1982-06-10",1982,6,161,15500,48300,30800,94600
"TR","1982-06-11",1982,6,162,193000,52200,31500,276700
"TR","1982-06-12",1982,6,163,0,50500,30600,81100
"TR","1982-06-13",1982,6,164,0,49700,30800,80500
"TR","1982-06-14",1982,6,165,0,48800,30800,79600
"TR","1982-06-15",1982,6,166,170000,51800,31200,253000
"TR","1982-06-16",1982,6,167,90600,51800,31200,173600
"TR","1982-06-17",1982,6,168,0,50200,30600,80800
"TR","1982-06-18",1982,6,169,42600,50200,31000,123800
"TR","1982-06-19",1982,6,170,0,49200,30700,79900
"TR","1982-06-20",1982,6,171,0,48600,30800,79400
"TR","1982-06-21",1982,6,172,177000,51800,31400,260200
"TR","1982-06-22",1982,6,173,25300,50700,30700,106700
"TR","1982-06-23",1982,6,174,47700,50500,31000,129200
"TR","1982-06-24",1982,6,175,0,49400,30600,80000
"TR","1982-06-25",1982,6,176,0,48600,30700,79300
"TR","1982-06-26",1982,6,177,116000,50300,31300,197600
"TR","1982-06-27",1982,6,178,0,49000,30600,79600
"TR","1982-06-28",1982,6,179,0,48400,30600,79000
"TR","1982-06-29",1982,6,180,0,47600,30600,78200
"TR","1982-06-30",1982,6,181,251000,53100,31400,335500
"TR","1982-07-01",1982,7,182,0,49800,30100,79900
"TR","1982-07-02",1982,7,183,0,48600,30100,78700
"TR","1982-07-03",1982,7,184,0,47400,30000,77400
"TR","1982-07-04",1982,7,185,65900,47600,29900,143400
"TR","1982-07-05",1982,7,186,122000,48900,30100,201000
"TR","1982-07-06",1982,7,187,87300,49200,29700,166200
"TR","1982-07-07",1982,7,188,0,47100,29200,76300
"TR","1982-07-08",1982,7,189,137000,48500,29600,215100
"TR","1982-07-09",1982,7,190,0,46600,28900,75500
"TR","1982-07-10",1982,7,191,170000,49300,29300,248600
"TR","1982-07-11",1982,7,192,357000,59500,30800,447300
"TR","1982-07-12",1982,7,193,311000,68300,30300,409600
"TR","1982-07-13",1982,7,194,31100,60700,27400,119200
"TR","1982-07-14",1982,7,195,1510,55400,27500,84410
"TR","1982-07-15",1982,7,196,187000,58700,28700,274400
"TR","1982-07-16",1982,7,197,49100,55300,27800,132200
"TR","1982-07-17",1982,7,198,307000,68900,35100,411000
"TR","1982-07-18",1982,7,199,189000,70100,37000,296100
"TR","1982-07-19",1982,7,200,53100,64400,27100,144600
"TR","1982-07-20",1982,7,201,0,58000,27000,85000
"TR","1982-07-21",1982,7,202,0,53600,27000,80600
"TR","1982-07-22",1982,7,203,50500,51700,27100,129300
"TR","1982-07-23",1982,7,204,27000,49800,27200,104000
"TR","1982-07-24",1982,7,205,0,48400,27100,75500
"TR","1982-07-25",1982,7,206,15400,47600,27200,90200
"TR","1982-07-26",1982,7,207,3020,46600,27200,76820
"TR","1982-07-27",1982,7,208,21500,46000,27300,94800
"TR","1982-07-28",1982,7,209,49900,45900,27400,123200
"TR","1982-07-29",1982,7,210,0,44800,27200,72000
"TR","1982-07-30",1982,7,211,53300,45100,27300,125700
"TR","1982-07-31",1982,7,212,266000,49600,28300,343900
"TR","1982-08-01",1982,8,213,0,47300,27200,74500
"TR","1982-08-02",1982,8,214,0,46100,27600,73700
"TR","1982-08-03",1982,8,215,30300,45400,28000,103700
"TR","1982-08-04",1982,8,216,0,44500,28100,72600
"TR","1982-08-05",1982,8,217,13600,43800,28300,85700
"TR","1982-08-06",1982,8,218,0,42900,28300,71200
"TR","1982-08-07",1982,8,219,0,42200,28500,70700
"TR","1982-08-08",1982,8,220,19000,41700,28500,89200
"TR","1982-08-09",1982,8,221,0,40900,28500,69400
"TR","1982-08-10",1982,8,222,18600,40800,28500,87900
"TR","1982-08-11",1982,8,223,4550,40500,28500,73550
"TR","1982-08-12",1982,8,224,0,40100,28500,68600
"TR","1982-08-13",1982,8,225,0,39600,28700,68300
"TR","1982-08-14",1982,8,226,0,39000,28700,67700
"TR","1982-08-15",1982,8,227,0,38500,28700,67200
"TR","1982-08-16",1982,8,228,0,38000,28800,66800
"TR","1982-08-17",1982,8,229,0,37400,28900,66300
"TR","1982-08-18",1982,8,230,0,36700,29100,65800
"TR","1982-08-19",1982,8,231,0,36000,29200,65200
"TR","1982-08-20",1982,8,232,29600,36100,29100,94800
"TR","1982-08-21",1982,8,233,2270,35600,29000,66870
"TR","1982-08-22",1982,8,234,0,35300,29000,64300
"TR","1982-08-23",1982,8,235,0,35100,29000,64100
"TR","1982-08-24",1982,8,236,193000,38300,29000,260300
"TR","1982-08-25",1982,8,237,17700,37800,28300,83800
"TR","1982-08-26",1982,8,238,103000,39500,28600,171100
"TR","1982-08-27",1982,8,239,315000,46000,28900,389900
"TR","1982-08-28",1982,8,240,459000,57000,38400,554400
"TR","1982-08-29",1982,8,241,0,49700,26100,75800
"TR","1982-08-30",1982,8,242,186000,56900,28800,271700
"TR","1982-08-31",1982,8,243,86500,56600,33200,176300
"TR","1982-09-01",1982,9,244,10500,53000,26800,90300
"TR","1982-09-02",1982,9,245,39400,51600,27300,118300
"TR","1982-09-03",1982,9,246,88400,53000,27900,169300
"TR","1982-09-04",1982,9,247,0,49600,27500,77100
"TR","1982-09-05",1982,9,248,0,48100,27700,75800
"TR","1982-09-06",1982,9,249,375000,63700,32500,471200
"TR","1982-09-07",1982,9,250,189000,65900,45700,300600
"TR","1982-09-08",1982,9,251,0,59800,26500,86300
"TR","1982-09-09",1982,9,252,0,55700,27000,82700
"TR","1982-09-10",1982,9,253,0,52100,27200,79300
"TR","1982-09-11",1982,9,254,23800,49600,27400,100800
"TR","1982-09-12",1982,9,255,54700,49300,27800,131800
"TR","1982-09-13",1982,9,256,0,47800,27600,75400
"TR","1982-09-14",1982,9,257,221000,54000,28800,303800
"TR","1982-09-15",1982,9,258,75400,53500,28600,157500
"TR","1982-09-16",1982,9,259,131000,58000,33500,222500
"TR","1982-09-17",1982,9,260,26400,54700,28100,109200
"TR","1982-09-18",1982,9,261,98600,57200,31600,187400
"TR","1982-09-19",1982,9,262,69700,57300,31300,158300
"TR","1982-09-20",1982,9,263,21100,54000,27400,102500
"TR","1982-09-21",1982,9,264,75200,55100,29000,159300
"TR","1982-09-22",1982,9,265,22100,53000,27500,102600
"TR","1982-09-23",1982,9,266,0,50600,27500,78100
"TR","1982-09-24",1982,9,267,26400,49600,27600,103600
"TR","1982-09-25",1982,9,268,181000,60200,33900,275100
"TR","1982-09-26",1982,9,269,8330,56000,28100,92430
"TR","1982-09-27",1982,9,270,0,52600,27200,79800
"TR","1982-09-28",1982,9,271,0,50300,27400,77700
"TR","1982-09-29",1982,9,272,0,48800,27500,76300
"TR","1982-09-30",1982,9,273,94400,50900,27500,172800
"TR","1982-10-01",1982,10,274,92800,55800,31900,180500
"TR","1982-10-02",1982,10,275,0,52500,27700,80200
"TR","1982-10-03",1982,10,276,37500,51400,27600,116500
"TR","1982-10-04",1982,10,277,135000,59300,30500,224800
"TR","1982-10-05",1982,10,278,0,55700,27400,83100
"TR","1982-10-06",1982,10,279,0,52700,27500,80200
"TR","1982-10-07",1982,10,280,191000,62700,34300,288000
"TR","1982-10-08",1982,10,281,241000,76000,43700,360700
"TR","1982-10-09",1982,10,282,5210,66400,28400,100010
"TR","1982-10-10",1982,10,283,91700,66400,28900,187000
"TR","1982-10-11",1982,10,284,182000,77200,41200,300400
"TR","1982-10-12",1982,10,285,18500,69400,28200,116100
"TR","1982-10-13",1982,10,286,17800,65000,26700,109500
"TR","1982-10-14",1982,10,287,24100,62000,27100,113200
"TR","1982-10-15",1982,10,288,10600,59300,27300,97200
"TR","1982-10-16",1982,10,289,35400,57900,27600,120900
"TR","1982-10-17",1982,10,290,0,55300,27500,82800
"TR","1982-10-18",1982,10,291,43000,55500,27900,126400
"TR","1982-10-19",1982,10,292,27900,54900,28100,110900
"TR","1982-10-20",1982,10,293,56700,55000,28400,140100
"TR","1982-10-21",1982,10,294,670000,88400,66100,824500
"TR","1982-10-22",1982,10,295,92000,82400,29400,203800
"TR","1982-10-23",1982,10,296,0,77900,26100,104000
"TR","1982-10-24",1982,10,297,0,73800,28800,102600
"TR","1982-10-25",1982,10,298,0,72900,31500,104400
"TR","1982-10-26",1982,10,299,0,69600,27700,97300
"TR","1982-10-27",1982,10,300,0,67100,28200,95300
"TR","1982-10-28",1982,10,301,0,62300,28300,90600
"TR","1982-10-29",1982,10,302,5210,59600,28500,93310
"TR","1982-10-30",1982,10,303,84400,61900,29000,175300
"TR","1982-10-31",1982,10,304,8680,59900,29000,97580
"TR","1982-11-01",1982,11,305,0,57900,29000,86900
"TR","1982-11-02",1982,11,306,13000,56700,29300,99000
"TR","1982-11-03",1982,11,307,15700,55400,29200,100300
"TR","1982-11-04",1982,11,308,28400,55100,29200,112700
"TR","1982-11-05",1982,11,309,150000,57900,28300,236200
"TR","1982-11-06",1982,11,310,84800,58900,27900,171600
"TR","1982-11-07",1982,11,311,0,57400,28200,85600
"TR","1982-11-08",1982,11,312,0,56100,28700,84800
"TR","1982-11-09",1982,11,313,0,56400,29800,86200
"TR","1982-11-10",1982,11,314,0,55600,30100,85700
"TR","1982-11-11",1982,11,315,71900,57200,29800,158900
"TR","1982-11-12",1982,11,316,28300,58900,29900,117100
"TR","1982-11-13",1982,11,317,499000,151000,28200,678200
"TR","1982-11-14",1982,11,318,8640,81200,27100,116940
"TR","1982-11-15",1982,11,319,70900,78200,27300,176400
"TR","1982-11-16",1982,11,320,0,73200,27600,100800
"TR","1982-11-17",1982,11,321,0,69300,28000,97300
"TR","1982-11-18",1982,11,322,0,66100,28400,94500
"TR","1982-11-19",1982,11,323,0,63500,28700,92200
"TR","1982-11-20",1982,11,324,20500,67500,31900,119900
"TR","1982-11-21",1982,11,325,78900,90600,88100,257600
"TR","1982-11-22",1982,11,326,66900,80500,47200,194600
"TR","1982-11-23",1982,11,327,8220,74000,30100,112320
"TR","1982-11-24",1982,11,328,42500,70200,30300,143000
"TR","1982-11-25",1982,11,329,0,66800,29500,96300
"TR","1982-11-26",1982,11,330,0,64600,29800,94400
"TR","1982-11-27",1982,11,331,0,62800,30100,92900
"TR","1982-11-28",1982,11,332,0,61500,30300,91800
"TR","1982-11-29",1982,11,333,0,60300,30400,90700
"TR","1982-11-30",1982,11,334,0,59200,30600,89800
"TR","1982-12-01",1982,12,335,0,58000,30600,88600
"TR","1982-12-02",1982,12,336,8600,57500,30500,96600
"TR","1982-12-03",1982,12,337,29200,58200,30800,118200
"TR","1982-12-04",1982,12,338,17700,58300,30800,106800
"TR","1982-12-05",1982,12,339,0,57400,30700,88100
"TR","1982-12-06",1982,12,340,3370,56900,30800,91070
"TR","1982-12-07",1982,12,341,86000,58600,30500,175100
"TR","1982-12-08",1982,12,342,0,57900,30500,88400
"TR","1982-12-09",1982,12,343,0,57300,30600,87900
"TR","1982-12-10",1982,12,344,0,56800,30700,87500
"TR","1982-12-11",1982,12,345,56200,57400,30600,144200
"TR","1982-12-12",1982,12,346,0,56900,30600,87500
"TR","1982-12-13",1982,12,347,0,56400,30700,87100
"TR","1982-12-14",1982,12,348,0,56000,30800,86800
"TR","1982-12-15",1982,12,349,2250,55700,30800,88750
"TR","1982-12-16",1982,12,350,0,55300,30900,86200
"TR","1982-12-17",1982,12,351,0,55100,30900,86000
"TR","1982-12-18",1982,12,352,0,54800,31000,85800
"TR","1982-12-19",1982,12,353,67800,56000,30700,154500
"TR","1982-12-20",1982,12,354,94300,57800,30200,182300
"TR","1982-12-21",1982,12,355,4400,57100,30200,91700
"TR","1982-12-22",1982,12,356,0,56300,30400,86700
"TR","1982-12-23",1982,12,357,0,55700,30500,86200
"TR","1982-12-24",1982,12,358,0,55200,30600,85800
"TR","1982-12-25",1982,12,359,89500,58100,31100,178700
"TR","1982-12-26",1982,12,360,320000,77500,51700,449200
"TR","1982-12-27",1982,12,361,14500,70400,29900,114800
"TR","1982-12-28",1982,12,362,0,66800,29500,96300
"TR","1982-12-29",1982,12,363,178000,68900,29100,276000
"TR","1982-12-30",1982,12,364,3640,66300,29100,99040
"TR","1982-12-31",1982,12,365,0,64100,29400,93500
"TR","1983-01-01",1983,1,1,5800,62400,29600,97800
"TR","1983-01-02",1983,1,2,0,60800,29800,90600
"TR","1983-01-03",1983,1,3,0,59600,30000,89600
"TR","1983-01-04",1983,1,4,0,58700,30100,88800
"TR","1983-01-05",1983,1,5,0,57800,30200,88000
"TR","1983-01-06",1983,1,6,0,57000,30300,87300
"TR","1983-01-07",1983,1,7,80700,57900,30000,168600
"TR","1983-01-08",1983,1,8,180000,62200,29300,271500
"TR","1983-01-09",1983,1,9,0,60500,29200,89700
"TR","1983-01-10",1983,1,10,0,59100,29500,88600
"TR","1983-01-11",1983,1,11,116000,60400,29200,205600
"TR","1983-01-12",1983,1,12,69300,60900,29000,159200
"TR","1983-01-13",1983,1,13,0,59400,29200,88600
"TR","1983-01-14",1983,1,14,0,58100,29400,87500
"TR","1983-01-15",1983,1,15,110000,59800,29100,198900
"TR","1983-01-16",1983,1,16,29900,59100,29100,118100
"TR","1983-01-17",1983,1,17,0,57900,29300,87200
"TR","1983-01-18",1983,1,18,0,57000,29400,86400
"TR","1983-01-19",1983,1,19,0,56200,29600,85800
"TR","1983-01-20",1983,1,20,0,55500,29700,85200
"TR","1983-01-21",1983,1,21,0,55000,29700,84700
"TR","1983-01-22",1983,1,22,0,54500,29800,84300
"TR","1983-01-23",1983,1,23,0,54000,29900,83900
"TR","1983-01-24",1983,1,24,0,53600,29900,83500
"TR","1983-01-25",1983,1,25,2020,53300,30000,85320
"TR","1983-01-26",1983,1,26,0,53000,30000,83000
"TR","1983-01-27",1983,1,27,0,52900,30000,82900
"TR","1983-01-28",1983,1,28,0,52800,30000,82800
"TR","1983-01-29",1983,1,29,0,52600,30000,82600
"TR","1983-01-30",1983,1,30,46200,53700,29800,129700
"TR","1983-01-31",1983,1,31,162000,57200,29100,248300
"TR","1983-02-01",1983,2,32,8710,56200,29000,93910
"TR","1983-02-02",1983,2,33,0,55200,29200,84400
"TR","1983-02-03",1983,2,34,18000,54700,29300,102000
"TR","1983-02-04",1983,2,35,111000,56800,28900,196700
"TR","1983-02-05",1983,2,36,0,55700,28900,84600
"TR","1983-02-06",1983,2,37,0,54800,29000,83800
"TR","1983-02-07",1983,2,38,0,54000,29200,83200
"TR","1983-02-08",1983,2,39,0,53400,29300,82700
"TR","1983-02-09",1983,2,40,0,52900,29300,82200
"TR","1983-02-10",1983,2,41,0,52500,29400,81900
"TR","1983-02-11",1983,2,42,0,52100,29400,81500
"TR","1983-02-12",1983,2,43,2430,51800,29400,83630
"TR","1983-02-13",1983,2,44,0,51500,29400,80900
"TR","1983-02-14",1983,2,45,0,51400,29500,80900
"TR","1983-02-15",1983,2,46,0,51200,29500,80700
"TR","1983-02-16",1983,2,47,0,51100,29500,80600
"TR","1983-02-17",1983,2,48,0,50900,29500,80400
"TR","1983-02-18",1983,2,49,0,50800,29500,80300
"TR","1983-02-19",1983,2,50,0,50700,29500,80200
"TR","1983-02-20",1983,2,51,4860,50600,29500,84960
"TR","1983-02-21",1983,2,52,0,50500,29500,80000
"TR","1983-02-22",1983,2,53,0,50300,29500,79800
"TR","1983-02-23",1983,2,54,0,50200,29500,79700
"TR","1983-02-24",1983,2,55,0,50100,29400,79500
"TR","1983-02-25",1983,2,56,1220,50000,29400,80620
"TR","1983-02-26",1983,2,57,4680,49900,29400,83980
"TR","1983-02-27",1983,2,58,0,49800,29300,79100
"TR","1983-02-28",1983,2,59,0,49700,29300,79000
"TR","1983-03-01",1983,3,60,23500,49700,29200,102400
"TR","1983-03-02",1983,3,61,50300,50000,29000,129300
"TR","1983-03-03",1983,3,62,28900,54300,37700,120900
"TR","1983-03-04",1983,3,63,67000,60700,41800,169500
"TR","1983-03-05",1983,3,64,55800,69500,50000,175300
"TR","1983-03-06",1983,3,65,6970,76900,54800,138670
"TR","1983-03-07",1983,3,66,10900,81900,54700,147500
"TR","1983-03-08",1983,3,67,22300,88300,57900,168500
"TR","1983-03-09",1983,3,68,3820,74600,30600,109020
"TR","1983-03-10",1983,3,69,193000,74400,29600,297000
"TR","1983-03-11",1983,3,70,28400,70800,29900,129100
"TR","1983-03-12",1983,3,71,0,67700,30500,98200
"TR","1983-03-13",1983,3,72,0,65100,31000,96100
"TR","1983-03-14",1983,3,73,0,63000,31500,94500
"TR","1983-03-15",1983,3,74,0,62300,32300,94600
"TR","1983-03-16",1983,3,75,0,60100,32300,92400
"TR","1983-03-17",1983,3,76,79400,61000,32000,172400
"TR","1983-03-18",1983,3,77,16600,61400,34800,112800
"TR","1983-03-19",1983,3,78,172000,65400,33400,270800
"TR","1983-03-20",1983,3,79,59600,64700,31300,155600
"TR","1983-03-21",1983,3,80,0,62400,31400,93800
"TR","1983-03-22",1983,3,81,0,60700,31700,92400
"TR","1983-03-23",1983,3,82,0,59400,31900,91300
"TR","1983-03-24",1983,3,83,0,58400,32000,90400
"TR","1983-03-25",1983,3,84,0,57600,32100,89700
"TR","1983-03-26",1983,3,85,0,56700,32200,88900
"TR","1983-03-27",1983,3,86,0,56000,32400,88400
"TR","1983-03-28",1983,3,87,44500,58200,32700,135400
"TR","1983-03-29",1983,3,88,0,55900,32400,88300
"TR","1983-03-30",1983,3,89,0,54700,32400,87100
"TR","1983-03-31",1983,3,90,37300,56000,33300,126600
"TR","1983-04-01",1983,4,91,29000,56900,36500,122400
"TR","1983-04-02",1983,4,92,66400,63300,48300,178000
"TR","1983-04-03",1983,4,93,0,60200,37600,97800
"TR","1983-04-04",1983,4,94,0,59600,33100,92700
"TR","1983-04-05",1983,4,95,9640,58300,31700,99640
"TR","1983-04-06",1983,4,96,0,57000,31600,88600
"TR","1983-04-07",1983,4,97,54900,58200,32000,145100
"TR","1983-04-08",1983,4,98,26500,58000,33200,117700
"TR","1983-04-09",1983,4,99,4820,56300,31600,92720
"TR","1983-04-10",1983,4,100,0,55000,31500,86500
"TR","1983-04-11",1983,4,101,199000,62000,32800,293800
"TR","1983-04-12",1983,4,102,16900,63900,40000,120800
"TR","1983-04-13",1983,4,103,0,59600,31300,90900
"TR","1983-04-14",1983,4,104,103000,64100,37200,204300
"TR","1983-04-15",1983,4,105,105000,67200,36700,208900
"TR","1983-04-16",1983,4,106,206000,67500,30300,303800
"TR","1983-04-17",1983,4,107,0,64600,30500,95100
"TR","1983-04-18",1983,4,108,0,62500,30800,93300
"TR","1983-04-19",1983,4,109,0,60800,31100,91900
"TR","1983-04-20",1983,4,110,0,59400,31400,90800
"TR","1983-04-21",1983,4,111,0,60700,34000,94700
"TR","1983-04-22",1983,4,112,0,61600,41100,102700
"TR","1983-04-23",1983,4,113,0,58000,32700,90700
"TR","1983-04-24",1983,4,114,0,56000,31300,87300
"TR","1983-04-25",1983,4,115,0,54700,31200,85900
"TR","1983-04-26",1983,4,116,0,53800,31100,84900
"TR","1983-04-27",1983,4,117,0,52900,30900,83800
"TR","1983-04-28",1983,4,118,0,52400,30800,83200
"TR","1983-04-29",1983,4,119,0,52100,30600,82700
"TR","1983-04-30",1983,4,120,57500,53100,30800,141400
"TR","1983-05-01",1983,5,121,0,52000,30400,82400
"TR","1983-05-02",1983,5,122,0,51400,30500,81900
"TR","1983-05-03",1983,5,123,231000,63500,33800,328300
"TR","1983-05-04",1983,5,124,19300,58600,30800,108700
"TR","1983-05-05",1983,5,125,1490,55900,30700,88090
"TR","1983-05-06",1983,5,126,0,54300,30600,84900
"TR","1983-05-07",1983,5,127,0,52800,30900,83700
"TR","1983-05-08",1983,5,128,695000,104000,69000,868000
"TR","1983-05-09",1983,5,129,211000,92500,42100,345600
"TR","1983-05-10",1983,5,130,0,84800,31000,115800
"TR","1983-05-11",1983,5,131,0,76800,29700,106500
"TR","1983-05-12",1983,5,132,0,70100,29700,99800
"TR","1983-05-13",1983,5,133,0,64800,29700,94500
"TR","1983-05-14",1983,5,134,270000,73400,32000,375400
"TR","1983-05-15",1983,5,135,23300,68200,30400,121900
"TR","1983-05-16",1983,5,136,0,64300,30300,94600
"TR","1983-05-17",1983,5,137,0,61700,30600,92300
"TR","1983-05-18",1983,5,138,0,59300,30600,89900
"TR","1983-05-19",1983,5,139,0,56900,30800,87700
"TR","1983-05-20",1983,5,140,27900,55800,30700,114400
"TR","1983-05-21",1983,5,141,12900,54600,30600,98100
"TR","1983-05-22",1983,5,142,103000,57600,31400,192000
"TR","1983-05-23",1983,5,143,133000,62000,31900,226900
"TR","1983-05-24",1983,5,144,385000,84200,48800,518000
"TR","1983-05-25",1983,5,145,25700,72000,30600,128300
"TR","1983-05-26",1983,5,146,21700,67100,30600,119400
"TR","1983-05-27",1983,5,147,0,62700,30200,92900
"TR","1983-05-28",1983,5,148,0,60000,30600,90600
"TR","1983-05-29",1983,5,149,0,57400,30500,87900
"TR","1983-05-30",1983,5,150,347000,75500,39700,462200
"TR","1983-05-31",1983,5,151,171000,78600,40400,290000
"TR","1983-06-01",1983,6,152,87000,75600,35500,198100
"TR","1983-06-02",1983,6,153,0,69300,30500,99800
"TR","1983-06-03",1983,6,154,44500,67300,31300,143100
"TR","1983-06-04",1983,6,155,206000,73800,37300,317100
"TR","1983-06-05",1983,6,156,266000,89200,47100,402300
"TR","1983-06-06",1983,6,157,16700,77500,30800,125000
"TR","1983-06-07",1983,6,158,0,71700,30900,102600
"TR","1983-06-08",1983,6,159,0,67400,31200,98600
"TR","1983-06-09",1983,6,160,0,63500,31300,94800
"TR","1983-06-10",1983,6,161,21100,61100,31400,113600
"TR","1983-06-11",1983,6,162,0,57800,31600,89400
"TR","1983-06-12",1983,6,163,0,55200,31500,86700
"TR","1983-06-13",1983,6,164,48600,54600,31700,134900
"TR","1983-06-14",1983,6,165,0,52500,31500,84000
"TR","1983-06-15",1983,6,166,15500,52000,31700,99200
"TR","1983-06-16",1983,6,167,171000,55600,32100,258700
"TR","1983-06-17",1983,6,168,135000,59500,32400,226900
"TR","1983-06-18",1983,6,169,37600,58200,32000,127800
"TR","1983-06-19",1983,6,170,0,55600,31900,87500
"TR","1983-06-20",1983,6,171,0,53600,32200,85800
"TR","1983-06-21",1983,6,172,0,51900,32200,84100
"TR","1983-06-22",1983,6,173,44200,51900,32200,128300
"TR","1983-06-23",1983,6,174,486000,73300,36300,595600
"TR","1983-06-24",1983,6,175,0,63500,31500,95000
"TR","1983-06-25",1983,6,176,0,59700,31900,91600
"TR","1983-06-26",1983,6,177,0,56500,32100,88600
"TR","1983-06-27",1983,6,178,0,53800,32100,85900
"TR","1983-06-28",1983,6,179,4420,51900,32000,88320
"TR","1983-06-29",1983,6,180,0,51100,31900,83000
"TR","1983-06-30",1983,6,181,0,50600,32000,82600
"TR","1983-07-01",1983,7,182,23000,50400,32000,105400
"TR","1983-07-02",1983,7,183,27200,50000,32000,109200
"TR","1983-07-03",1983,7,184,0,49000,31700,80700
"TR","1983-07-04",1983,7,185,523000,64800,33600,621400
"TR","1983-07-05",1983,7,186,3e+05,73300,33700,407000
"TR","1983-07-06",1983,7,187,7560,64100,30600,102260
"TR","1983-07-07",1983,7,188,0,59600,30800,90400
"TR","1983-07-08",1983,7,189,0,56100,31000,87100
"TR","1983-07-09",1983,7,190,0,52700,31000,83700
"TR","1983-07-10",1983,7,191,0,51300,30900,82200
"TR","1983-07-11",1983,7,192,0,50200,30800,81000
"TR","1983-07-12",1983,7,193,0,49200,30800,80000
"TR","1983-07-13",1983,7,194,0,48100,30800,78900
"TR","1983-07-14",1983,7,195,0,47200,30700,77900
"TR","1983-07-15",1983,7,196,0,46400,30700,77100
"TR","1983-07-16",1983,7,197,0,45700,30700,76400
"TR","1983-07-17",1983,7,198,0,45000,30700,75700
"TR","1983-07-18",1983,7,199,5610,44400,30700,80710
"TR","1983-07-19",1983,7,200,68500,45000,30700,144200
"TR","1983-07-20",1983,7,201,0,44000,30400,74400
"TR","1983-07-21",1983,7,202,28100,43800,30500,102400
"TR","1983-07-22",1983,7,203,110000,45200,30500,185700
"TR","1983-07-23",1983,7,204,6050,44000,30100,80150
"TR","1983-07-24",1983,7,205,0,43200,30200,73400
"TR","1983-07-25",1983,7,206,0,42600,30300,72900
"TR","1983-07-26",1983,7,207,0,42000,30300,72300
"TR","1983-07-27",1983,7,208,0,41500,30300,71800
"TR","1983-07-28",1983,7,209,0,41000,30300,71300
"TR","1983-07-29",1983,7,210,152000,43600,30300,225900
"TR","1983-07-30",1983,7,211,0,42200,29700,71900
"TR","1983-07-31",1983,7,212,32200,41900,29800,103900
"TR","1983-08-01",1983,8,213,20800,41500,29800,92100
"TR","1983-08-02",1983,8,214,13600,41000,30000,84600
"TR","1983-08-03",1983,8,215,0,40400,30200,70600
"TR","1983-08-04",1983,8,216,651000,55800,31800,738600
"TR","1983-08-05",1983,8,217,9100,48800,28900,86800
"TR","1983-08-06",1983,8,218,0,47600,29500,77100
"TR","1983-08-07",1983,8,219,0,46800,30000,76800
"TR","1983-08-08",1983,8,220,0,45400,30600,76000
"TR","1983-08-09",1983,8,221,0,44200,30800,75000
"TR","1983-08-10",1983,8,222,0,43600,30800,74400
"TR","1983-08-11",1983,8,223,895000,83800,34000,1012800
"TR","1983-08-12",1983,8,224,448000,89500,68200,605700
"TR","1983-08-13",1983,8,225,0,81100,30300,111400
"TR","1983-08-14",1983,8,226,0,74800,28400,103200
"TR","1983-08-15",1983,8,227,0,68300,28800,97100
"TR","1983-08-16",1983,8,228,0,62900,29100,92000
"TR","1983-08-17",1983,8,229,0,58700,29400,88100
"TR","1983-08-18",1983,8,230,87900,58500,29900,176300
"TR","1983-08-19",1983,8,231,0,54700,29600,84300
"TR","1983-08-20",1983,8,232,0,52100,29800,81900
"TR","1983-08-21",1983,8,233,2270,50600,30000,82870
"TR","1983-08-22",1983,8,234,98100,51600,30200,179900
"TR","1983-08-23",1983,8,235,77300,52100,30400,159800
"TR","1983-08-24",1983,8,236,0,50700,30000,80700
"TR","1983-08-25",1983,8,237,0,49900,30200,80100
"TR","1983-08-26",1983,8,238,10500,49200,30200,89900
"TR","1983-08-27",1983,8,239,0,48300,30200,78500
"TR","1983-08-28",1983,8,240,0,47600,30200,77800
"TR","1983-08-29",1983,8,241,0,46800,30200,77000
"TR","1983-08-30",1983,8,242,0,46200,30200,76400
"TR","1983-08-31",1983,8,243,101000,47500,30500,179000
"TR","1983-09-01",1983,9,244,1410,46400,30000,77810
"TR","1983-09-02",1983,9,245,0,45600,30200,75800
"TR","1983-09-03",1983,9,246,0,45100,30300,75400
"TR","1983-09-04",1983,9,247,0,44400,30500,74900
"TR","1983-09-05",1983,9,248,26800,44100,30500,101400
"TR","1983-09-06",1983,9,249,198000,47500,30800,276300
"TR","1983-09-07",1983,9,250,250000,52200,31300,333500
"TR","1983-09-08",1983,9,251,50800,50000,30500,131300
"TR","1983-09-09",1983,9,252,0,48700,30500,79200
"TR","1983-09-10",1983,9,253,29100,48300,30700,108100
"TR","1983-09-11",1983,9,254,311000,56300,32000,399300
"TR","1983-09-12",1983,9,255,79700,52800,30300,162800
"TR","1983-09-13",1983,9,256,1e+05,55100,30400,185500
"TR","1983-09-14",1983,9,257,36000,53900,29900,119800
"TR","1983-09-15",1983,9,258,13100,52200,29900,95200
"TR","1983-09-16",1983,9,259,52800,52400,30000,135200
"TR","1983-09-17",1983,9,260,286000,68300,39700,394000
"TR","1983-09-18",1983,9,261,4270,59800,28900,92970
"TR","1983-09-19",1983,9,262,71400,61100,31500,164000
"TR","1983-09-20",1983,9,263,74000,60200,30300,164500
"TR","1983-09-21",1983,9,264,719000,109000,84500,912500
"TR","1983-09-22",1983,9,265,7120,90000,30700,127820
"TR","1983-09-23",1983,9,266,0,85300,27500,112800
"TR","1983-09-24",1983,9,267,27000,81800,28100,136900
"TR","1983-09-25",1983,9,268,0,75300,28400,103700
"TR","1983-09-26",1983,9,269,0,70300,28800,99100
"TR","1983-09-27",1983,9,270,0,65800,29000,94800
"TR","1983-09-28",1983,9,271,0,61900,29200,91100
"TR","1983-09-29",1983,9,272,0,58700,29300,88000
"TR","1983-09-30",1983,9,273,39600,57200,29400,126200
"TR","1983-10-01",1983,10,274,16500,55200,29400,101100
"TR","1983-10-02",1983,10,275,0,53400,29500,82900
"TR","1983-10-03",1983,10,276,50400,53800,29900,134100
"TR","1983-10-04",1983,10,277,70900,56400,29800,157100
"TR","1983-10-05",1983,10,278,30700,56500,29900,117100
"TR","1983-10-06",1983,10,279,23600,55700,30000,109300
"TR","1983-10-07",1983,10,280,18600,54600,30000,103200
"TR","1983-10-08",1983,10,281,163000,60800,30600,254400
"TR","1983-10-09",1983,10,282,280000,79800,40800,400600
"TR","1983-10-10",1983,10,283,0,69900,29200,99100
"TR","1983-10-11",1983,10,284,0,65400,29200,94600
"TR","1983-10-12",1983,10,285,265000,80100,40600,385700
"TR","1983-10-13",1983,10,286,413000,102000,64500,579500
"TR","1983-10-14",1983,10,287,79400,91900,35100,206400
"TR","1983-10-15",1983,10,288,47200,90500,36600,174300
"TR","1983-10-16",1983,10,289,48200,88200,31800,168200
"TR","1983-10-17",1983,10,290,77300,87800,34300,199400
"TR","1983-10-18",1983,10,291,1020,81900,29300,112220
"TR","1983-10-19",1983,10,292,9660,77100,29600,116360
"TR","1983-10-20",1983,10,293,28400,74400,30200,133000
"TR","1983-10-21",1983,10,294,2030,70900,30200,103130
"TR","1983-10-22",1983,10,295,0,68000,30400,98400
"TR","1983-10-23",1983,10,296,0,65600,30700,96300
"TR","1983-10-24",1983,10,297,0,63900,30800,94700
"TR","1983-10-25",1983,10,298,0,62500,30800,93300
"TR","1983-10-26",1983,10,299,0,61400,30900,92300
"TR","1983-10-27",1983,10,300,1610,60500,31000,93110
"TR","1983-10-28",1983,10,301,0,59700,31000,90700
"TR","1983-10-29",1983,10,302,0,58800,31100,89900
"TR","1983-10-30",1983,10,303,0,58200,31100,89300
"TR","1983-10-31",1983,10,304,0,57800,31200,89000
"TR","1983-11-01",1983,11,305,0,57300,31200,88500
"TR","1983-11-02",1983,11,306,0,56700,31400,88100
"TR","1983-11-03",1983,11,307,4560,56200,31600,92360
"TR","1983-11-04",1983,11,308,0,55800,31700,87500
"TR","1983-11-05",1983,11,309,0,55600,31800,87400
"TR","1983-11-06",1983,11,310,0,55400,31800,87200
"TR","1983-11-07",1983,11,311,0,55100,31900,87000
"TR","1983-11-08",1983,11,312,0,54800,32000,86800
"TR","1983-11-09",1983,11,313,1210,54600,32100,87910
"TR","1983-11-10",1983,11,314,190000,61600,32700,284300
"TR","1983-11-11",1983,11,315,156000,64100,31100,251200
"TR","1983-11-12",1983,11,316,6010,62300,31000,99310
"TR","1983-11-13",1983,11,317,0,61000,31200,92200
"TR","1983-11-14",1983,11,318,22000,60300,31300,113600
"TR","1983-11-15",1983,11,319,52700,60300,31200,144200
"TR","1983-11-16",1983,11,320,62600,61400,30900,154900
"TR","1983-11-17",1983,11,321,25600,60900,31200,117700
"TR","1983-11-18",1983,11,322,0,59800,31100,90900
"TR","1983-11-19",1983,11,323,10100,59300,31200,100600
"TR","1983-11-20",1983,11,324,39700,60900,31700,132300
"TR","1983-11-21",1983,11,325,190000,85400,67700,343100
"TR","1983-11-22",1983,11,326,51800,78400,36700,166900
"TR","1983-11-23",1983,11,327,0,73200,31200,104400
"TR","1983-11-24",1983,11,328,546000,84500,32400,662900
"TR","1983-11-25",1983,11,329,192000,87300,34600,313900
"TR","1983-11-26",1983,11,330,10800,82200,28900,121900
"TR","1983-11-27",1983,11,331,0,77600,29100,106700
"TR","1983-11-28",1983,11,332,0,73900,29600,103500
"TR","1983-11-29",1983,11,333,176000,75400,29200,280600
"TR","1983-11-30",1983,11,334,104000,75000,29100,208100
"TR","1983-12-01",1983,12,335,36700,72800,29300,138800
"TR","1983-12-02",1983,12,336,7270,70400,29600,107270
"TR","1983-12-03",1983,12,337,0,68400,29900,98300
"TR","1983-12-04",1983,12,338,0,66700,30100,96800
"TR","1983-12-05",1983,12,339,0,65300,30400,95700
"TR","1983-12-06",1983,12,340,0,64200,30500,94700
"TR","1983-12-07",1983,12,341,0,63300,30700,94000
"TR","1983-12-08",1983,12,342,3460,62600,30900,96960
"TR","1983-12-09",1983,12,343,0,62000,31000,93000
"TR","1983-12-10",1983,12,344,0,61400,31100,92500
"TR","1983-12-11",1983,12,345,9080,61100,31100,101280
"TR","1983-12-12",1983,12,346,49500,62000,30900,142400
"TR","1983-12-13",1983,12,347,54700,62800,30700,148200
"TR","1983-12-14",1983,12,348,31700,62700,30600,125000
"TR","1983-12-15",1983,12,349,7100,62000,30700,99800
"TR","1983-12-16",1983,12,350,107000,63900,30400,201300
"TR","1983-12-17",1983,12,351,9430,63000,30400,102830
"TR","1983-12-18",1983,12,352,0,62000,30600,92600
"TR","1983-12-19",1983,12,353,0,61200,30700,91900
"TR","1983-12-20",1983,12,354,0,60500,30800,91300
"TR","1983-12-21",1983,12,355,0,59900,30900,90800
"TR","1983-12-22",1983,12,356,19000,60000,30900,109900
"TR","1983-12-23",1983,12,357,1210,59500,30900,91610
"TR","1983-12-24",1983,12,358,0,59100,31000,90100
"TR","1983-12-25",1983,12,359,0,58700,31000,89700
"TR","1983-12-26",1983,12,360,0,58400,31100,89500
"TR","1983-12-27",1983,12,361,7840,58300,31000,97140
"TR","1983-12-28",1983,12,362,5620,58100,31000,94720
"TR","1983-12-29",1983,12,363,0,57900,31100,89000
"TR","1983-12-30",1983,12,364,0,57600,31100,88700
"TR","1983-12-31",1983,12,365,0,57400,31100,88500
"TR","1984-01-01",1984,1,1,0,57200,31100,88300
"TR","1984-01-02",1984,1,2,0,56900,31100,88000
"TR","1984-01-03",1984,1,3,0,56700,31100,87800
"TR","1984-01-04",1984,1,4,0,56400,31100,87500
"TR","1984-01-05",1984,1,5,0,56100,31100,87200
"TR","1984-01-06",1984,1,6,9130,56200,31100,96430
"TR","1984-01-07",1984,1,7,4050,56000,31100,91150
"TR","1984-01-08",1984,1,8,0,55800,31100,86900
"TR","1984-01-09",1984,1,9,2020,55700,31000,88720
"TR","1984-01-10",1984,1,10,5630,55700,31000,92330
"TR","1984-01-11",1984,1,11,3750,55600,30900,90250
"TR","1984-01-12",1984,1,12,0,55500,30900,86400
"TR","1984-01-13",1984,1,13,52200,56600,30700,139500
"TR","1984-01-14",1984,1,14,17200,56500,30500,104200
"TR","1984-01-15",1984,1,15,13300,56300,30500,100100
"TR","1984-01-16",1984,1,16,0,55900,30500,86400
"TR","1984-01-17",1984,1,17,21800,56200,30400,108400
"TR","1984-01-18",1984,1,18,0,55800,30400,86200
"TR","1984-01-19",1984,1,19,0,55400,30500,85900
"TR","1984-01-20",1984,1,20,0,55100,30500,85600
"TR","1984-01-21",1984,1,21,0,54800,30500,85300
"TR","1984-01-22",1984,1,22,0,54600,30500,85100
"TR","1984-01-23",1984,1,23,0,54400,30400,84800
"TR","1984-01-24",1984,1,24,0,54200,30400,84600
"TR","1984-01-25",1984,1,25,2020,54000,30400,86420
"TR","1984-01-26",1984,1,26,2020,53700,30400,86120
"TR","1984-01-27",1984,1,27,8290,53900,30400,92590
"TR","1984-01-28",1984,1,28,0,53700,30300,84000
"TR","1984-01-29",1984,1,29,35100,54300,30200,119600
"TR","1984-01-30",1984,1,30,6070,54100,30100,90270
"TR","1984-01-31",1984,1,31,0,53800,30100,83900
"TR","1984-02-01",1984,2,32,0,53500,30100,83600
"TR","1984-02-02",1984,2,33,0,53300,30100,83400
"TR","1984-02-03",1984,2,34,0,53000,30100,83100
"TR","1984-02-04",1984,2,35,1220,52800,30100,84120
"TR","1984-02-05",1984,2,36,56900,54000,29800,140700
"TR","1984-02-06",1984,2,37,9460,53800,29700,92960
"TR","1984-02-07",1984,2,38,1220,53400,29700,84320
"TR","1984-02-08",1984,2,39,0,53100,29700,82800
"TR","1984-02-09",1984,2,40,0,52800,29800,82600
"TR","1984-02-10",1984,2,41,0,52500,29800,82300
"TR","1984-02-11",1984,2,42,0,52300,29800,82100
"TR","1984-02-12",1984,2,43,0,52000,29800,81800
"TR","1984-02-13",1984,2,44,82800,54300,29400,166500
"TR","1984-02-14",1984,2,45,62000,55400,29000,146400
"TR","1984-02-15",1984,2,46,0,54600,29100,83700
"TR","1984-02-16",1984,2,47,0,55100,30300,85400
"TR","1984-02-17",1984,2,48,0,56000,33600,89600
"TR","1984-02-18",1984,2,49,0,56000,33000,89000
"TR","1984-02-19",1984,2,50,0,55600,31700,87300
"TR","1984-02-20",1984,2,51,103000,58700,32500,194200
"TR","1984-02-21",1984,2,52,0,56600,28900,85500
"TR","1984-02-22",1984,2,53,0,55300,29000,84300
"TR","1984-02-23",1984,2,54,0,54600,29100,83700
"TR","1984-02-24",1984,2,55,0,56000,33000,89000
"TR","1984-02-25",1984,2,56,0,54700,30200,84900
"TR","1984-02-26",1984,2,57,0,53600,29300,82900
"TR","1984-02-27",1984,2,58,0,53000,29300,82300
"TR","1984-02-28",1984,2,59,0,52600,29300,81900
"TR","1984-02-29",1984,2,60,0,52300,29300,81600
"TR","1984-03-01",1984,3,61,5720,52100,29300,87120
"TR","1984-03-02",1984,3,62,0,51800,29300,81100
"TR","1984-03-03",1984,3,63,0,51700,29300,81000
"TR","1984-03-04",1984,3,64,0,51500,29300,80800
"TR","1984-03-05",1984,3,65,0,51300,29300,80600
"TR","1984-03-06",1984,3,66,116000,53300,28800,198100
"TR","1984-03-07",1984,3,67,24600,53200,28600,106400
"TR","1984-03-08",1984,3,68,0,52500,28700,81200
"TR","1984-03-09",1984,3,69,0,52000,28700,80700
"TR","1984-03-10",1984,3,70,0,51500,28800,80300
"TR","1984-03-11",1984,3,71,4140,51200,28800,84140
"TR","1984-03-12",1984,3,72,11200,51200,28800,91200
"TR","1984-03-13",1984,3,73,0,51000,28800,79800
"TR","1984-03-14",1984,3,74,351000,57000,27400,435400
"TR","1984-03-15",1984,3,75,0,55000,27300,82300
"TR","1984-03-16",1984,3,76,210000,58900,26900,295800
"TR","1984-03-17",1984,3,77,0,56500,26900,83400
"TR","1984-03-18",1984,3,78,0,54800,27300,82100
"TR","1984-03-19",1984,3,79,0,53400,27500,80900
"TR","1984-03-20",1984,3,80,0,52000,27800,79800
"TR","1984-03-21",1984,3,81,46800,52300,27800,126900
"TR","1984-03-22",1984,3,82,86900,53200,27500,167600
"TR","1984-03-23",1984,3,83,56100,53300,27400,136800
"TR","1984-03-24",1984,3,84,0,51900,27600,79500
"TR","1984-03-25",1984,3,85,0,50700,27900,78600
"TR","1984-03-26",1984,3,86,0,50300,28100,78400
"TR","1984-03-27",1984,3,87,0,50000,28200,78200
"TR","1984-03-28",1984,3,88,0,49700,28400,78100
"TR","1984-03-29",1984,3,89,0,49400,28400,77800
"TR","1984-03-30",1984,3,90,0,49200,28500,77700
"TR","1984-03-31",1984,3,91,0,49200,28600,77800
"TR","1984-04-01",1984,4,92,0,49200,28600,77800
"TR","1984-04-02",1984,4,93,0,49800,28600,78400
"TR","1984-04-03",1984,4,94,0,51500,32300,83800
"TR","1984-04-04",1984,4,95,0,53000,36700,89700
"TR","1984-04-05",1984,4,96,0,53500,36400,89900
"TR","1984-04-06",1984,4,97,0,55100,37800,92900
"TR","1984-04-07",1984,4,98,0,56400,38200,94600
"TR","1984-04-08",1984,4,99,0,57600,37500,95100
"TR","1984-04-09",1984,4,100,0,61400,40400,101800
"TR","1984-04-10",1984,4,101,0,64600,43000,107600
"TR","1984-04-11",1984,4,102,0,66600,44200,110800
"TR","1984-04-12",1984,4,103,0,67300,45500,112800
"TR","1984-04-13",1984,4,104,0,66400,46700,113100
"TR","1984-04-14",1984,4,105,54300,68500,38700,161500
"TR","1984-04-15",1984,4,106,53000,67600,31600,152200
"TR","1984-04-16",1984,4,107,0,64100,30300,94400
"TR","1984-04-17",1984,4,108,0,61600,30400,92000
"TR","1984-04-18",1984,4,109,0,59800,30400,90200
"TR","1984-04-19",1984,4,110,0,58100,30400,88500
"TR","1984-04-20",1984,4,111,0,56700,30400,87100
"TR","1984-04-21",1984,4,112,0,55500,30300,85800
"TR","1984-04-22",1984,4,113,0,54300,30300,84600
"TR","1984-04-23",1984,4,114,0,53300,30200,83500
"TR","1984-04-24",1984,4,115,0,52500,30100,82600
"TR","1984-04-25",1984,4,116,0,51700,30100,81800
"TR","1984-04-26",1984,4,117,0,51400,30300,81700
"TR","1984-04-27",1984,4,118,52100,52500,30700,135300
"TR","1984-04-28",1984,4,119,193000,60100,31500,284600
"TR","1984-04-29",1984,4,120,121000,62700,33600,217300
"TR","1984-04-30",1984,4,121,0,58700,30000,88700
"TR","1984-05-01",1984,5,122,854000,88000,44300,986300
"TR","1984-05-02",1984,5,123,78500,83100,31400,193000
"TR","1984-05-03",1984,5,124,0,81800,34600,116400
"TR","1984-05-04",1984,5,125,0,82000,40300,122300
"TR","1984-05-05",1984,5,126,0,80500,45200,125700
"TR","1984-05-06",1984,5,127,17700,77600,41500,136800
"TR","1984-05-07",1984,5,128,43100,74000,32300,149400
"TR","1984-05-08",1984,5,129,282000,89000,46300,417300
"TR","1984-05-09",1984,5,130,22500,77400,30200,130100
"TR","1984-05-10",1984,5,131,111000,79900,34600,225500
"TR","1984-05-11",1984,5,132,0,73300,30300,103600
"TR","1984-05-12",1984,5,133,33500,70400,30900,134800
"TR","1984-05-13",1984,5,134,0,66300,30700,97000
"TR","1984-05-14",1984,5,135,185000,74000,33700,292700
"TR","1984-05-15",1984,5,136,4780,68500,31100,104380
"TR","1984-05-16",1984,5,137,0,64600,31200,95800
"TR","1984-05-17",1984,5,138,0,61300,31200,92500
"TR","1984-05-18",1984,5,139,16200,59100,31000,106300
"TR","1984-05-19",1984,5,140,0,56800,30900,87700
"TR","1984-05-20",1984,5,141,0,55000,31000,86000
"TR","1984-05-21",1984,5,142,0,53400,30900,84300
"TR","1984-05-22",1984,5,143,0,52300,30900,83200
"TR","1984-05-23",1984,5,144,314000,64100,32700,410800
"TR","1984-05-24",1984,5,145,0,58500,30900,89400
"TR","1984-05-25",1984,5,146,31400,57200,31200,119800
"TR","1984-05-26",1984,5,147,12000,55300,31300,98600
"TR","1984-05-27",1984,5,148,0,53400,31200,84600
"TR","1984-05-28",1984,5,149,0,52400,31300,83700
"TR","1984-05-29",1984,5,150,0,51800,31300,83100
"TR","1984-05-30",1984,5,151,0,51400,31300,82700
"TR","1984-05-31",1984,5,152,0,51000,31300,82300
"TR","1984-06-01",1984,6,153,0,50500,31300,81800
"TR","1984-06-02",1984,6,154,0,49900,31400,81300
"TR","1984-06-03",1984,6,155,29700,49700,31500,110900
"TR","1984-06-04",1984,6,156,0,49000,31500,80500
"TR","1984-06-05",1984,6,157,64100,49600,31600,145300
"TR","1984-06-06",1984,6,158,155000,52000,32200,239200
"TR","1984-06-07",1984,6,159,16700,50900,31700,99300
"TR","1984-06-08",1984,6,160,204000,54900,32900,291800
"TR","1984-06-09",1984,6,161,429000,74900,35000,538900
"TR","1984-06-10",1984,6,162,0,63800,30600,94400
"TR","1984-06-11",1984,6,163,70300,62600,31400,164300
"TR","1984-06-12",1984,6,164,25300,59900,31400,116600
"TR","1984-06-13",1984,6,165,304000,75400,37900,417300
"TR","1984-06-14",1984,6,166,44700,68500,32900,146100
"TR","1984-06-15",1984,6,167,0,63300,30900,94200
"TR","1984-06-16",1984,6,168,0,60000,31200,91200
"TR","1984-06-17",1984,6,169,0,57000,31200,88200
"TR","1984-06-18",1984,6,170,36200,56100,31300,123600
"TR","1984-06-19",1984,6,171,0,53600,31200,84800
"TR","1984-06-20",1984,6,172,0,51800,31200,83000
"TR","1984-06-21",1984,6,173,0,51000,31100,82100
"TR","1984-06-22",1984,6,174,0,50300,31100,81400
"TR","1984-06-23",1984,6,175,0,49600,31100,80700
"TR","1984-06-24",1984,6,176,0,49100,31100,80200
"TR","1984-06-25",1984,6,177,0,48500,31100,79600
"TR","1984-06-26",1984,6,178,0,48000,31100,79100
"TR","1984-06-27",1984,6,179,36300,48100,31100,115500
"TR","1984-06-28",1984,6,180,364000,57200,32000,453200
"TR","1984-06-29",1984,6,181,0,52500,30500,83000
"TR","1984-06-30",1984,6,182,0,51100,30800,81900
"TR","1984-07-01",1984,7,183,0,50200,31000,81200
"TR","1984-07-02",1984,7,184,0,49100,30900,80000
"TR","1984-07-03",1984,7,185,0,48200,30700,78900
"TR","1984-07-04",1984,7,186,49100,48100,30500,127700
"TR","1984-07-05",1984,7,187,89100,48800,30700,168600
"TR","1984-07-06",1984,7,188,15400,47700,30200,93300
"TR","1984-07-07",1984,7,189,104000,49000,30600,183600
"TR","1984-07-08",1984,7,190,0,47800,30000,77800
"TR","1984-07-09",1984,7,191,0,47100,30100,77200
"TR","1984-07-10",1984,7,192,0,46300,30100,76400
"TR","1984-07-11",1984,7,193,65200,46600,30100,141900
"TR","1984-07-12",1984,7,194,90800,47400,30200,168400
"TR","1984-07-13",1984,7,195,6050,46200,29800,82050
"TR","1984-07-14",1984,7,196,9810,45300,29700,84810
"TR","1984-07-15",1984,7,197,3540,44500,29600,77640
"TR","1984-07-16",1984,7,198,14300,44000,29600,87900
"TR","1984-07-17",1984,7,199,0,43300,29500,72800
"TR","1984-07-18",1984,7,200,150000,45600,29800,225400
"TR","1984-07-19",1984,7,201,34700,45200,29200,109100
"TR","1984-07-20",1984,7,202,0,44300,29200,73500
"TR","1984-07-21",1984,7,203,128000,46100,29600,203700
"TR","1984-07-22",1984,7,204,0,44800,29100,73900
"TR","1984-07-23",1984,7,205,1770,43900,29200,74870
"TR","1984-07-24",1984,7,206,1510,43100,29200,73810
"TR","1984-07-25",1984,7,207,0,42400,29100,71500
"TR","1984-07-26",1984,7,208,0,41700,29100,70800
"TR","1984-07-27",1984,7,209,0,41200,29100,70300
"TR","1984-07-28",1984,7,210,0,40700,29000,69700
"TR","1984-07-29",1984,7,211,0,40300,29000,69300
"TR","1984-07-30",1984,7,212,0,39900,29000,68900
"TR","1984-07-31",1984,7,213,0,39400,29000,68400
"TR","1984-08-01",1984,8,214,0,38900,28900,67800
"TR","1984-08-02",1984,8,215,248000,42900,29200,320100
"TR","1984-08-03",1984,8,216,159000,44400,28700,232100
"TR","1984-08-04",1984,8,217,185000,46700,29000,260700
"TR","1984-08-05",1984,8,218,0,44400,28500,72900
"TR","1984-08-06",1984,8,219,236000,48600,29300,313900
"TR","1984-08-07",1984,8,220,139000,48300,29200,216500
"TR","1984-08-08",1984,8,221,12600,46500,28800,87900
"TR","1984-08-09",1984,8,222,554000,70200,46900,671100
"TR","1984-08-10",1984,8,223,3990,59200,27500,90690
"TR","1984-08-11",1984,8,224,0,54900,28000,82900
"TR","1984-08-12",1984,8,225,0,51800,28400,80200
"TR","1984-08-13",1984,8,226,0,49600,28600,78200
"TR","1984-08-14",1984,8,227,0,48500,28700,77200
"TR","1984-08-15",1984,8,228,122000,50100,28900,201000
"TR","1984-08-16",1984,8,229,179000,54900,29400,263300
"TR","1984-08-17",1984,8,230,9100,50600,28800,88500
"TR","1984-08-18",1984,8,231,0,48900,28900,77800
"TR","1984-08-19",1984,8,232,63900,49100,29100,142100
"TR","1984-08-20",1984,8,233,0,47700,28800,76500
"TR","1984-08-21",1984,8,234,0,46900,29000,75900
"TR","1984-08-22",1984,8,235,139000,49000,29200,217200
"TR","1984-08-23",1984,8,236,134000,50200,29400,213600
"TR","1984-08-24",1984,8,237,11400,48700,28800,88900
"TR","1984-08-25",1984,8,238,0,47500,28900,76400
"TR","1984-08-26",1984,8,239,0,46700,29000,75700
"TR","1984-08-27",1984,8,240,0,45700,29000,74700
"TR","1984-08-28",1984,8,241,389000,55900,31100,476000
"TR","1984-08-29",1984,8,242,0,49700,28200,77900
"TR","1984-08-30",1984,8,243,16900,48600,28500,94000
"TR","1984-08-31",1984,8,244,36400,48300,28700,113400
"TR","1984-09-01",1984,9,245,0,47200,28500,75700
"TR","1984-09-02",1984,9,246,47500,47500,28600,123600
"TR","1984-09-03",1984,9,247,525000,73000,41900,639900
"TR","1984-09-04",1984,9,248,91200,67400,38700,197300
"TR","1984-09-05",1984,9,249,51500,63400,27700,142600
"TR","1984-09-06",1984,9,250,25200,59900,27800,112900
"TR","1984-09-07",1984,9,251,0,56200,27900,84100
"TR","1984-09-08",1984,9,252,3960,53300,28200,85460
"TR","1984-09-09",1984,9,253,105000,54900,28700,188600
"TR","1984-09-10",1984,9,254,30000,52800,28400,111200
"TR","1984-09-11",1984,9,255,3960,50300,28400,82660
"TR","1984-09-12",1984,9,256,0,49200,28400,77600
"TR","1984-09-13",1984,9,257,305000,62300,30200,397500
"TR","1984-09-14",1984,9,258,127000,64400,41700,233100
"TR","1984-09-15",1984,9,259,5280,57900,27700,90880
"TR","1984-09-16",1984,9,260,13900,55000,27900,96800
"TR","1984-09-17",1984,9,261,0,52500,28000,80500
"TR","1984-09-18",1984,9,262,0,50400,28200,78600
"TR","1984-09-19",1984,9,263,0,49400,28200,77600
"TR","1984-09-20",1984,9,264,0,48600,28300,76900
"TR","1984-09-21",1984,9,265,0,47700,28400,76100
"TR","1984-09-22",1984,9,266,0,47000,28300,75300
"TR","1984-09-23",1984,9,267,0,46400,28300,74700
"TR","1984-09-24",1984,9,268,43900,46900,28100,118900
"TR","1984-09-25",1984,9,269,440000,66400,33100,539500
"TR","1984-09-26",1984,9,270,175000,70600,44700,290300
"TR","1984-09-27",1984,9,271,16000,64100,28600,108700
"TR","1984-09-28",1984,9,272,0,59600,27200,86800
"TR","1984-09-29",1984,9,273,0,56800,27600,84400
"TR","1984-09-30",1984,9,274,0,54500,27700,82200
"TR","1984-10-01",1984,10,275,0,52600,27900,80500
"TR","1984-10-02",1984,10,276,0,51100,28100,79200
"TR","1984-10-03",1984,10,277,0,50100,28200,78300
"TR","1984-10-04",1984,10,278,0,49300,28200,77500
"TR","1984-10-05",1984,10,279,0,48600,28200,76800
"TR","1984-10-06",1984,10,280,11200,48500,28300,88000
"TR","1984-10-07",1984,10,281,0,48000,28300,76300
"TR","1984-10-08",1984,10,282,133000,51400,28400,212800
"TR","1984-10-09",1984,10,283,73100,52400,28300,153800
"TR","1984-10-10",1984,10,284,5210,51000,28300,84510
"TR","1984-10-11",1984,10,285,0,49700,28400,78100
"TR","1984-10-12",1984,10,286,0,48900,28600,77500
"TR","1984-10-13",1984,10,287,15200,49000,28600,92800
"TR","1984-10-14",1984,10,288,0,48400,28600,77000
"TR","1984-10-15",1984,10,289,0,48100,28800,76900
"TR","1984-10-16",1984,10,290,0,47900,29000,76900
"TR","1984-10-17",1984,10,291,60800,49300,29100,139200
"TR","1984-10-18",1984,10,292,225000,59400,33300,317700
"TR","1984-10-19",1984,10,293,4830,54500,28500,87830
"TR","1984-10-20",1984,10,294,98000,58500,33600,190100
"TR","1984-10-21",1984,10,295,21000,57300,29700,108000
"TR","1984-10-22",1984,10,296,0,54700,28100,82800
"TR","1984-10-23",1984,10,297,11300,53300,28200,92800
"TR","1984-10-24",1984,10,298,0,51800,28200,80000
"TR","1984-10-25",1984,10,299,0,50700,28300,79000
"TR","1984-10-26",1984,10,300,27200,50800,28300,106300
"TR","1984-10-27",1984,10,301,46800,52100,28400,127300
"TR","1984-10-28",1984,10,302,82600,55800,28700,167100
"TR","1984-10-29",1984,10,303,238000,73200,45400,356600
"TR","1984-10-30",1984,10,304,0,64200,28800,93000
"TR","1984-10-31",1984,10,305,51600,63700,29200,144500
"TR","1984-11-01",1984,11,306,50800,63100,30300,144200
"TR","1984-11-02",1984,11,307,227000,67200,29400,323600
"TR","1984-11-03",1984,11,308,0,63400,26900,90300
"TR","1984-11-04",1984,11,309,0,60500,27000,87500
"TR","1984-11-05",1984,11,310,4470,64600,36000,105070
"TR","1984-11-06",1984,11,311,0,58800,29000,87800
"TR","1984-11-07",1984,11,312,0,56400,27600,84000
"TR","1984-11-08",1984,11,313,0,54600,27700,82300
"TR","1984-11-09",1984,11,314,14700,53700,27800,96200
"TR","1984-11-10",1984,11,315,0,52500,27600,80100
"TR","1984-11-11",1984,11,316,0,51700,27600,79300
"TR","1984-11-12",1984,11,317,0,51300,27600,78900
"TR","1984-11-13",1984,11,318,0,51000,27600,78600
"TR","1984-11-14",1984,11,319,0,50800,27600,78400
"TR","1984-11-15",1984,11,320,0,50500,27600,78100
"TR","1984-11-16",1984,11,321,8500,50400,27600,86500
"TR","1984-11-17",1984,11,322,2160,50100,27500,79760
"TR","1984-11-18",1984,11,323,0,50000,27500,77500
"TR","1984-11-19",1984,11,324,0,49800,27600,77400
"TR","1984-11-20",1984,11,325,0,49700,27600,77300
"TR","1984-11-21",1984,11,326,6480,49600,27600,83680
"TR","1984-11-22",1984,11,327,0,49400,27600,77000
"TR","1984-11-23",1984,11,328,0,49300,27700,77000
"TR","1984-11-24",1984,11,329,0,49100,27800,76900
"TR","1984-11-25",1984,11,330,0,48900,27800,76700
"TR","1984-11-26",1984,11,331,0,48700,27900,76600
"TR","1984-11-27",1984,11,332,0,48400,28100,76500
"TR","1984-11-28",1984,11,333,66000,49900,28300,144200
"TR","1984-11-29",1984,11,334,72100,51200,28400,151700
"TR","1984-11-30",1984,11,335,2160,50300,27900,80360
"TR","1984-12-01",1984,12,336,6010,49600,28000,83610
"TR","1984-12-02",1984,12,337,2420,49300,27800,79520
"TR","1984-12-03",1984,12,338,126000,51000,27300,204300
"TR","1984-12-04",1984,12,339,85300,52600,26900,164800
"TR","1984-12-05",1984,12,340,0,51700,26900,78600
"TR","1984-12-06",1984,12,341,6740,51100,27100,84940
"TR","1984-12-07",1984,12,342,21100,51100,27100,99300
"TR","1984-12-08",1984,12,343,0,50500,27200,77700
"TR","1984-12-09",1984,12,344,0,49900,27300,77200
"TR","1984-12-10",1984,12,345,0,49700,27300,77000
"TR","1984-12-11",1984,12,346,0,49600,27400,77000
"TR","1984-12-12",1984,12,347,0,49400,27400,76800
"TR","1984-12-13",1984,12,348,0,49300,27500,76800
"TR","1984-12-14",1984,12,349,0,49200,27500,76700
"TR","1984-12-15",1984,12,350,15200,49200,27400,91800
"TR","1984-12-16",1984,12,351,58100,49500,27100,134700
"TR","1984-12-17",1984,12,352,97500,51500,27000,176000
"TR","1984-12-18",1984,12,353,24900,52800,27200,104900
"TR","1984-12-19",1984,12,354,20600,52200,26700,99500
"TR","1984-12-20",1984,12,355,0,51200,26800,78000
"TR","1984-12-21",1984,12,356,0,50500,26900,77400
"TR","1984-12-22",1984,12,357,88800,51500,26600,166900
"TR","1984-12-23",1984,12,358,132000,54300,26100,212400
"TR","1984-12-24",1984,12,359,0,53000,26100,79100
"TR","1984-12-25",1984,12,360,0,51900,26300,78200
"TR","1984-12-26",1984,12,361,0,51000,26500,77500
"TR","1984-12-27",1984,12,362,0,50300,26600,76900
"TR","1984-12-28",1984,12,363,0,49800,26700,76500
"TR","1984-12-29",1984,12,364,18900,49800,26700,95400
"TR","1984-12-30",1984,12,365,20500,49800,26600,96900
"TR","1984-12-31",1984,12,366,0,49600,26700,76300
"TR","1985-01-01",1985,1,1,30400,49600,26600,106600
"TR","1985-01-02",1985,1,2,0,49500,26600,76100
"TR","1985-01-03",1985,1,3,0,49300,26700,76000
"TR","1985-01-04",1985,1,4,0,49100,26700,75800
"TR","1985-01-05",1985,1,5,0,49000,26800,75800
"TR","1985-01-06",1985,1,6,0,48800,26800,75600
"TR","1985-01-07",1985,1,7,0,48600,26900,75500
"TR","1985-01-08",1985,1,8,2410,48400,26900,77710
"TR","1985-01-09",1985,1,9,0,48300,26900,75200
"TR","1985-01-10",1985,1,10,0,48100,26900,75000
"TR","1985-01-11",1985,1,11,7340,48100,26800,82240
"TR","1985-01-12",1985,1,12,12700,48000,26800,87500
"TR","1985-01-13",1985,1,13,0,47900,26800,74700
"TR","1985-01-14",1985,1,14,0,47800,26800,74600
"TR","1985-01-15",1985,1,15,38500,47900,26600,113000
"TR","1985-01-16",1985,1,16,4050,47800,26600,78450
"TR","1985-01-17",1985,1,17,0,47700,26600,74300
"TR","1985-01-18",1985,1,18,0,47500,26600,74100
"TR","1985-01-19",1985,1,19,4050,47400,26700,78150
"TR","1985-01-20",1985,1,20,0,47300,26700,74000
"TR","1985-01-21",1985,1,21,0,47200,26700,73900
"TR","1985-01-22",1985,1,22,0,47100,26600,73700
"TR","1985-01-23",1985,1,23,25800,47100,26500,99400
"TR","1985-01-24",1985,1,24,0,47000,26500,73500
"TR","1985-01-25",1985,1,25,2020,46900,26600,75520
"TR","1985-01-26",1985,1,26,0,46700,26600,73300
"TR","1985-01-27",1985,1,27,0,46600,26600,73200
"TR","1985-01-28",1985,1,28,5630,46500,26500,78630
"TR","1985-01-29",1985,1,29,2020,46400,26500,74920
"TR","1985-01-30",1985,1,30,0,46300,26500,72800
"TR","1985-01-31",1985,1,31,0,46200,26500,72700
"TR","1985-02-01",1985,2,32,0,46100,26500,72600
"TR","1985-02-02",1985,2,33,0,46000,26500,72500
"TR","1985-02-03",1985,2,34,0,45900,26400,72300
"TR","1985-02-04",1985,2,35,0,45800,26400,72200
"TR","1985-02-05",1985,2,36,0,45700,26400,72100
"TR","1985-02-06",1985,2,37,8060,45700,26400,80160
"TR","1985-02-07",1985,2,38,24000,45800,26200,96000
"TR","1985-02-08",1985,2,39,4860,45700,26200,76760
"TR","1985-02-09",1985,2,40,0,45600,26200,71800
"TR","1985-02-10",1985,2,41,0,45500,26200,71700
"TR","1985-02-11",1985,2,42,33200,45600,26100,104900
"TR","1985-02-12",1985,2,43,61200,46000,25800,133000
"TR","1985-02-13",1985,2,44,0,45800,25800,71600
"TR","1985-02-14",1985,2,45,0,45700,25800,71500
"TR","1985-02-15",1985,2,46,0,45600,25900,71500
"TR","1985-02-16",1985,2,47,0,45500,25900,71400
"TR","1985-02-17",1985,2,48,3380,45300,25900,74580
"TR","1985-02-18",1985,2,49,5510,45300,25900,76710
"TR","1985-02-19",1985,2,50,10100,45200,25900,81200
"TR","1985-02-20",1985,2,51,10000,45100,25800,80900
"TR","1985-02-21",1985,2,52,1220,45000,25800,72020
"TR","1985-02-22",1985,2,53,86700,45600,25500,157800
"TR","1985-02-23",1985,2,54,4860,45400,25400,75660
"TR","1985-02-24",1985,2,55,0,45300,25500,70800
"TR","1985-02-25",1985,2,56,31500,45500,25500,102500
"TR","1985-02-26",1985,2,57,0,45300,25500,70800
"TR","1985-02-27",1985,2,58,18600,45600,25600,89800
"TR","1985-02-28",1985,2,59,0,45200,25500,70700
"TR","1985-03-01",1985,3,60,0,45000,25600,70600
"TR","1985-03-02",1985,3,61,0,44800,25600,70400
"TR","1985-03-03",1985,3,62,0,44500,25700,70200
"TR","1985-03-04",1985,3,63,76600,44800,25400,146800
"TR","1985-03-05",1985,3,64,246000,46500,24400,316900
"TR","1985-03-06",1985,3,65,120000,47200,23900,191100
"TR","1985-03-07",1985,3,66,0,47000,24000,71000
"TR","1985-03-08",1985,3,67,0,46700,24300,71000
"TR","1985-03-09",1985,3,68,0,46400,24600,71000
"TR","1985-03-10",1985,3,69,0,45900,24800,70700
"TR","1985-03-11",1985,3,70,0,45500,25000,70500
"TR","1985-03-12",1985,3,71,0,45200,25200,70400
"TR","1985-03-13",1985,3,72,279000,47000,24100,350100
"TR","1985-03-14",1985,3,73,33700,47600,23800,105100
"TR","1985-03-15",1985,3,74,0,48400,25000,73400
"TR","1985-03-16",1985,3,75,0,47000,24500,71500
"TR","1985-03-17",1985,3,76,0,46300,24700,71000
"TR","1985-03-18",1985,3,77,0,46800,26300,73100
"TR","1985-03-19",1985,3,78,0,46200,25000,71200
"TR","1985-03-20",1985,3,79,0,47000,27300,74300
"TR","1985-03-21",1985,3,80,0,47500,30400,77900
"TR","1985-03-22",1985,3,81,0,46800,27000,73800
"TR","1985-03-23",1985,3,82,0,48400,31000,79400
"TR","1985-03-24",1985,3,83,0,50600,35000,85600
"TR","1985-03-25",1985,3,84,8390,54300,39000,101690
"TR","1985-03-26",1985,3,85,0,51000,29700,80700
"TR","1985-03-27",1985,3,86,7820,53000,39200,100020
"TR","1985-03-28",1985,3,87,45400,59400,52600,157400
"TR","1985-03-29",1985,3,88,43500,58200,41500,143200
"TR","1985-03-30",1985,3,89,77600,60000,30900,168500
"TR","1985-03-31",1985,3,90,0,55600,25900,81500
"TR","1985-04-01",1985,4,91,265000,60000,25300,350300
"TR","1985-04-02",1985,4,92,256000,64400,24400,344800
"TR","1985-04-03",1985,4,93,0,60900,24600,85500
"TR","1985-04-04",1985,4,94,61300,60800,25000,147100
"TR","1985-04-05",1985,4,95,0,58900,25800,84700
"TR","1985-04-06",1985,4,96,0,58000,28900,86900
"TR","1985-04-07",1985,4,97,2410,58700,31700,92810
"TR","1985-04-08",1985,4,98,0,56700,29400,86100
"TR","1985-04-09",1985,4,99,48000,55600,26500,130100
"TR","1985-04-10",1985,4,100,0,53800,26300,80100
"TR","1985-04-11",1985,4,101,0,52900,26700,79600
"TR","1985-04-12",1985,4,102,0,54800,34800,89600
"TR","1985-04-13",1985,4,103,56200,57700,36600,150500
"TR","1985-04-14",1985,4,104,418000,85500,54700,558200
"TR","1985-04-15",1985,4,105,11500,70800,25400,107700
"TR","1985-04-16",1985,4,106,0,65100,25600,90700
"TR","1985-04-17",1985,4,107,0,61100,26100,87200
"TR","1985-04-18",1985,4,108,223000,69600,30600,323200
"TR","1985-04-19",1985,4,109,0,64500,29200,93700
"TR","1985-04-20",1985,4,110,96800,65000,28900,190700
"TR","1985-04-21",1985,4,111,0,60200,26500,86700
"TR","1985-04-22",1985,4,112,48800,59000,26900,134700
"TR","1985-04-23",1985,4,113,31900,56900,26800,115600
"TR","1985-04-24",1985,4,114,135000,60700,27700,223400
"TR","1985-04-25",1985,4,115,188000,69700,40100,297800
"TR","1985-04-26",1985,4,116,15800,63400,26700,105900
"TR","1985-04-27",1985,4,117,0,59500,26800,86300
"TR","1985-04-28",1985,4,118,10600,57300,27000,94900
"TR","1985-04-29",1985,4,119,12000,55900,27100,95000
"TR","1985-04-30",1985,4,120,0,53700,27200,80900
"TR","1985-05-01",1985,5,121,0,52200,27300,79500
"TR","1985-05-02",1985,5,122,7180,51300,27400,85880
"TR","1985-05-03",1985,5,123,0,50700,27500,78200
"TR","1985-05-04",1985,5,124,0,50200,27400,77600
"TR","1985-05-05",1985,5,125,35500,50500,27800,113800
"TR","1985-05-06",1985,5,126,37700,50300,28200,116200
"TR","1985-05-07",1985,5,127,116000,52200,28500,196700
"TR","1985-05-08",1985,5,128,32300,51300,28300,111900
"TR","1985-05-09",1985,5,129,0,49800,28200,78000
"TR","1985-05-10",1985,5,130,0,49000,28200,77200
"TR","1985-05-11",1985,5,131,708000,88000,57900,853900
"TR","1985-05-12",1985,5,132,102000,73000,28300,203300
"TR","1985-05-13",1985,5,133,39700,67400,27000,134100
"TR","1985-05-14",1985,5,134,36500,64100,27400,128000
"TR","1985-05-15",1985,5,135,35200,61300,27600,124100
"TR","1985-05-16",1985,5,136,198000,70100,36300,304400
"TR","1985-05-17",1985,5,137,40100,64500,28400,133000
"TR","1985-05-18",1985,5,138,13800,60800,27900,102500
"TR","1985-05-19",1985,5,139,52900,60100,28500,141500
"TR","1985-05-20",1985,5,140,31000,58000,28400,117400
"TR","1985-05-21",1985,5,141,2390,54700,28400,85490
"TR","1985-05-22",1985,5,142,0,52100,28100,80200
"TR","1985-05-23",1985,5,143,0,50700,28300,79000
"TR","1985-05-24",1985,5,144,0,49900,28200,78100
"TR","1985-05-25",1985,5,145,31000,49500,28200,108700
"TR","1985-05-26",1985,5,146,99700,50600,28500,178800
"TR","1985-05-27",1985,5,147,665000,91100,55500,811600
"TR","1985-05-28",1985,5,148,0,71700,27400,99100
"TR","1985-05-29",1985,5,149,0,65700,27400,93100
"TR","1985-05-30",1985,5,150,20000,62200,27700,109900
"TR","1985-05-31",1985,5,151,617000,103000,63700,783700
"TR","1985-06-01",1985,6,152,349000,102000,47600,498600
"TR","1985-06-02",1985,6,153,97600,93100,32800,223500
"TR","1985-06-03",1985,6,154,90500,89400,30900,210800
"TR","1985-06-04",1985,6,155,0,81600,27600,109200
"TR","1985-06-05",1985,6,156,0,75300,28400,103700
"TR","1985-06-06",1985,6,157,0,70000,28900,98900
"TR","1985-06-07",1985,6,158,0,65700,29200,94900
"TR","1985-06-08",1985,6,159,27100,62800,29600,119500
"TR","1985-06-09",1985,6,160,102000,64100,30700,196800
"TR","1985-06-10",1985,6,161,207000,71900,36100,315000
"TR","1985-06-11",1985,6,162,0,63700,30400,94100
"TR","1985-06-12",1985,6,163,0,60600,30700,91300
"TR","1985-06-13",1985,6,164,0,57900,30800,88700
"TR","1985-06-14",1985,6,165,0,55800,30900,86700
"TR","1985-06-15",1985,6,166,0,53900,31000,84900
"TR","1985-06-16",1985,6,167,115000,57400,31700,204100
"TR","1985-06-17",1985,6,168,45000,57200,31600,133800
"TR","1985-06-18",1985,6,169,158000,61900,32500,252400
"TR","1985-06-19",1985,6,170,159000,67700,33100,259800
"TR","1985-06-20",1985,6,171,0,62100,31600,93700
"TR","1985-06-21",1985,6,172,0,59000,31800,90800
"TR","1985-06-22",1985,6,173,181000,63600,32800,277400
"TR","1985-06-23",1985,6,174,371000,87400,51700,510100
"TR","1985-06-24",1985,6,175,11900,74200,31400,117500
"TR","1985-06-25",1985,6,176,0,68300,30900,99200
"TR","1985-06-26",1985,6,177,0,64300,31200,95500
"TR","1985-06-27",1985,6,178,584000,93600,48100,725700
"TR","1985-06-28",1985,6,179,145000,81800,36900,263700
"TR","1985-06-29",1985,6,180,0,72700,30300,103000
"TR","1985-06-30",1985,6,181,0,67300,30800,98100
"TR","1985-07-01",1985,7,182,0,62900,31000,93900
"TR","1985-07-02",1985,7,183,0,58500,31100,89600
"TR","1985-07-03",1985,7,184,140000,61100,31900,233000
"TR","1985-07-04",1985,7,185,0,56600,31100,87700
"TR","1985-07-05",1985,7,186,355000,70300,34200,459500
"TR","1985-07-06",1985,7,187,371000,89600,51500,512100
"TR","1985-07-07",1985,7,188,48300,76900,32700,157900
"TR","1985-07-08",1985,7,189,4200,69500,30800,104500
"TR","1985-07-09",1985,7,190,0,64100,31000,95100
"TR","1985-07-10",1985,7,191,39200,61000,31100,131300
"TR","1985-07-11",1985,7,192,60900,59700,31400,152000
"TR","1985-07-12",1985,7,193,13800,56700,31100,101600
"TR","1985-07-13",1985,7,194,0,54000,31100,85100
"TR","1985-07-14",1985,7,195,0,53000,31300,84300
"TR","1985-07-15",1985,7,196,0,51800,31200,83000
"TR","1985-07-16",1985,7,197,0,50800,31200,82000
"TR","1985-07-17",1985,7,198,0,50100,31200,81300
"TR","1985-07-18",1985,7,199,0,49400,31200,80600
"TR","1985-07-19",1985,7,200,213000,53200,31800,298000
"TR","1985-07-20",1985,7,201,25000,51800,31200,108000
"TR","1985-07-21",1985,7,202,0,50300,31200,81500
"TR","1985-07-22",1985,7,203,0,49300,31300,80600
"TR","1985-07-23",1985,7,204,0,48400,31400,79800
"TR","1985-07-24",1985,7,205,0,47600,31300,78900
"TR","1985-07-25",1985,7,206,78500,48400,31400,158300
"TR","1985-07-26",1985,7,207,188000,51300,32100,271400
"TR","1985-07-27",1985,7,208,0,49500,31200,80700
"TR","1985-07-28",1985,7,209,0,48400,31500,79900
"TR","1985-07-29",1985,7,210,7970,47400,31400,86770
"TR","1985-07-30",1985,7,211,0,46700,31300,78000
"TR","1985-07-31",1985,7,212,7010,46200,31300,84510
"TR","1985-08-01",1985,8,213,36000,46200,31400,113600
"TR","1985-08-02",1985,8,214,0,45400,31400,76800
"TR","1985-08-03",1985,8,215,0,44900,31700,76600
"TR","1985-08-04",1985,8,216,0,44400,31800,76200
"TR","1985-08-05",1985,8,217,0,43900,32000,75900
"TR","1985-08-06",1985,8,218,158000,46500,32100,236600
"TR","1985-08-07",1985,8,219,28500,45700,31700,105900
"TR","1985-08-08",1985,8,220,132000,47500,32400,211900
"TR","1985-08-09",1985,8,221,10500,46200,31900,88600
"TR","1985-08-10",1985,8,222,116000,47700,32300,196000
"TR","1985-08-11",1985,8,223,757000,81000,51300,889300
"TR","1985-08-12",1985,8,224,0,64700,29900,94600
"TR","1985-08-13",1985,8,225,84300,63200,30800,178300
"TR","1985-08-14",1985,8,226,243000,75200,47400,365600
"TR","1985-08-15",1985,8,227,0,66000,30400,96400
"TR","1985-08-16",1985,8,228,0,61600,30600,92200
"TR","1985-08-17",1985,8,229,0,58100,30900,89000
"TR","1985-08-18",1985,8,230,69600,57600,31200,158400
"TR","1985-08-19",1985,8,231,248000,68800,37200,354000
"TR","1985-08-20",1985,8,232,2110,61900,30800,94810
"TR","1985-08-21",1985,8,233,0,58400,31100,89500
"TR","1985-08-22",1985,8,234,0,55800,31300,87100
"TR","1985-08-23",1985,8,235,8430,53500,31400,93330
"TR","1985-08-24",1985,8,236,511000,82400,49300,642700
"TR","1985-08-25",1985,8,237,110000,75200,39300,224500
"TR","1985-08-26",1985,8,238,14700,68500,30400,113600
"TR","1985-08-27",1985,8,239,0,63500,30600,94100
"TR","1985-08-28",1985,8,240,0,59900,30900,90800
"TR","1985-08-29",1985,8,241,6660,57100,31000,94760
"TR","1985-08-30",1985,8,242,51300,56200,31200,138700
"TR","1985-08-31",1985,8,243,0,53500,31000,84500
"TR","1985-09-01",1985,9,244,0,52200,31200,83400
"TR","1985-09-02",1985,9,245,0,51300,31300,82600
"TR","1985-09-03",1985,9,246,14500,50600,31300,96400
"TR","1985-09-04",1985,9,247,515000,76100,40500,631600
"TR","1985-09-05",1985,9,248,95300,68900,37800,202000
"TR","1985-09-06",1985,9,249,0,62300,30800,93100
"TR","1985-09-07",1985,9,250,0,58300,31400,89700
"TR","1985-09-08",1985,9,251,3960,54900,31500,90360
"TR","1985-09-09",1985,9,252,314000,70100,44600,428700
"TR","1985-09-10",1985,9,253,3820,61800,31300,96920
"TR","1985-09-11",1985,9,254,9450,58400,31500,99350
"TR","1985-09-12",1985,9,255,0,55900,31500,87400
"TR","1985-09-13",1985,9,256,0,54100,31700,85800
"TR","1985-09-14",1985,9,257,0,52600,31600,84200
"TR","1985-09-15",1985,9,258,0,51900,31600,83500
"TR","1985-09-16",1985,9,259,0,51200,31600,82800
"TR","1985-09-17",1985,9,260,0,50500,31700,82200
"TR","1985-09-18",1985,9,261,6420,50000,31700,88120
"TR","1985-09-19",1985,9,262,0,49200,31700,80900
"TR","1985-09-20",1985,9,263,0,48500,31800,80300
"TR","1985-09-21",1985,9,264,65000,49100,32000,146100
"TR","1985-09-22",1985,9,265,0,48300,31600,79900
"TR","1985-09-23",1985,9,266,91200,50100,32100,173400
"TR","1985-09-24",1985,9,267,330000,62400,33400,425800
"TR","1985-09-25",1985,9,268,330000,84500,51300,465800
"TR","1985-09-26",1985,9,269,5650,73200,30900,109750
"TR","1985-09-27",1985,9,270,17200,68500,30500,116200
"TR","1985-09-28",1985,9,271,0,64400,30700,95100
"TR","1985-09-29",1985,9,272,1320,61600,31100,94020
"TR","1985-09-30",1985,9,273,199000,71900,38000,308900
"TR","1985-10-01",1985,10,274,435000,100000,64600,599600
"TR","1985-10-02",1985,10,275,94000,90700,40600,225300
"TR","1985-10-03",1985,10,276,32600,87400,33600,153600
"TR","1985-10-04",1985,10,277,0,79500,30200,109700
"TR","1985-10-05",1985,10,278,458000,103000,52300,613300
"TR","1985-10-06",1985,10,279,517000,123000,88900,728900
"TR","1985-10-07",1985,10,280,16200,105000,36500,157700
"TR","1985-10-08",1985,10,281,12000,100000,30900,142900
"TR","1985-10-09",1985,10,282,214000,107000,47300,368300
"TR","1985-10-10",1985,10,283,0,98300,33000,131300
"TR","1985-10-11",1985,10,284,6680,93900,33100,133680
"TR","1985-10-12",1985,10,285,0,90600,33700,124300
"TR","1985-10-13",1985,10,286,192000,97700,43300,333000
"TR","1985-10-14",1985,10,287,24600,92500,37500,154600
"TR","1985-10-15",1985,10,288,0,88300,34900,123200
"TR","1985-10-16",1985,10,289,0,83300,35400,118700
"TR","1985-10-17",1985,10,290,0,79300,35500,114800
"TR","1985-10-18",1985,10,291,9660,76900,35800,122360
"TR","1985-10-19",1985,10,292,13800,74700,36000,124500
"TR","1985-10-20",1985,10,293,0,72500,35900,108400
"TR","1985-10-21",1985,10,294,0,70700,36100,106800
"TR","1985-10-22",1985,10,295,0,69200,36100,105300
"TR","1985-10-23",1985,10,296,0,67800,36200,104000
"TR","1985-10-24",1985,10,297,29000,67700,36400,133100
"TR","1985-10-25",1985,10,298,17500,66900,36400,120800
"TR","1985-10-26",1985,10,299,1610,65500,36300,103410
"TR","1985-10-27",1985,10,300,1740,64800,36400,102940
"TR","1985-10-28",1985,10,301,0,64100,36600,100700
"TR","1985-10-29",1985,10,302,0,63600,36800,100400
"TR","1985-10-30",1985,10,303,0,63300,37000,100300
"TR","1985-10-31",1985,10,304,12700,63400,37100,113200
"TR","1985-11-01",1985,11,305,0,62700,37100,99800
"TR","1985-11-02",1985,11,306,382000,89000,49200,520200
"TR","1985-11-03",1985,11,307,212000,96400,57500,365900
"TR","1985-11-04",1985,11,308,16700,88300,37500,142500
"TR","1985-11-05",1985,11,309,13300,82900,36300,132500
"TR","1985-11-06",1985,11,310,0,78800,36300,115100
"TR","1985-11-07",1985,11,311,29700,77000,36700,143400
"TR","1985-11-08",1985,11,312,0,74000,36300,110300
"TR","1985-11-09",1985,11,313,0,71900,36400,108300
"TR","1985-11-10",1985,11,314,0,70500,36200,106700
"TR","1985-11-11",1985,11,315,0,69300,36200,105500
"TR","1985-11-12",1985,11,316,0,68400,36100,104500
"TR","1985-11-13",1985,11,317,0,67500,36100,103600
"TR","1985-11-14",1985,11,318,0,66700,36000,102700
"TR","1985-11-15",1985,11,319,0,65900,35900,101800
"TR","1985-11-16",1985,11,320,0,65300,35800,101100
"TR","1985-11-17",1985,11,321,86700,67000,35300,189000
"TR","1985-11-18",1985,11,322,126000,70300,34900,231200
"TR","1985-11-19",1985,11,323,12100,70500,35700,118300
"TR","1985-11-20",1985,11,324,39800,77800,41300,158900
"TR","1985-11-21",1985,11,325,287000,79800,34900,401700
"TR","1985-11-22",1985,11,326,0,76800,34900,111700
"TR","1985-11-23",1985,11,327,120000,77500,34800,232300
"TR","1985-11-24",1985,11,328,23100,75600,34900,133600
"TR","1985-11-25",1985,11,329,27400,74500,35100,137000
"TR","1985-11-26",1985,11,330,20000,73200,35200,128400
"TR","1985-11-27",1985,11,331,68900,73600,35100,177600
"TR","1985-11-28",1985,11,332,0,72000,35200,107200
"TR","1985-11-29",1985,11,333,56500,71700,35100,163300
"TR","1985-11-30",1985,11,334,36700,71700,35000,143400
"TR","1985-12-01",1985,12,335,161000,74200,34400,269600
"TR","1985-12-02",1985,12,336,104000,74900,34100,213000
"TR","1985-12-03",1985,12,337,68400,74700,34000,177100
"TR","1985-12-04",1985,12,338,0,72700,34200,106900
"TR","1985-12-05",1985,12,339,16600,71400,34300,122300
"TR","1985-12-06",1985,12,340,23400,70600,34400,128400
"TR","1985-12-07",1985,12,341,9700,69500,34500,113700
"TR","1985-12-08",1985,12,342,0,68400,34600,103000
"TR","1985-12-09",1985,12,343,0,67500,34800,102300
"TR","1985-12-10",1985,12,344,6060,66900,34800,107760
"TR","1985-12-11",1985,12,345,38000,67000,34700,139700
"TR","1985-12-12",1985,12,346,0,66300,34700,101000
"TR","1985-12-13",1985,12,347,0,65700,34800,100500
"TR","1985-12-14",1985,12,348,0,65200,34800,1e+05
"TR","1985-12-15",1985,12,349,0,64800,34800,99600
"TR","1985-12-16",1985,12,350,6060,64600,34800,105460
"TR","1985-12-17",1985,12,351,0,64200,34800,99000
"TR","1985-12-18",1985,12,352,3370,63900,34800,102070
"TR","1985-12-19",1985,12,353,0,63600,34800,98400
"TR","1985-12-20",1985,12,354,0,63300,34700,98000
"TR","1985-12-21",1985,12,355,0,63100,34700,97800
"TR","1985-12-22",1985,12,356,2250,62900,34700,99850
"TR","1985-12-23",1985,12,357,31600,63400,34500,129500
"TR","1985-12-24",1985,12,358,2890,63000,34500,100390
"TR","1985-12-25",1985,12,359,24300,63400,34400,122100
"TR","1985-12-26",1985,12,360,0,62900,34300,97200
"TR","1985-12-27",1985,12,361,8110,62700,34300,105110
"TR","1985-12-28",1985,12,362,6890,62500,34300,103690
"TR","1985-12-29",1985,12,363,0,62200,34300,96500
"TR","1985-12-30",1985,12,364,1210,61800,34200,97210
"TR","1985-12-31",1985,12,365,0,61500,34200,95700
"TR","1986-01-01",1986,1,1,0,61200,34200,95400
"TR","1986-01-02",1986,1,2,0,61000,34200,95200
"TR","1986-01-03",1986,1,3,0,60800,34100,94900
"TR","1986-01-04",1986,1,4,0,60500,34100,94600
"TR","1986-01-05",1986,1,5,76300,62200,33700,172200
"TR","1986-01-06",1986,1,6,0,61600,33600,95200
"TR","1986-01-07",1986,1,7,0,61100,33700,94800
"TR","1986-01-08",1986,1,8,0,60700,33700,94400
"TR","1986-01-09",1986,1,9,0,60300,33700,94000
"TR","1986-01-10",1986,1,10,0,59900,33700,93600
"TR","1986-01-11",1986,1,11,0,59500,33700,93200
"TR","1986-01-12",1986,1,12,0,59200,33700,92900
"TR","1986-01-13",1986,1,13,29300,59600,33500,122400
"TR","1986-01-14",1986,1,14,8090,59400,33400,100890
"TR","1986-01-15",1986,1,15,16200,59500,33400,109100
"TR","1986-01-16",1986,1,16,0,59200,33300,92500
"TR","1986-01-17",1986,1,17,0,58800,33300,92100
"TR","1986-01-18",1986,1,18,0,58400,33300,91700
"TR","1986-01-19",1986,1,19,60200,59900,33000,153100
"TR","1986-01-20",1986,1,20,2020,59300,33000,94320
"TR","1986-01-21",1986,1,21,0,58800,33000,91800
"TR","1986-01-22",1986,1,22,0,58300,33000,91300
"TR","1986-01-23",1986,1,23,126000,61100,32500,219600
"TR","1986-01-24",1986,1,24,0,60300,32300,92600
"TR","1986-01-25",1986,1,25,3750,59600,32400,95750
"TR","1986-01-26",1986,1,26,90000,61100,32100,183200
"TR","1986-01-27",1986,1,27,6070,60300,32000,98370
"TR","1986-01-28",1986,1,28,11600,59700,32100,103400
"TR","1986-01-29",1986,1,29,0,59000,32200,91200
"TR","1986-01-30",1986,1,30,7110,58700,32200,98010
"TR","1986-01-31",1986,1,31,0,58100,32200,90300
"TR","1986-02-01",1986,2,32,0,57700,32200,89900
"TR","1986-02-02",1986,2,33,81700,59200,31900,172800
"TR","1986-02-03",1986,2,34,0,58500,31800,90300
"TR","1986-02-04",1986,2,35,0,57800,31900,89700
"TR","1986-02-05",1986,2,36,0,57300,32000,89300
"TR","1986-02-06",1986,2,37,0,56800,32000,88800
"TR","1986-02-07",1986,2,38,0,56400,32000,88400
"TR","1986-02-08",1986,2,39,0,56100,32000,88100
"TR","1986-02-09",1986,2,40,0,55900,32000,87900
"TR","1986-02-10",1986,2,41,0,55700,32000,87700
"TR","1986-02-11",1986,2,42,0,55500,32000,87500
"TR","1986-02-12",1986,2,43,0,55300,32000,87300
"TR","1986-02-13",1986,2,44,0,55200,31900,87100
"TR","1986-02-14",1986,2,45,0,55000,31900,86900
"TR","1986-02-15",1986,2,46,11400,55200,31800,98400
"TR","1986-02-16",1986,2,47,0,55000,31800,86800
"TR","1986-02-17",1986,2,48,0,54800,31800,86600
"TR","1986-02-18",1986,2,49,0,54600,31700,86300
"TR","1986-02-19",1986,2,50,0,54300,31700,86000
"TR","1986-02-20",1986,2,51,0,54100,31700,85800
"TR","1986-02-21",1986,2,52,106000,56400,31200,193600
"TR","1986-02-22",1986,2,53,0,55800,31100,86900
"TR","1986-02-23",1986,2,54,13500,55500,31100,100100
"TR","1986-02-24",1986,2,55,19500,55600,31100,106200
"TR","1986-02-25",1986,2,56,0,55100,31100,86200
"TR","1986-02-26",1986,2,57,0,54600,31100,85700
"TR","1986-02-27",1986,2,58,41800,55200,31000,128000
"TR","1986-02-28",1986,2,59,0,54700,31000,85700
"TR","1986-03-01",1986,3,60,0,54300,31000,85300
"TR","1986-03-02",1986,3,61,0,53800,31000,84800
"TR","1986-03-03",1986,3,62,0,53200,31100,84300
"TR","1986-03-04",1986,3,63,0,52900,31200,84100
"TR","1986-03-05",1986,3,64,4140,52700,31200,88040
"TR","1986-03-06",1986,3,65,22900,52600,31100,106600
"TR","1986-03-07",1986,3,66,51200,53500,30800,135500
"TR","1986-03-08",1986,3,67,11200,53500,30700,95400
"TR","1986-03-09",1986,3,68,0,53200,30700,83900
"TR","1986-03-10",1986,3,69,2070,52800,30800,85670
"TR","1986-03-11",1986,3,70,182000,56900,30000,268900
"TR","1986-03-12",1986,3,71,19800,56100,29800,105700
"TR","1986-03-13",1986,3,72,0,54600,30000,84600
"TR","1986-03-14",1986,3,73,24800,53900,30200,108900
"TR","1986-03-15",1986,3,74,94000,56000,29800,179800
"TR","1986-03-16",1986,3,75,4460,54800,29800,89060
"TR","1986-03-17",1986,3,76,0,53500,30000,83500
"TR","1986-03-18",1986,3,77,0,52600,30200,82800
"TR","1986-03-19",1986,3,78,168000,55600,29500,253100
"TR","1986-03-20",1986,3,79,310000,62600,28300,400900
"TR","1986-03-21",1986,3,80,0,60300,28200,88500
"TR","1986-03-22",1986,3,81,0,58300,28600,86900
"TR","1986-03-23",1986,3,82,0,56500,28900,85400
"TR","1986-03-24",1986,3,83,0,54700,29200,83900
"TR","1986-03-25",1986,3,84,0,53500,29400,82900
"TR","1986-03-26",1986,3,85,0,52500,29600,82100
"TR","1986-03-27",1986,3,86,0,52100,29700,81800
"TR","1986-03-28",1986,3,87,0,51900,29800,81700
"TR","1986-03-29",1986,3,88,0,53300,30000,83300
"TR","1986-03-30",1986,3,89,0,56400,31900,88300
"TR","1986-03-31",1986,3,90,0,60600,46500,107100
"TR","1986-04-01",1986,4,91,0,64300,47600,111900
"TR","1986-04-02",1986,4,92,47000,381000,571000,999000
"TR","1986-04-03",1986,4,93,0,113000,37900,150900
"TR","1986-04-04",1986,4,94,7600,110000,54900,172500
"TR","1986-04-05",1986,4,95,32800,106000,52800,191600
"TR","1986-04-06",1986,4,96,117000,111000,71200,299200
"TR","1986-04-07",1986,4,97,92200,116000,44600,252800
"TR","1986-04-08",1986,4,98,0,98200,31000,129200
"TR","1986-04-09",1986,4,99,15200,94000,30600,139800
"TR","1986-04-10",1986,4,100,0,89800,30600,120400
"TR","1986-04-11",1986,4,101,0,86500,30900,117400
"TR","1986-04-12",1986,4,102,0,83600,31100,114700
"TR","1986-04-13",1986,4,103,0,79100,31100,110200
"TR","1986-04-14",1986,4,104,0,74600,31200,105800
"TR","1986-04-15",1986,4,105,13700,71500,31300,116500
"TR","1986-04-16",1986,4,106,153000,76700,33000,262700
"TR","1986-04-17",1986,4,107,4820,71000,31900,107720
"TR","1986-04-18",1986,4,108,0,67500,31900,99400
"TR","1986-04-19",1986,4,109,0,64800,32000,96800
"TR","1986-04-20",1986,4,110,16500,63200,31900,111600
"TR","1986-04-21",1986,4,111,21500,62200,31900,115600
"TR","1986-04-22",1986,4,112,8340,60900,31700,100940
"TR","1986-04-23",1986,4,113,0,59400,31600,91000
"TR","1986-04-24",1986,4,114,0,58300,31800,90100
"TR","1986-04-25",1986,4,115,0,57200,31800,89000
"TR","1986-04-26",1986,4,116,0,56200,31900,88100
"TR","1986-04-27",1986,4,117,206000,67100,35100,308200
"TR","1986-04-28",1986,4,118,83600,66700,33200,183500
"TR","1986-04-29",1986,4,119,21300,63200,32000,116500
"TR","1986-04-30",1986,4,120,161000,68800,37200,267000
"TR","1986-05-01",1986,5,121,72600,67400,33100,173100
"TR","1986-05-02",1986,5,122,2800,63300,31900,98000
"TR","1986-05-03",1986,5,123,2390,60600,31600,94590
"TR","1986-05-04",1986,5,124,0,59100,31400,90500
"TR","1986-05-05",1986,5,125,0,57400,31700,89100
"TR","1986-05-06",1986,5,126,0,56000,31400,87400
"TR","1986-05-07",1986,5,127,0,54900,31300,86200
"TR","1986-05-08",1986,5,128,0,54100,31500,85600
"TR","1986-05-09",1986,5,129,0,53500,31700,85200
"TR","1986-05-10",1986,5,130,0,53200,31800,85000
"TR","1986-05-11",1986,5,131,2390,52300,31700,86390
"TR","1986-05-12",1986,5,132,20000,51700,31500,103200
"TR","1986-05-13",1986,5,133,31500,51500,31500,114500
"TR","1986-05-14",1986,5,134,33300,51400,31400,116100
"TR","1986-05-15",1986,5,135,50200,51600,31500,133300
"TR","1986-05-16",1986,5,136,0,50700,31200,81900
"TR","1986-05-17",1986,5,137,0,50100,31200,81300
"TR","1986-05-18",1986,5,138,0,49500,31100,80600
"TR","1986-05-19",1986,5,139,0,49100,30900,80000
"TR","1986-05-20",1986,5,140,0,48800,30900,79700
"TR","1986-05-21",1986,5,141,0,48400,30900,79300
"TR","1986-05-22",1986,5,142,0,47900,30900,78800
"TR","1986-05-23",1986,5,143,0,47500,30700,78200
"TR","1986-05-24",1986,5,144,14600,47300,30700,92600
"TR","1986-05-25",1986,5,145,0,47000,30600,77600
"TR","1986-05-26",1986,5,146,24800,47100,30600,102500
"TR","1986-05-27",1986,5,147,0,46700,30500,77200
"TR","1986-05-28",1986,5,148,0,46400,30600,77000
"TR","1986-05-29",1986,5,149,0,45800,30700,76500
"TR","1986-05-30",1986,5,150,0,45000,30700,75700
"TR","1986-05-31",1986,5,151,0,44400,30700,75100
"TR","1986-06-01",1986,6,152,0,43900,30700,74600
"TR","1986-06-02",1986,6,153,0,43400,30900,74300
"TR","1986-06-03",1986,6,154,0,43100,30700,73800
"TR","1986-06-04",1986,6,155,0,43000,30700,73700
"TR","1986-06-05",1986,6,156,2210,42800,30700,75710
"TR","1986-06-06",1986,6,157,0,42500,30600,73100
"TR","1986-06-07",1986,6,158,0,42300,30600,72900
"TR","1986-06-08",1986,6,159,46400,42700,30500,119600
"TR","1986-06-09",1986,6,160,56700,43300,30400,130400
"TR","1986-06-10",1986,6,161,0,42700,30200,72900
"TR","1986-06-11",1986,6,162,19900,42700,30300,92900
"TR","1986-06-12",1986,6,163,204000,46200,30400,280600
"TR","1986-06-13",1986,6,164,244000,50000,30200,324200
"TR","1986-06-14",1986,6,165,0,47600,29200,76800
"TR","1986-06-15",1986,6,166,0,46900,29600,76500
"TR","1986-06-16",1986,6,167,0,46100,29800,75900
"TR","1986-06-17",1986,6,168,0,45500,30000,75500
"TR","1986-06-18",1986,6,169,0,45000,30000,75000
"TR","1986-06-19",1986,6,170,0,44600,30100,74700
"TR","1986-06-20",1986,6,171,827000,72400,34700,934100
"TR","1986-06-21",1986,6,172,11900,58500,27600,98000
"TR","1986-06-22",1986,6,173,165000,61900,31600,258500
"TR","1986-06-23",1986,6,174,176000,64600,34000,274600
"TR","1986-06-24",1986,6,175,88800,61900,28600,179300
"TR","1986-06-25",1986,6,176,134000,65100,34400,233500
"TR","1986-06-26",1986,6,177,50800,62000,28700,141500
"TR","1986-06-27",1986,6,178,40000,59700,29000,128700
"TR","1986-06-28",1986,6,179,493000,86500,54300,633800
"TR","1986-06-29",1986,6,180,0,72800,27600,100400
"TR","1986-06-30",1986,6,181,0,67000,28000,95000
"TR","1986-07-01",1986,7,182,0,62200,28200,90400
"TR","1986-07-02",1986,7,183,0,57600,28200,85800
"TR","1986-07-03",1986,7,184,0,53800,28200,82000
"TR","1986-07-04",1986,7,185,0,50800,28300,79100
"TR","1986-07-05",1986,7,186,154000,53000,28600,235600
"TR","1986-07-06",1986,7,187,181000,57300,29200,267500
"TR","1986-07-07",1986,7,188,48300,54300,28500,131100
"TR","1986-07-08",1986,7,189,0,51000,28200,79200
"TR","1986-07-09",1986,7,190,0,49700,28200,77900
"TR","1986-07-10",1986,7,191,0,48600,28100,76700
"TR","1986-07-11",1986,7,192,0,47700,28100,75800
"TR","1986-07-12",1986,7,193,102000,48700,28200,178900
"TR","1986-07-13",1986,7,194,318000,55200,29400,402600
"TR","1986-07-14",1986,7,195,239000,62500,29900,331400
"TR","1986-07-15",1986,7,196,1510,56300,27600,85410
"TR","1986-07-16",1986,7,197,12600,53100,27800,93500
"TR","1986-07-17",1986,7,198,65000,52600,28300,145900
"TR","1986-07-18",1986,7,199,0,50300,27900,78200
"TR","1986-07-19",1986,7,200,0,49100,28000,77100
"TR","1986-07-20",1986,7,201,545000,72000,44100,661100
"TR","1986-07-21",1986,7,202,31600,61000,27000,119600
"TR","1986-07-22",1986,7,203,0,56200,27100,83300
"TR","1986-07-23",1986,7,204,0,52500,27300,79800
"TR","1986-07-24",1986,7,205,0,50400,27300,77700
"TR","1986-07-25",1986,7,206,0,49200,27300,76500
"TR","1986-07-26",1986,7,207,269000,54800,28600,352400
"TR","1986-07-27",1986,7,208,0,51300,27300,78600
"TR","1986-07-28",1986,7,209,108000,52200,27800,188000
"TR","1986-07-29",1986,7,210,34400,51000,27600,113000
"TR","1986-07-30",1986,7,211,0,49300,27400,76700
"TR","1986-07-31",1986,7,212,11200,48300,27500,87000
"TR","1986-08-01",1986,8,213,0,47300,27400,74700
"TR","1986-08-02",1986,8,214,37900,47100,27500,112500
"TR","1986-08-03",1986,8,215,364000,56100,29900,450000
"TR","1986-08-04",1986,8,216,35300,52400,28000,115700
"TR","1986-08-05",1986,8,217,0,50500,28200,78700
"TR","1986-08-06",1986,8,218,417000,69200,30800,517000
"TR","1986-08-07",1986,8,219,15900,58100,27400,101400
"TR","1986-08-08",1986,8,220,97000,57600,28200,182800
"TR","1986-08-09",1986,8,221,212000,66400,35800,314200
"TR","1986-08-10",1986,8,222,12600,58900,27700,99200
"TR","1986-08-11",1986,8,223,143000,64100,33100,240200
"TR","1986-08-12",1986,8,224,13100,58900,28100,100100
"TR","1986-08-13",1986,8,225,0,55200,28200,83400
"TR","1986-08-14",1986,8,226,0,52300,28500,80800
"TR","1986-08-15",1986,8,227,101000,53900,29100,184000
"TR","1986-08-16",1986,8,228,24300,52100,28900,105300
"TR","1986-08-17",1986,8,229,10500,50800,28800,90100
"TR","1986-08-18",1986,8,230,135000,52900,29900,217800
"TR","1986-08-19",1986,8,231,0,50800,29000,79800
"TR","1986-08-20",1986,8,232,0,49800,29100,78900
"TR","1986-08-21",1986,8,233,14800,49000,29000,92800
"TR","1986-08-22",1986,8,234,12900,48400,29000,90300
"TR","1986-08-23",1986,8,235,82200,49500,29100,160800
"TR","1986-08-24",1986,8,236,254000,58200,30900,343100
"TR","1986-08-25",1986,8,237,0,52500,28700,81200
"TR","1986-08-26",1986,8,238,58800,52300,29200,140300
"TR","1986-08-27",1986,8,239,6320,50700,29000,86020
"TR","1986-08-28",1986,8,240,6270,49700,29000,84970
"TR","1986-08-29",1986,8,241,0,48800,28900,77700
"TR","1986-08-30",1986,8,242,0,48300,28900,77200
"TR","1986-08-31",1986,8,243,0,47700,28900,76600
"TR","1986-09-01",1986,9,244,19100,47300,28900,95300
"TR","1986-09-02",1986,9,245,0,46400,28900,75300
"TR","1986-09-03",1986,9,246,124000,48300,29300,201600
"TR","1986-09-04",1986,9,247,28200,47300,29000,104500
"TR","1986-09-05",1986,9,248,298000,54300,30900,383200
"TR","1986-09-06",1986,9,249,10600,50200,28700,89500
"TR","1986-09-07",1986,9,250,0,48900,28800,77700
"TR","1986-09-08",1986,9,251,0,48300,29000,77300
"TR","1986-09-09",1986,9,252,0,47600,29000,76600
"TR","1986-09-10",1986,9,253,0,46800,29000,75800
"TR","1986-09-11",1986,9,254,166000,49900,29900,245800
"TR","1986-09-12",1986,9,255,160000,53400,30400,243800
"TR","1986-09-13",1986,9,256,48200,51600,29000,128800
"TR","1986-09-14",1986,9,257,48100,51400,29200,128700
"TR","1986-09-15",1986,9,258,11900,50300,28900,91100
"TR","1986-09-16",1986,9,259,294000,67300,43200,404500
"TR","1986-09-17",1986,9,260,27000,59800,29700,116500
"TR","1986-09-18",1986,9,261,37000,57300,28500,122800
"TR","1986-09-19",1986,9,262,61900,57700,31400,151000
"TR","1986-09-20",1986,9,263,30800,55300,28700,114800
"TR","1986-09-21",1986,9,264,36500,54200,28900,119600
"TR","1986-09-22",1986,9,265,31700,53400,29000,114100
"TR","1986-09-23",1986,9,266,350000,75800,52700,478500
"TR","1986-09-24",1986,9,267,0,64000,28300,92300
"TR","1986-09-25",1986,9,268,0,59200,28100,87300
"TR","1986-09-26",1986,9,269,196000,68300,33300,297600
"TR","1986-09-27",1986,9,270,30000,66200,32700,128900
"TR","1986-09-28",1986,9,271,113000,72000,37300,222300
"TR","1986-09-29",1986,9,272,0,65500,28400,93900
"TR","1986-09-30",1986,9,273,67700,65900,29900,163500
"TR","1986-10-01",1986,10,274,0,62000,28500,90500
"TR","1986-10-02",1986,10,275,0,58900,28700,87600
"TR","1986-10-03",1986,10,276,0,56000,28700,84700
"TR","1986-10-04",1986,10,277,73800,57400,28800,160000
"TR","1986-10-05",1986,10,278,3220,55700,28900,87820
"TR","1986-10-06",1986,10,279,11300,54300,28900,94500
"TR","1986-10-07",1986,10,280,0,52600,28900,81500
"TR","1986-10-08",1986,10,281,3470,51500,29000,83970
"TR","1986-10-09",1986,10,282,38100,53300,29000,120400
"TR","1986-10-10",1986,10,283,0,52300,29000,81300
"TR","1986-10-11",1986,10,284,0,51300,29100,80400
"TR","1986-10-12",1986,10,285,128000,57100,29500,214600
"TR","1986-10-13",1986,10,286,680000,107000,80000,867000
"TR","1986-10-14",1986,10,287,23000,86800,30600,140400
"TR","1986-10-15",1986,10,288,137000,85000,29800,251800
"TR","1986-10-16",1986,10,289,31600,84700,34800,151100
"TR","1986-10-17",1986,10,290,27400,77900,31600,136900
"TR","1986-10-18",1986,10,291,0,72000,28300,100300
"TR","1986-10-19",1986,10,292,0,68000,28800,96800
"TR","1986-10-20",1986,10,293,0,64800,29100,93900
"TR","1986-10-21",1986,10,294,0,62000,29300,91300
"TR","1986-10-22",1986,10,295,0,60000,29500,89500
"TR","1986-10-23",1986,10,296,0,58400,29700,88100
"TR","1986-10-24",1986,10,297,39200,59900,29800,128900
"TR","1986-10-25",1986,10,298,0,58300,29900,88200
"TR","1986-10-26",1986,10,299,0,56500,30000,86500
"TR","1986-10-27",1986,10,300,0,55600,30100,85700
"TR","1986-10-28",1986,10,301,0,54800,30100,84900
"TR","1986-10-29",1986,10,302,0,54100,30200,84300
"TR","1986-10-30",1986,10,303,3470,53500,30300,87270
"TR","1986-10-31",1986,10,304,0,53000,30200,83200
"TR","1986-11-01",1986,11,305,83000,56300,30500,169800
"TR","1986-11-02",1986,11,306,40000,57400,30400,127800
"TR","1986-11-03",1986,11,307,0,56000,30300,86300
"TR","1986-11-04",1986,11,308,59000,56600,30300,145900
"TR","1986-11-05",1986,11,309,0,55600,30300,85900
"TR","1986-11-06",1986,11,310,2000,55400,30800,88200
"TR","1986-11-07",1986,11,311,0,54000,30600,84600
"TR","1986-11-08",1986,11,312,0,52700,30600,83300
"TR","1986-11-09",1986,11,313,132000,58600,31300,221900
"TR","1986-11-10",1986,11,314,10500,56900,30400,97800
"TR","1986-11-11",1986,11,315,4010,55700,30300,90010
"TR","1986-11-12",1986,11,316,2530,55200,30300,88030
"TR","1986-11-13",1986,11,317,0,54800,30300,85100
"TR","1986-11-14",1986,11,318,0,54500,30300,84800
"TR","1986-11-15",1986,11,319,0,54200,30300,84500
"TR","1986-11-16",1986,11,320,40000,54800,30200,125000
"TR","1986-11-17",1986,11,321,34000,55000,30100,119100
"TR","1986-11-18",1986,11,322,0,54300,30200,84500
"TR","1986-11-19",1986,11,323,0,53900,30300,84200
"TR","1986-11-20",1986,11,324,0,53600,30300,83900
"TR","1986-11-21",1986,11,325,179000,57700,29500,266200
"TR","1986-11-22",1986,11,326,0,56500,29400,85900
"TR","1986-11-23",1986,11,327,0,55400,29700,85100
"TR","1986-11-24",1986,11,328,62800,56400,29500,148700
"TR","1986-11-25",1986,11,329,6480,55600,29500,91580
"TR","1986-11-26",1986,11,330,0,54600,29700,84300
"TR","1986-11-27",1986,11,331,0,54200,30200,84400
"TR","1986-11-28",1986,11,332,0,53700,30200,83900
"TR","1986-11-29",1986,11,333,0,53600,30400,84000
"TR","1986-11-30",1986,11,334,0,53000,30300,83300
"TR","1986-12-01",1986,12,335,0,52600,30200,82800
"TR","1986-12-02",1986,12,336,0,52500,30200,82700
"TR","1986-12-03",1986,12,337,16900,52600,30000,99500
"TR","1986-12-04",1986,12,338,59700,54100,29700,143500
"TR","1986-12-05",1986,12,339,12400,54000,29600,96000
"TR","1986-12-06",1986,12,340,0,53600,29600,83200
"TR","1986-12-07",1986,12,341,0,53200,29600,82800
"TR","1986-12-08",1986,12,342,0,52900,29600,82500
"TR","1986-12-09",1986,12,343,0,52600,29600,82200
"TR","1986-12-10",1986,12,344,12900,52600,29600,95100
"TR","1986-12-11",1986,12,345,0,52400,29500,81900
"TR","1986-12-12",1986,12,346,26400,52800,29400,108600
"TR","1986-12-13",1986,12,347,3640,52600,29400,85640
"TR","1986-12-14",1986,12,348,0,52300,29400,81700
"TR","1986-12-15",1986,12,349,1210,52100,29400,82710
"TR","1986-12-16",1986,12,350,0,51800,29400,81200
"TR","1986-12-17",1986,12,351,0,51600,29400,81000
"TR","1986-12-18",1986,12,352,0,51400,29400,80800
"TR","1986-12-19",1986,12,353,0,51300,29300,80600
"TR","1986-12-20",1986,12,354,0,51300,29300,80600
"TR","1986-12-21",1986,12,355,0,51200,29300,80500
"TR","1986-12-22",1986,12,356,0,51100,29300,80400
"TR","1986-12-23",1986,12,357,0,51000,29200,80200
"TR","1986-12-24",1986,12,358,0,50900,29200,80100
"TR","1986-12-25",1986,12,359,0,50800,29200,80000
"TR","1986-12-26",1986,12,360,0,50700,29200,79900
"TR","1986-12-27",1986,12,361,0,50600,29100,79700
"TR","1986-12-28",1986,12,362,0,50500,29100,79600
"TR","1986-12-29",1986,12,363,0,50400,29100,79500
"TR","1986-12-30",1986,12,364,0,50300,29100,79400
"TR","1986-12-31",1986,12,365,0,50200,29000,79200
"TR","1987-01-01",1987,1,1,0,50100,29000,79100
"TR","1987-01-02",1987,1,2,0,50000,29000,79000
"TR","1987-01-03",1987,1,3,0,49900,29000,78900
"TR","1987-01-04",1987,1,4,0,49800,29000,78800
"TR","1987-01-05",1987,1,5,0,49600,29000,78600
"TR","1987-01-06",1987,1,6,0,49500,28900,78400
"TR","1987-01-07",1987,1,7,0,49400,28900,78300
"TR","1987-01-08",1987,1,8,46400,49600,28700,124700
"TR","1987-01-09",1987,1,9,0,49500,28600,78100
"TR","1987-01-10",1987,1,10,0,49400,28600,78000
"TR","1987-01-11",1987,1,11,0,49300,28600,77900
"TR","1987-01-12",1987,1,12,0,49200,28600,77800
"TR","1987-01-13",1987,1,13,0,49100,28600,77700
"TR","1987-01-14",1987,1,14,0,49100,28600,77700
"TR","1987-01-15",1987,1,15,0,49100,28600,77700
"TR","1987-01-16",1987,1,16,5630,49000,28600,83230
"TR","1987-01-17",1987,1,17,0,48600,28500,77100
"TR","1987-01-18",1987,1,18,0,48600,28500,77100
"TR","1987-01-19",1987,1,19,18100,48600,28300,95000
"TR","1987-01-20",1987,1,20,0,48600,28300,76900
"TR","1987-01-21",1987,1,21,148000,49200,27700,224900
"TR","1987-01-22",1987,1,22,0,49100,27500,76600
"TR","1987-01-23",1987,1,23,39600,49300,27500,116400
"TR","1987-01-24",1987,1,24,0,49200,27500,76700
"TR","1987-01-25",1987,1,25,0,49000,27600,76600
"TR","1987-01-26",1987,1,26,0,48900,27700,76600
"TR","1987-01-27",1987,1,27,0,48800,27700,76500
"TR","1987-01-28",1987,1,28,0,48600,27700,76300
"TR","1987-01-29",1987,1,29,5780,48500,27700,81980
"TR","1987-01-30",1987,1,30,41300,48600,27500,117400
"TR","1987-01-31",1987,1,31,221000,51800,26700,299500
"TR","1987-02-01",1987,2,32,0,50600,26600,77200
"TR","1987-02-02",1987,2,33,0,49800,26800,76600
"TR","1987-02-03",1987,2,34,0,49400,26900,76300
"TR","1987-02-04",1987,2,35,0,49200,27100,76300
"TR","1987-02-05",1987,2,36,0,49000,27100,76100
"TR","1987-02-06",1987,2,37,0,48800,27200,76000
"TR","1987-02-07",1987,2,38,0,48600,27200,75800
"TR","1987-02-08",1987,2,39,0,48400,27300,75700
"TR","1987-02-09",1987,2,40,19000,48300,27200,94500
"TR","1987-02-10",1987,2,41,0,48200,27200,75400
"TR","1987-02-11",1987,2,42,0,48000,27200,75200
"TR","1987-02-12",1987,2,43,0,47900,27200,75100
"TR","1987-02-13",1987,2,44,0,47700,27200,74900
"TR","1987-02-14",1987,2,45,0,47500,27200,74700
"TR","1987-02-15",1987,2,46,0,47400,27200,74600
"TR","1987-02-16",1987,2,47,0,47300,27200,74500
"TR","1987-02-17",1987,2,48,0,47100,27200,74300
"TR","1987-02-18",1987,2,49,0,47000,27200,74200
"TR","1987-02-19",1987,2,50,0,46900,27200,74100
"TR","1987-02-20",1987,2,51,0,46800,27200,74000
"TR","1987-02-21",1987,2,52,0,46600,27200,73800
"TR","1987-02-22",1987,2,53,0,46500,27200,73700
"TR","1987-02-23",1987,2,54,37400,46800,27000,111200
"TR","1987-02-24",1987,2,55,6080,47900,27100,81080
"TR","1987-02-25",1987,2,56,0,47000,27000,74000
"TR","1987-02-26",1987,2,57,0,46600,27000,73600
"TR","1987-02-27",1987,2,58,0,46300,27000,73300
"TR","1987-02-28",1987,2,59,0,46200,27000,73200
"TR","1987-03-01",1987,3,60,0,46500,27000,73500
"TR","1987-03-02",1987,3,61,187000,47900,26300,261200
"TR","1987-03-03",1987,3,62,55500,48000,25900,129400
"TR","1987-03-04",1987,3,63,0,47500,26100,73600
"TR","1987-03-05",1987,3,64,0,47400,26300,73700
"TR","1987-03-06",1987,3,65,0,48000,26400,74400
"TR","1987-03-07",1987,3,66,0,49400,27100,76500
"TR","1987-03-08",1987,3,67,0,51000,36600,87600
"TR","1987-03-09",1987,3,68,0,51900,41800,93700
"TR","1987-03-10",1987,3,69,0,49000,28300,77300
"TR","1987-03-11",1987,3,70,0,48600,27500,76100
"TR","1987-03-12",1987,3,71,0,48400,27300,75700
"TR","1987-03-13",1987,3,72,0,48000,27400,75400
"TR","1987-03-14",1987,3,73,0,47700,27400,75100
"TR","1987-03-15",1987,3,74,4460,47500,27400,79360
"TR","1987-03-16",1987,3,75,0,47200,27400,74600
"TR","1987-03-17",1987,3,76,0,47000,27400,74400
"TR","1987-03-18",1987,3,77,0,47000,27500,74500
"TR","1987-03-19",1987,3,78,0,46600,30300,76900
"TR","1987-03-20",1987,3,79,0,46500,33600,80100
"TR","1987-03-21",1987,3,80,0,45700,26800,72500
"TR","1987-03-22",1987,3,81,0,45000,26500,71500
"TR","1987-03-23",1987,3,82,0,44400,26200,70600
"TR","1987-03-24",1987,3,83,0,43900,26000,69900
"TR","1987-03-25",1987,3,84,0,43500,26200,69700
"TR","1987-03-26",1987,3,85,5590,43200,26400,75190
"TR","1987-03-27",1987,3,86,36700,43600,26500,106800
"TR","1987-03-28",1987,3,87,4460,42900,26300,73660
"TR","1987-03-29",1987,3,88,0,42500,26400,68900
"TR","1987-03-30",1987,3,89,42900,42800,26300,112000
"TR","1987-03-31",1987,3,90,45400,43100,26100,114600
"TR","1987-04-01",1987,4,91,0,43000,26100,69100
"TR","1987-04-02",1987,4,92,244000,44500,25300,313800
"TR","1987-04-03",1987,4,93,28300,44700,25100,98100
"TR","1987-04-04",1987,4,94,0,44500,25400,69900
"TR","1987-04-05",1987,4,95,0,44300,25600,69900
"TR","1987-04-06",1987,4,96,0,45300,26100,71400
"TR","1987-04-07",1987,4,97,0,46000,27100,73100
"TR","1987-04-08",1987,4,98,0,44800,34800,79600
"TR","1987-04-09",1987,4,99,0,44100,26400,70500
"TR","1987-04-10",1987,4,100,0,43500,26300,69800
"TR","1987-04-11",1987,4,101,0,43300,26200,69500
"TR","1987-04-12",1987,4,102,22100,43600,26000,91700
"TR","1987-04-13",1987,4,103,0,43100,25800,68900
"TR","1987-04-14",1987,4,104,0,42800,25800,68600
"TR","1987-04-15",1987,4,105,26900,43200,25700,95800
"TR","1987-04-16",1987,4,106,29300,43300,25700,98300
"TR","1987-04-17",1987,4,107,0,42500,25500,68000
"TR","1987-04-18",1987,4,108,0,42300,25600,67900
"TR","1987-04-19",1987,4,109,0,42000,25800,67800
"TR","1987-04-20",1987,4,110,0,41700,25900,67600
"TR","1987-04-21",1987,4,111,0,41400,26100,67500
"TR","1987-04-22",1987,4,112,10900,41400,26100,78400
"TR","1987-04-23",1987,4,113,0,41100,26100,67200
"TR","1987-04-24",1987,4,114,2880,41000,26200,70080
"TR","1987-04-25",1987,4,115,0,40800,26200,67000
"TR","1987-04-26",1987,4,116,173000,45100,27100,245200
"TR","1987-04-27",1987,4,117,0,42500,25700,68200
"TR","1987-04-28",1987,4,118,26900,42300,25800,95000
"TR","1987-04-29",1987,4,119,0,41500,25600,67100
"TR","1987-04-30",1987,4,120,0,41300,25600,66900
"TR","1987-05-01",1987,5,121,0,41200,25500,66700
"TR","1987-05-02",1987,5,122,11700,41300,25600,78600
"TR","1987-05-03",1987,5,123,0,40800,25800,66600
"TR","1987-05-04",1987,5,124,0,40500,26000,66500
"TR","1987-05-05",1987,5,125,0,40300,26200,66500
"TR","1987-05-06",1987,5,126,0,39900,26400,66300
"TR","1987-05-07",1987,5,127,0,39600,26600,66200
"TR","1987-05-08",1987,5,128,0,39200,26700,65900
"TR","1987-05-09",1987,5,129,0,38900,26800,65700
"TR","1987-05-10",1987,5,130,0,38300,27000,65300
"TR","1987-05-11",1987,5,131,31000,37400,26600,95000
"TR","1987-05-12",1987,5,132,19400,36900,26100,82400
"TR","1987-05-13",1987,5,133,0,36300,25900,62200
"TR","1987-05-14",1987,5,134,11100,35900,25800,72800
"TR","1987-05-15",1987,5,135,7180,35600,25700,68480
"TR","1987-05-16",1987,5,136,0,35100,25700,60800
"TR","1987-05-17",1987,5,137,26400,34800,25700,86900
"TR","1987-05-18",1987,5,138,0,34100,25700,59800
"TR","1987-05-19",1987,5,139,109000,35400,25600,170000
"TR","1987-05-20",1987,5,140,446000,44200,26000,516200
"TR","1987-05-21",1987,5,141,13800,40600,24300,78700
"TR","1987-05-22",1987,5,142,15500,40000,24500,80000
"TR","1987-05-23",1987,5,143,71100,40700,25000,136800
"TR","1987-05-24",1987,5,144,11900,39600,24600,76100
"TR","1987-05-25",1987,5,145,0,39100,24700,63800
"TR","1987-05-26",1987,5,146,0,38700,24800,63500
"TR","1987-05-27",1987,5,147,101000,39900,25200,166100
"TR","1987-05-28",1987,5,148,189000,42900,25400,257300
"TR","1987-05-29",1987,5,149,229000,45400,26200,300600
"TR","1987-05-30",1987,5,150,139000,45800,24500,209300
"TR","1987-05-31",1987,5,151,554000,68400,56500,678900
"TR","1987-06-01",1987,6,152,140000,62300,25700,228000
"TR","1987-06-02",1987,6,153,23500,56200,22500,102200
"TR","1987-06-03",1987,6,154,342000,69200,37400,448600
"TR","1987-06-04",1987,6,155,13000,59300,22400,94700
"TR","1987-06-05",1987,6,156,0,54300,22800,77100
"TR","1987-06-06",1987,6,157,80200,53400,23400,157000
"TR","1987-06-07",1987,6,158,0,49100,23400,72500
"TR","1987-06-08",1987,6,159,0,47000,23700,70700
"TR","1987-06-09",1987,6,160,0,45700,23800,69500
"TR","1987-06-10",1987,6,161,0,44800,23900,68700
"TR","1987-06-11",1987,6,162,0,44000,24000,68000
"TR","1987-06-12",1987,6,163,235000,47700,25100,307800
"TR","1987-06-13",1987,6,164,4770,45900,24300,74970
"TR","1987-06-14",1987,6,165,0,44700,24400,69100
"TR","1987-06-15",1987,6,166,0,43600,24600,68200
"TR","1987-06-16",1987,6,167,0,42400,24900,67300
"TR","1987-06-17",1987,6,168,0,41200,25100,66300
"TR","1987-06-18",1987,6,169,0,40400,25100,65500
"TR","1987-06-19",1987,6,170,4420,39800,25100,69320
"TR","1987-06-20",1987,6,171,0,39100,25200,64300
"TR","1987-06-21",1987,6,172,0,38500,25200,63700
"TR","1987-06-22",1987,6,173,50000,38700,25200,113900
"TR","1987-06-23",1987,6,174,40800,38700,25100,104600
"TR","1987-06-24",1987,6,175,0,37800,25100,62900
"TR","1987-06-25",1987,6,176,0,37200,25200,62400
"TR","1987-06-26",1987,6,177,44200,37200,25200,106600
"TR","1987-06-27",1987,6,178,80800,38100,25100,144000
"TR","1987-06-28",1987,6,179,53700,38300,24900,116900
"TR","1987-06-29",1987,6,180,0,37500,24800,62300
"TR","1987-06-30",1987,6,181,79800,38400,25000,143200
"TR","1987-07-01",1987,7,182,0,37500,24800,62300
"TR","1987-07-02",1987,7,183,0,36500,24900,61400
"TR","1987-07-03",1987,7,184,182000,38800,24800,245600
"TR","1987-07-04",1987,7,185,75500,38600,24300,138400
"TR","1987-07-05",1987,7,186,0,37300,24000,61300
"TR","1987-07-06",1987,7,187,0,36400,24200,60600
"TR","1987-07-07",1987,7,188,168000,38300,24300,230600
"TR","1987-07-08",1987,7,189,40600,37200,23900,101700
"TR","1987-07-09",1987,7,190,82000,37200,24000,143200
"TR","1987-07-10",1987,7,191,233000,40600,24200,297800
"TR","1987-07-11",1987,7,192,121000,40500,23600,185100
"TR","1987-07-12",1987,7,193,208000,42900,23900,274800
"TR","1987-07-13",1987,7,194,132000,42900,23300,198200
"TR","1987-07-14",1987,7,195,18500,41200,22800,82500
"TR","1987-07-15",1987,7,196,0,39900,22900,62800
"TR","1987-07-16",1987,7,197,0,39100,23200,62300
"TR","1987-07-17",1987,7,198,0,38200,23400,61600
"TR","1987-07-18",1987,7,199,0,37200,23500,60700
"TR","1987-07-19",1987,7,200,0,36100,23600,59700
"TR","1987-07-20",1987,7,201,182000,38100,23900,244000
"TR","1987-07-21",1987,7,202,37800,36900,23200,97900
"TR","1987-07-22",1987,7,203,207000,39700,23800,270500
"TR","1987-07-23",1987,7,204,0,37500,22900,60400
"TR","1987-07-24",1987,7,205,0,36200,23200,59400
"TR","1987-07-25",1987,7,206,296000,41400,24100,361500
"TR","1987-07-26",1987,7,207,1510,38700,22900,63110
"TR","1987-07-27",1987,7,208,0,37300,23100,60400
"TR","1987-07-28",1987,7,209,0,36000,23300,59300
"TR","1987-07-29",1987,7,210,2660,35000,23200,60860
"TR","1987-07-30",1987,7,211,0,34200,23300,57500
"TR","1987-07-31",1987,7,212,0,33400,23400,56800
"TR","1987-08-01",1987,8,213,5610,32800,23400,61810
"TR","1987-08-02",1987,8,214,110000,34100,23700,167800
"TR","1987-08-03",1987,8,215,165000,36000,23700,224700
"TR","1987-08-04",1987,8,216,0,34400,23400,57800
"TR","1987-08-05",1987,8,217,0,33500,23800,57300
"TR","1987-08-06",1987,8,218,0,32600,24100,56700
"TR","1987-08-07",1987,8,219,2660,32000,24200,58860
"TR","1987-08-08",1987,8,220,26700,31800,24300,82800
"TR","1987-08-09",1987,8,221,0,31100,24400,55500
"TR","1987-08-10",1987,8,222,109000,32400,24600,166000
"TR","1987-08-11",1987,8,223,25000,31900,24400,81300
"TR","1987-08-12",1987,8,224,0,31200,24400,55600
"TR","1987-08-13",1987,8,225,48500,31400,24500,104400
"TR","1987-08-14",1987,8,226,378000,38800,24900,441700
"TR","1987-08-15",1987,8,227,60300,35600,23600,119500
"TR","1987-08-16",1987,8,228,114000,36600,24000,174600
"TR","1987-08-17",1987,8,229,36100,35800,23900,95800
"TR","1987-08-18",1987,8,230,104000,36600,24300,164900
"TR","1987-08-19",1987,8,231,26600,35800,24000,86400
"TR","1987-08-20",1987,8,232,107000,37000,24600,168600
"TR","1987-08-21",1987,8,233,0,35700,24200,59900
"TR","1987-08-22",1987,8,234,0,34800,24400,59200
"TR","1987-08-23",1987,8,235,92600,35700,24800,153100
"TR","1987-08-24",1987,8,236,0,34700,24400,59100
"TR","1987-08-25",1987,8,237,0,34100,24600,58700
"TR","1987-08-26",1987,8,238,0,33600,24600,58200
"TR","1987-08-27",1987,8,239,0,33000,24600,57600
"TR","1987-08-28",1987,8,240,0,32400,24500,56900
"TR","1987-08-29",1987,8,241,0,32000,24500,56500
"TR","1987-08-30",1987,8,242,0,31500,24500,56000
"TR","1987-08-31",1987,8,243,136000,33600,24900,194500
"TR","1987-09-01",1987,9,244,48500,33600,24400,106500
"TR","1987-09-02",1987,9,245,9240,33100,24300,66640
"TR","1987-09-03",1987,9,246,6420,32700,24400,63520
"TR","1987-09-04",1987,9,247,0,32100,24400,56500
"TR","1987-09-05",1987,9,248,0,31600,24600,56200
"TR","1987-09-06",1987,9,249,0,31100,24700,55800
"TR","1987-09-07",1987,9,250,182000,33600,25100,240700
"TR","1987-09-08",1987,9,251,0,32200,24400,56600
"TR","1987-09-09",1987,9,252,21900,31800,24600,78300
"TR","1987-09-10",1987,9,253,0,31200,24600,55800
"TR","1987-09-11",1987,9,254,6600,30900,24700,62200
"TR","1987-09-12",1987,9,255,75100,31800,24700,131600
"TR","1987-09-13",1987,9,256,19000,31500,24500,75000
"TR","1987-09-14",1987,9,257,49700,31900,24600,106200
"TR","1987-09-15",1987,9,258,0,31300,24400,55700
"TR","1987-09-16",1987,9,259,0,30900,24500,55400
"TR","1987-09-17",1987,9,260,0,30400,24600,55000
"TR","1987-09-18",1987,9,261,119000,32200,24900,176100
"TR","1987-09-19",1987,9,262,73500,32700,24700,130900
"TR","1987-09-20",1987,9,263,61200,33200,24600,119000
"TR","1987-09-21",1987,9,264,4060,32500,24400,60960
"TR","1987-09-22",1987,9,265,43600,32900,24600,101100
"TR","1987-09-23",1987,9,266,834,32200,24400,57434
"TR","1987-09-24",1987,9,267,0,31600,24400,56000
"TR","1987-09-25",1987,9,268,0,31200,24500,55700
"TR","1987-09-26",1987,9,269,0,30800,24400,55200
"TR","1987-09-27",1987,9,270,0,30600,24400,55000
"TR","1987-09-28",1987,9,271,0,30200,24400,54600
"TR","1987-09-29",1987,9,272,0,29800,24500,54300
"TR","1987-09-30",1987,9,273,9240,29500,24500,63240
"TR","1987-10-01",1987,10,274,5830,29400,24400,59630
"TR","1987-10-02",1987,10,275,0,29300,24400,53700
"TR","1987-10-03",1987,10,276,363000,34600,24400,422000
"TR","1987-10-04",1987,10,277,0,34300,23500,57800
"TR","1987-10-05",1987,10,278,0,34300,23900,58200
"TR","1987-10-06",1987,10,279,13600,34000,24000,71600
"TR","1987-10-07",1987,10,280,123000,36100,24400,183500
"TR","1987-10-08",1987,10,281,77900,36600,23600,138100
"TR","1987-10-09",1987,10,282,0,36400,23500,59900
"TR","1987-10-10",1987,10,283,3220,35900,23600,62720
"TR","1987-10-11",1987,10,284,4960,35600,23600,64160
"TR","1987-10-12",1987,10,285,0,35300,23500,58800
"TR","1987-10-13",1987,10,286,0,35100,23600,58700
"TR","1987-10-14",1987,10,287,0,34900,23600,58500
"TR","1987-10-15",1987,10,288,0,34700,23600,58300
"TR","1987-10-16",1987,10,289,155000,38500,23800,217300
"TR","1987-10-17",1987,10,290,483000,50900,39600,573500
"TR","1987-10-18",1987,10,291,39700,45300,26200,111200
"TR","1987-10-19",1987,10,292,2670,44400,22000,69070
"TR","1987-10-20",1987,10,293,0,43500,21900,65400
"TR","1987-10-21",1987,10,294,23300,43300,22100,88700
"TR","1987-10-22",1987,10,295,128000,44400,23900,196300
"TR","1987-10-23",1987,10,296,54200,45400,28100,127700
"TR","1987-10-24",1987,10,297,93500,45300,22100,160900
"TR","1987-10-25",1987,10,298,9130,45700,27000,81830
"TR","1987-10-26",1987,10,299,0,44600,23800,68400
"TR","1987-10-27",1987,10,300,36400,44600,22100,103100
"TR","1987-10-28",1987,10,301,72200,45400,25900,143500
"TR","1987-10-29",1987,10,302,4960,44700,22900,72560
"TR","1987-10-30",1987,10,303,0,43800,22000,65800
"TR","1987-10-31",1987,10,304,0,43100,22200,65300
"TR","1987-11-01",1987,11,305,0,42500,22300,64800
"TR","1987-11-02",1987,11,306,0,41800,22300,64100
"TR","1987-11-03",1987,11,307,8560,41400,22300,72260
"TR","1987-11-04",1987,11,308,62400,42600,22200,127200
"TR","1987-11-05",1987,11,309,55500,43200,22400,121100
"TR","1987-11-06",1987,11,310,0,42300,22300,64600
"TR","1987-11-07",1987,11,311,0,41400,22300,63700
"TR","1987-11-08",1987,11,312,0,40800,22300,63100
"TR","1987-11-09",1987,11,313,0,40200,22300,62500
"TR","1987-11-10",1987,11,314,0,39900,22200,62100
"TR","1987-11-11",1987,11,315,0,39700,22100,61800
"TR","1987-11-12",1987,11,316,0,39500,22100,61600
"TR","1987-11-13",1987,11,317,0,39100,22200,61300
"TR","1987-11-14",1987,11,318,0,38900,22200,61100
"TR","1987-11-15",1987,11,319,0,38700,22100,60800
"TR","1987-11-16",1987,11,320,0,38400,22100,60500
"TR","1987-11-17",1987,11,321,42900,39000,22200,104100
"TR","1987-11-18",1987,11,322,288000,46400,26200,360600
"TR","1987-11-19",1987,11,323,210000,44200,24900,279100
"TR","1987-11-20",1987,11,324,6480,43400,21200,71080
"TR","1987-11-21",1987,11,325,0,42900,21300,64200
"TR","1987-11-22",1987,11,326,0,42600,21500,64100
"TR","1987-11-23",1987,11,327,0,42200,21700,63900
"TR","1987-11-24",1987,11,328,77800,42500,21500,141800
"TR","1987-11-25",1987,11,329,61600,42800,21300,125700
"TR","1987-11-26",1987,11,330,0,42400,21400,63800
"TR","1987-11-27",1987,11,331,0,42000,21600,63600
"TR","1987-11-28",1987,11,332,0,41600,21800,63400
"TR","1987-11-29",1987,11,333,0,41200,21900,63100
"TR","1987-11-30",1987,11,334,258000,47200,39000,344200
"TR","1987-12-01",1987,12,335,90300,45400,21500,157200
"TR","1987-12-02",1987,12,336,17800,45100,20800,83700
"TR","1987-12-03",1987,12,337,3460,44600,21000,69060
"TR","1987-12-04",1987,12,338,0,44300,21200,65500
"TR","1987-12-05",1987,12,339,2630,44000,21300,67930
"TR","1987-12-06",1987,12,340,0,43600,21500,65100
"TR","1987-12-07",1987,12,341,0,43200,21600,64800
"TR","1987-12-08",1987,12,342,0,42900,21700,64600
"TR","1987-12-09",1987,12,343,0,42500,21700,64200
"TR","1987-12-10",1987,12,344,253000,48600,33000,334600
"TR","1987-12-11",1987,12,345,33700,45700,21400,100800
"TR","1987-12-12",1987,12,346,18500,45400,21300,85200
"TR","1987-12-13",1987,12,347,58500,45900,23300,127700
"TR","1987-12-14",1987,12,348,2420,45400,21200,69020
"TR","1987-12-15",1987,12,349,0,45000,21400,66400
"TR","1987-12-16",1987,12,350,18400,44700,21500,84600
"TR","1987-12-17",1987,12,351,47200,44700,21400,113300
"TR","1987-12-18",1987,12,352,0,44400,21500,65900
"TR","1987-12-19",1987,12,353,19200,44000,21600,84800
"TR","1987-12-20",1987,12,354,47000,44000,21500,112500
"TR","1987-12-21",1987,12,355,106000,44400,21200,171600
"TR","1987-12-22",1987,12,356,0,44000,21300,65300
"TR","1987-12-23",1987,12,357,0,43700,21500,65200
"TR","1987-12-24",1987,12,358,0,43300,21600,64900
"TR","1987-12-25",1987,12,359,18000,43000,21700,82700
"TR","1987-12-26",1987,12,360,38700,43000,21600,103300
"TR","1987-12-27",1987,12,361,0,42700,21700,64400
"TR","1987-12-28",1987,12,362,0,42400,21800,64200
"TR","1987-12-29",1987,12,363,0,42100,22000,64100
"TR","1987-12-30",1987,12,364,0,41800,22000,63800
"TR","1987-12-31",1987,12,365,0,41600,22100,63700
"TR","1988-01-01",1988,1,1,37600,41600,22000,101200
"TR","1988-01-02",1988,1,2,6070,41400,22000,69470
"TR","1988-01-03",1988,1,3,0,41100,22100,63200
"TR","1988-01-04",1988,1,4,0,40900,22200,63100
"TR","1988-01-05",1988,1,5,0,40700,22200,62900
"TR","1988-01-06",1988,1,6,0,40500,22300,62800
"TR","1988-01-07",1988,1,7,0,40300,22300,62600
"TR","1988-01-08",1988,1,8,0,40100,22400,62500
"TR","1988-01-09",1988,1,9,0,39900,22400,62300
"TR","1988-01-10",1988,1,10,0,39800,22400,62200
"TR","1988-01-11",1988,1,11,0,39600,22400,62000
"TR","1988-01-12",1988,1,12,17500,39600,22400,79500
"TR","1988-01-13",1988,1,13,32000,39600,22300,93900
"TR","1988-01-14",1988,1,14,73400,40000,22000,135400
"TR","1988-01-15",1988,1,15,0,39900,22000,61900
"TR","1988-01-16",1988,1,16,4050,39700,22100,65850
"TR","1988-01-17",1988,1,17,0,39500,22200,61700
"TR","1988-01-18",1988,1,18,0,39300,22300,61600
"TR","1988-01-19",1988,1,19,0,39100,22400,61500
"TR","1988-01-20",1988,1,20,0,38900,22400,61300
"TR","1988-01-21",1988,1,21,122000,39700,21900,183600
"TR","1988-01-22",1988,1,22,26300,39700,21800,87800
"TR","1988-01-23",1988,1,23,3750,39600,21900,65250
"TR","1988-01-24",1988,1,24,22200,39600,21900,83700
"TR","1988-01-25",1988,1,25,6070,39400,22000,67470
"TR","1988-01-26",1988,1,26,4050,39300,22100,65450
"TR","1988-01-27",1988,1,27,8290,39200,22100,69590
"TR","1988-01-28",1988,1,28,0,39000,22200,61200
"TR","1988-01-29",1988,1,29,0,38900,22200,61100
"TR","1988-01-30",1988,1,30,0,38700,22300,61000
"TR","1988-01-31",1988,1,31,0,38500,22300,60800
"TR","1988-02-01",1988,2,32,8750,38400,22400,69550
"TR","1988-02-02",1988,2,33,0,38200,22400,60600
"TR","1988-02-03",1988,2,34,0,38100,22400,60500
"TR","1988-02-04",1988,2,35,0,38000,22400,60400
"TR","1988-02-05",1988,2,36,0,37800,22400,60200
"TR","1988-02-06",1988,2,37,0,37700,22400,60100
"TR","1988-02-07",1988,2,38,0,37600,22400,60000
"TR","1988-02-08",1988,2,39,41100,37800,22300,101200
"TR","1988-02-09",1988,2,40,0,37700,22200,59900
"TR","1988-02-10",1988,2,41,0,37600,22300,59900
"TR","1988-02-11",1988,2,42,0,37500,22300,59800
"TR","1988-02-12",1988,2,43,0,37400,22300,59700
"TR","1988-02-13",1988,2,44,0,37300,22400,59700
"TR","1988-02-14",1988,2,45,0,37200,22400,59600
"TR","1988-02-15",1988,2,46,0,37100,22400,59500
"TR","1988-02-16",1988,2,47,3470,37000,22400,62870
"TR","1988-02-17",1988,2,48,0,36900,22400,59300
"TR","1988-02-18",1988,2,49,0,36800,22400,59200
"TR","1988-02-19",1988,2,50,0,36700,22400,59100
"TR","1988-02-20",1988,2,51,0,36600,22400,59000
"TR","1988-02-21",1988,2,52,22300,36700,22300,81300
"TR","1988-02-22",1988,2,53,0,36600,22300,58900
"TR","1988-02-23",1988,2,54,0,36500,22300,58800
"TR","1988-02-24",1988,2,55,3560,36400,22300,62260
"TR","1988-02-25",1988,2,56,0,36400,22300,58700
"TR","1988-02-26",1988,2,57,0,36300,22300,58600
"TR","1988-02-27",1988,2,58,0,36200,22300,58500
"TR","1988-02-28",1988,2,59,0,36100,22300,58400
"TR","1988-02-29",1988,2,60,2250,36000,22300,60550
"TR","1988-03-01",1988,3,61,8330,36000,22300,66630
"TR","1988-03-02",1988,3,62,0,35900,22300,58200
"TR","1988-03-03",1988,3,63,0,35700,22400,58100
"TR","1988-03-04",1988,3,64,0,35700,22300,58000
"TR","1988-03-05",1988,3,65,0,35600,22300,57900
"TR","1988-03-06",1988,3,66,0,35400,22400,57800
"TR","1988-03-07",1988,3,67,0,35300,22400,57700
"TR","1988-03-08",1988,3,68,2070,35200,22500,59770
"TR","1988-03-09",1988,3,69,155000,37200,21800,214000
"TR","1988-03-10",1988,3,70,6700,38500,22600,67800
"TR","1988-03-11",1988,3,71,0,37900,23500,61400
"TR","1988-03-12",1988,3,72,0,38300,26200,64500
"TR","1988-03-13",1988,3,73,20700,38000,24300,83000
"TR","1988-03-14",1988,3,74,106000,38600,21800,166400
"TR","1988-03-15",1988,3,75,16900,38600,21700,77200
"TR","1988-03-16",1988,3,76,17500,38500,21800,77800
"TR","1988-03-17",1988,3,77,0,38200,21900,60100
"TR","1988-03-18",1988,3,78,0,38000,22000,60000
"TR","1988-03-19",1988,3,79,0,37600,22100,59700
"TR","1988-03-20",1988,3,80,0,37400,22200,59600
"TR","1988-03-21",1988,3,81,0,37200,22100,59300
"TR","1988-03-22",1988,3,82,0,37000,22100,59100
"TR","1988-03-23",1988,3,83,0,36700,22200,58900
"TR","1988-03-24",1988,3,84,0,36400,22300,58700
"TR","1988-03-25",1988,3,85,4140,37000,22300,63440
"TR","1988-03-26",1988,3,86,332000,93100,190000,615100
"TR","1988-03-27",1988,3,87,32700,47500,26000,106200
"TR","1988-03-28",1988,3,88,0,44000,21300,65300
"TR","1988-03-29",1988,3,89,0,42600,21300,63900
"TR","1988-03-30",1988,3,90,95000,43900,24500,163400
"TR","1988-03-31",1988,3,91,0,42600,23600,66200
"TR","1988-04-01",1988,4,92,0,41900,25300,67200
"TR","1988-04-02",1988,4,93,0,41500,25600,67100
"TR","1988-04-03",1988,4,94,0,41500,29200,70700
"TR","1988-04-04",1988,4,95,132000,53000,63000,248000
"TR","1988-04-05",1988,4,96,0,51400,36100,87500
"TR","1988-04-06",1988,4,97,0,50300,36800,87100
"TR","1988-04-07",1988,4,98,93700,63400,57900,215000
"TR","1988-04-08",1988,4,99,0,51700,24600,76300
"TR","1988-04-09",1988,4,100,0,48200,22100,70300
"TR","1988-04-10",1988,4,101,0,45100,22200,67300
"TR","1988-04-11",1988,4,102,9590,44200,22200,75990
"TR","1988-04-12",1988,4,103,0,43600,22200,65800
"TR","1988-04-13",1988,4,104,0,43100,22300,65400
"TR","1988-04-14",1988,4,105,0,42500,22400,64900
"TR","1988-04-15",1988,4,106,0,42100,22400,64500
"TR","1988-04-16",1988,4,107,14900,41900,22400,79200
"TR","1988-04-17",1988,4,108,0,41400,22400,63800
"TR","1988-04-18",1988,4,109,5760,41100,22500,69360
"TR","1988-04-19",1988,4,110,0,40700,22500,63200
"TR","1988-04-20",1988,4,111,0,40400,22700,63100
"TR","1988-04-21",1988,4,112,0,40000,22800,62800
"TR","1988-04-22",1988,4,113,0,39700,22900,62600
"TR","1988-04-23",1988,4,114,0,39400,23000,62400
"TR","1988-04-24",1988,4,115,64300,40400,23300,128000
"TR","1988-04-25",1988,4,116,0,39500,23000,62500
"TR","1988-04-26",1988,4,117,0,38800,23100,61900
"TR","1988-04-27",1988,4,118,0,38400,23300,61700
"TR","1988-04-28",1988,4,119,24600,38600,23400,86600
"TR","1988-04-29",1988,4,120,0,38100,23200,61300
"TR","1988-04-30",1988,4,121,0,37900,23300,61200
"TR","1988-05-01",1988,5,122,0,37600,23500,61100
"TR","1988-05-02",1988,5,123,0,37200,23700,60900
"TR","1988-05-03",1988,5,124,0,36800,24000,60800
"TR","1988-05-04",1988,5,125,0,36300,24200,60500
"TR","1988-05-05",1988,5,126,0,35900,24400,60300
"TR","1988-05-06",1988,5,127,0,35500,24600,60100
"TR","1988-05-07",1988,5,128,0,35100,24700,59800
"TR","1988-05-08",1988,5,129,0,34800,24800,59600
"TR","1988-05-09",1988,5,130,0,34400,24800,59200
"TR","1988-05-10",1988,5,131,302000,41000,31300,374300
"TR","1988-05-11",1988,5,132,73900,38700,23900,136500
"TR","1988-05-12",1988,5,133,5600,37300,23400,66300
"TR","1988-05-13",1988,5,134,27700,36600,23400,87700
"TR","1988-05-14",1988,5,135,103000,37500,23700,164200
"TR","1988-05-15",1988,5,136,0,36300,23000,59300
"TR","1988-05-16",1988,5,137,23100,36000,23000,82100
"TR","1988-05-17",1988,5,138,0,35200,23000,58200
"TR","1988-05-18",1988,5,139,0,34500,23000,57500
"TR","1988-05-19",1988,5,140,0,33900,23100,57000
"TR","1988-05-20",1988,5,141,0,33200,23100,56300
"TR","1988-05-21",1988,5,142,0,32500,23200,55700
"TR","1988-05-22",1988,5,143,31300,32500,23000,86800
"TR","1988-05-23",1988,5,144,211000,35200,23300,269500
"TR","1988-05-24",1988,5,145,28700,34500,22500,85700
"TR","1988-05-25",1988,5,146,0,33600,22600,56200
"TR","1988-05-26",1988,5,147,0,32800,22700,55500
"TR","1988-05-27",1988,5,148,0,32200,22800,55000
"TR","1988-05-28",1988,5,149,4200,31800,22800,58800
"TR","1988-05-29",1988,5,150,0,31200,23000,54200
"TR","1988-05-30",1988,5,151,0,30900,23000,53900
"TR","1988-05-31",1988,5,152,0,30400,23000,53400
"TR","1988-06-01",1988,6,153,0,30100,23000,53100
"TR","1988-06-02",1988,6,154,22100,29800,23300,75200
"TR","1988-06-03",1988,6,155,80400,30500,23500,134400
"TR","1988-06-04",1988,6,156,96200,31200,23200,150600
"TR","1988-06-05",1988,6,157,0,30400,23000,53400
"TR","1988-06-06",1988,6,158,0,29700,23400,53100
"TR","1988-06-07",1988,6,159,0,29200,23700,52900
"TR","1988-06-08",1988,6,160,0,28600,24100,52700
"TR","1988-06-09",1988,6,161,28300,28500,24300,81100
"TR","1988-06-10",1988,6,162,9540,28300,24000,61840
"TR","1988-06-11",1988,6,163,0,28000,24100,52100
"TR","1988-06-12",1988,6,164,0,27500,24300,51800
"TR","1988-06-13",1988,6,165,0,27100,24600,51700
"TR","1988-06-14",1988,6,166,7150,26700,24800,58650
"TR","1988-06-15",1988,6,167,0,26500,24900,51400
"TR","1988-06-16",1988,6,168,55300,26900,24800,107000
"TR","1988-06-17",1988,6,169,30400,27100,24500,82000
"TR","1988-06-18",1988,6,170,0,26800,24200,51000
"TR","1988-06-19",1988,6,171,0,26700,24300,51000
"TR","1988-06-20",1988,6,172,349000,32400,24000,405400
"TR","1988-06-21",1988,6,173,0,30300,22700,53000
"TR","1988-06-22",1988,6,174,22100,29900,23100,75100
"TR","1988-06-23",1988,6,175,4420,29200,23300,56920
"TR","1988-06-24",1988,6,176,0,28700,23400,52100
"TR","1988-06-25",1988,6,177,0,28400,23500,51900
"TR","1988-06-26",1988,6,178,0,28000,23700,51700
"TR","1988-06-27",1988,6,179,0,27800,23700,51500
"TR","1988-06-28",1988,6,180,0,27600,23700,51300
"TR","1988-06-29",1988,6,181,246000,31100,23400,300500
"TR","1988-06-30",1988,6,182,180000,33100,22600,235700
"TR","1988-07-01",1988,7,183,0,31700,21900,53600
"TR","1988-07-02",1988,7,184,0,30600,22200,52800
"TR","1988-07-03",1988,7,185,0,29200,22500,51700
"TR","1988-07-04",1988,7,186,0,28100,22700,50800
"TR","1988-07-05",1988,7,187,0,27000,22900,49900
"TR","1988-07-06",1988,7,188,0,25800,23100,48900
"TR","1988-07-07",1988,7,189,0,24000,23300,47300
"TR","1988-07-08",1988,7,190,0,23300,23400,46700
"TR","1988-07-09",1988,7,191,0,22000,23500,45500
"TR","1988-07-10",1988,7,192,210000,27200,23300,260500
"TR","1988-07-11",1988,7,193,36300,26700,22300,85300
"TR","1988-07-12",1988,7,194,0,25800,22300,48100
"TR","1988-07-13",1988,7,195,2660,25200,22400,50260
"TR","1988-07-14",1988,7,196,38500,25300,22300,86100
"TR","1988-07-15",1988,7,197,27200,24300,22400,73900
"TR","1988-07-16",1988,7,198,54000,25100,22300,101400
"TR","1988-07-17",1988,7,199,219000,28200,22100,269300
"TR","1988-07-18",1988,7,200,0,26400,21300,47700
"TR","1988-07-19",1988,7,201,0,25300,21600,46900
"TR","1988-07-20",1988,7,202,0,24300,21800,46100
"TR","1988-07-21",1988,7,203,1770,23900,21900,47570
"TR","1988-07-22",1988,7,204,44100,24200,21800,90100
"TR","1988-07-23",1988,7,205,88200,24700,21900,134800
"TR","1988-07-24",1988,7,206,0,23400,21600,45000
"TR","1988-07-25",1988,7,207,64900,23900,21600,110400
"TR","1988-07-26",1988,7,208,55700,24600,21500,101800
"TR","1988-07-27",1988,7,209,0,23400,21400,44800
"TR","1988-07-28",1988,7,210,0,22100,21700,43800
"TR","1988-07-29",1988,7,211,0,20800,22100,42900
"TR","1988-07-30",1988,7,212,60300,20700,22200,103200
"TR","1988-07-31",1988,7,213,81500,21300,22100,124900
"TR","1988-08-01",1988,8,214,27700,21000,21800,70500
"TR","1988-08-02",1988,8,215,78800,22100,21900,122800
"TR","1988-08-03",1988,8,216,984000,44500,36600,1065100
"TR","1988-08-04",1988,8,217,144000,37000,19500,200500
"TR","1988-08-05",1988,8,218,255000,40000,28000,323000
"TR","1988-08-06",1988,8,219,161000,40400,26500,227900
"TR","1988-08-07",1988,8,220,5540,38700,19000,63240
"TR","1988-08-08",1988,8,221,0,37100,19900,57000
"TR","1988-08-09",1988,8,222,21700,35900,20500,78100
"TR","1988-08-10",1988,8,223,12500,35000,20700,68200
"TR","1988-08-11",1988,8,224,0,33700,21000,54700
"TR","1988-08-12",1988,8,225,0,32200,21400,53600
"TR","1988-08-13",1988,8,226,129000,33000,21800,183800
"TR","1988-08-14",1988,8,227,77000,32700,21400,131100
"TR","1988-08-15",1988,8,228,282000,36300,21700,340000
"TR","1988-08-16",1988,8,229,0,33800,20600,54400
"TR","1988-08-17",1988,8,230,0,32600,21100,53700
"TR","1988-08-18",1988,8,231,228000,35500,21900,285400
"TR","1988-08-19",1988,8,232,112000,34900,21200,168100
"TR","1988-08-20",1988,8,233,0,33400,20900,54300
"TR","1988-08-21",1988,8,234,0,32500,21200,53700
"TR","1988-08-22",1988,8,235,0,31600,21300,52900
"TR","1988-08-23",1988,8,236,0,30900,21400,52300
"TR","1988-08-24",1988,8,237,554000,41900,31800,627700
"TR","1988-08-25",1988,8,238,0,36400,19700,56100
"TR","1988-08-26",1988,8,239,0,35500,20200,55700
"TR","1988-08-27",1988,8,240,71300,35800,20500,127600
"TR","1988-08-28",1988,8,241,75500,36200,20700,132400
"TR","1988-08-29",1988,8,242,54500,36200,20700,111400
"TR","1988-08-30",1988,8,243,2710,35100,20700,58510
"TR","1988-08-31",1988,8,244,0,34200,20800,55000
"TR","1988-09-01",1988,9,245,0,33400,21000,54400
"TR","1988-09-02",1988,9,246,48700,33300,21200,103200
"TR","1988-09-03",1988,9,247,2850,32300,21100,56250
"TR","1988-09-04",1988,9,248,375000,40400,25600,441000
"TR","1988-09-05",1988,9,249,206000,41200,37300,284500
"TR","1988-09-06",1988,9,250,9270,38800,20900,68970
"TR","1988-09-07",1988,9,251,0,37900,20200,58100
"TR","1988-09-08",1988,9,252,0,37200,20500,57700
"TR","1988-09-09",1988,9,253,0,36400,20700,57100
"TR","1988-09-10",1988,9,254,0,35600,20800,56400
"TR","1988-09-11",1988,9,255,0,34800,20900,55700
"TR","1988-09-12",1988,9,256,0,34000,21000,55000
"TR","1988-09-13",1988,9,257,6600,33300,21100,61000
"TR","1988-09-14",1988,9,258,28400,33000,21200,82600
"TR","1988-09-15",1988,9,259,0,32300,21100,53400
"TR","1988-09-16",1988,9,260,0,31900,21200,53100
"TR","1988-09-17",1988,9,261,96300,32900,21300,150500
"TR","1988-09-18",1988,9,262,156000,34900,21500,212400
"TR","1988-09-19",1988,9,263,2640,33500,21000,57140
"TR","1988-09-20",1988,9,264,150000,35700,21500,207200
"TR","1988-09-21",1988,9,265,168000,37500,22100,227600
"TR","1988-09-22",1988,9,266,30400,36200,20800,87400
"TR","1988-09-23",1988,9,267,15600,35400,20900,71900
"TR","1988-09-24",1988,9,268,4270,34600,20900,59770
"TR","1988-09-25",1988,9,269,0,33900,21000,54900
"TR","1988-09-26",1988,9,270,13200,33600,21100,67900
"TR","1988-09-27",1988,9,271,24000,33300,21200,78500
"TR","1988-09-28",1988,9,272,0,32600,21100,53700
"TR","1988-09-29",1988,9,273,13200,32300,21200,66700
"TR","1988-09-30",1988,9,274,54500,33300,21100,108900
"TR","1988-10-01",1988,10,275,2850,32900,21100,56850
"TR","1988-10-02",1988,10,276,2030,32300,21300,55630
"TR","1988-10-03",1988,10,277,0,31800,21200,53000
"TR","1988-10-04",1988,10,278,40200,32100,21200,93500
"TR","1988-10-05",1988,10,279,35700,32500,21200,89400
"TR","1988-10-06",1988,10,280,8570,32200,21100,61870
"TR","1988-10-07",1988,10,281,0,31900,21100,53000
"TR","1988-10-08",1988,10,282,0,31700,21200,52900
"TR","1988-10-09",1988,10,283,0,31600,21200,52800
"TR","1988-10-10",1988,10,284,0,31400,21300,52700
"TR","1988-10-11",1988,10,285,15700,31600,21400,68700
"TR","1988-10-12",1988,10,286,8020,31500,21400,60920
"TR","1988-10-13",1988,10,287,0,31400,21400,52800
"TR","1988-10-14",1988,10,288,0,31300,21500,52800
"TR","1988-10-15",1988,10,289,0,31200,21600,52800
"TR","1988-10-16",1988,10,290,0,31000,21800,52800
"TR","1988-10-17",1988,10,291,71200,32500,21800,125500
"TR","1988-10-18",1988,10,292,47600,33100,21600,102300
"TR","1988-10-19",1988,10,293,47900,33700,21500,103100
"TR","1988-10-20",1988,10,294,35500,33800,21400,90700
"TR","1988-10-21",1988,10,295,16900,33500,21100,71500
"TR","1988-10-22",1988,10,296,88500,34800,21400,144700
"TR","1988-10-23",1988,10,297,56900,35400,21100,113400
"TR","1988-10-24",1988,10,298,69300,36300,26300,131900
"TR","1988-10-25",1988,10,299,239000,38400,38400,315800
"TR","1988-10-26",1988,10,300,22300,38400,22700,83400
"TR","1988-10-27",1988,10,301,0,37900,19700,57600
"TR","1988-10-28",1988,10,302,112000,38400,19500,169900
"TR","1988-10-29",1988,10,303,77600,38800,19300,135700
"TR","1988-10-30",1988,10,304,0,38500,19300,57800
"TR","1988-10-31",1988,10,305,0,38200,19500,57700
"TR","1988-11-01",1988,11,306,37200,38400,20300,95900
"TR","1988-11-02",1988,11,307,43900,38600,22600,105100
"TR","1988-11-03",1988,11,308,0,38300,19900,58200
"TR","1988-11-04",1988,11,309,0,38400,21600,60000
"TR","1988-11-05",1988,11,310,114000,40300,28300,182600
"TR","1988-11-06",1988,11,311,301000,43400,24600,369000
"TR","1988-11-07",1988,11,312,46100,42900,18900,107900
"TR","1988-11-08",1988,11,313,7730,42100,18700,68530
"TR","1988-11-09",1988,11,314,38000,42600,19500,100100
"TR","1988-11-10",1988,11,315,0,42800,22700,65500
"TR","1988-11-11",1988,11,316,3790,44000,31700,79490
"TR","1988-11-12",1988,11,317,12900,43300,23400,79600
"TR","1988-11-13",1988,11,318,0,42700,21400,64100
"TR","1988-11-14",1988,11,319,81500,43000,21700,146200
"TR","1988-11-15",1988,11,320,60100,44000,25000,129100
"TR","1988-11-16",1988,11,321,199000,49800,28900,277700
"TR","1988-11-17",1988,11,322,501000,80000,68900,649900
"TR","1988-11-18",1988,11,323,15100,67300,23500,105900
"TR","1988-11-19",1988,11,324,0,61200,18900,80100
"TR","1988-11-20",1988,11,325,20900,56800,19600,97300
"TR","1988-11-21",1988,11,326,0,52800,20200,73000
"TR","1988-11-22",1988,11,327,0,49600,20600,70200
"TR","1988-11-23",1988,11,328,0,47200,21000,68200
"TR","1988-11-24",1988,11,329,0,45300,21300,66600
"TR","1988-11-25",1988,11,330,0,44500,21600,66100
"TR","1988-11-26",1988,11,331,0,43900,21800,65700
"TR","1988-11-27",1988,11,332,60400,44900,21900,127200
"TR","1988-11-28",1988,11,333,169000,46800,21400,237200
"TR","1988-11-29",1988,11,334,154000,48600,20800,223400
"TR","1988-11-30",1988,11,335,0,46500,21000,67500
"TR","1988-12-01",1988,12,336,0,44700,21400,66100
"TR","1988-12-02",1988,12,337,2200,44200,21600,68000
"TR","1988-12-03",1988,12,338,0,43800,21900,65700
"TR","1988-12-04",1988,12,339,0,43500,22000,65500
"TR","1988-12-05",1988,12,340,0,43100,22200,65300
"TR","1988-12-06",1988,12,341,0,42800,22300,65100
"TR","1988-12-07",1988,12,342,0,42500,22400,64900
"TR","1988-12-08",1988,12,343,754,42600,22700,66054
"TR","1988-12-09",1988,12,344,0,42300,22600,64900
"TR","1988-12-10",1988,12,345,0,42000,22600,64600
"TR","1988-12-11",1988,12,346,0,41700,22700,64400
"TR","1988-12-12",1988,12,347,0,41500,22700,64200
"TR","1988-12-13",1988,12,348,0,41200,22700,63900
"TR","1988-12-14",1988,12,349,69700,41400,22500,133600
"TR","1988-12-15",1988,12,350,111000,41900,22000,174900
"TR","1988-12-16",1988,12,351,2950,41700,22000,66650
"TR","1988-12-17",1988,12,352,0,41500,22200,63700
"TR","1988-12-18",1988,12,353,9540,41300,22300,73140
"TR","1988-12-19",1988,12,354,24000,41200,22300,87500
"TR","1988-12-20",1988,12,355,0,41000,22400,63400
"TR","1988-12-21",1988,12,356,163000,41800,21800,226600
"TR","1988-12-22",1988,12,357,20200,41700,21700,83600
"TR","1988-12-23",1988,12,358,0,41500,21900,63400
"TR","1988-12-24",1988,12,359,62200,41600,21800,125600
"TR","1988-12-25",1988,12,360,0,41300,21900,63200
"TR","1988-12-26",1988,12,361,754,41100,22100,63954
"TR","1988-12-27",1988,12,362,0,40800,22200,63000
"TR","1988-12-28",1988,12,363,106000,41300,21800,169100
"TR","1988-12-29",1988,12,364,0,41100,21800,62900
"TR","1988-12-30",1988,12,365,0,40900,22000,62900
"TR","1988-12-31",1988,12,366,0,40600,22100,62700
"TR","1989-01-01",1989,1,1,0,40400,22200,62600
"TR","1989-01-02",1989,1,2,0,40200,22300,62500
"TR","1989-01-03",1989,1,3,14100,40100,22300,76500
"TR","1989-01-04",1989,1,4,43600,40200,22200,106000
"TR","1989-01-05",1989,1,5,17200,40100,22100,79400
"TR","1989-01-06",1989,1,6,1260,39900,22200,63360
"TR","1989-01-07",1989,1,7,0,39700,22300,62000
"TR","1989-01-08",1989,1,8,4240,39600,22300,66140
"TR","1989-01-09",1989,1,9,186000,40600,21600,248200
"TR","1989-01-10",1989,1,10,7550,40400,21500,69450
"TR","1989-01-11",1989,1,11,4080,40200,21700,65980
"TR","1989-01-12",1989,1,12,0,40000,21800,61800
"TR","1989-01-13",1989,1,13,9170,39900,21900,70970
"TR","1989-01-14",1989,1,14,0,39700,22000,61700
"TR","1989-01-15",1989,1,15,0,39500,22100,61600
"TR","1989-01-16",1989,1,16,0,39300,22200,61500
"TR","1989-01-17",1989,1,17,2520,39100,22200,63820
"TR","1989-01-18",1989,1,18,3670,38900,22300,64870
"TR","1989-01-19",1989,1,19,114000,39500,21800,175300
"TR","1989-01-20",1989,1,20,0,39300,21800,61100
"TR","1989-01-21",1989,1,21,23900,39200,21800,84900
"TR","1989-01-22",1989,1,22,0,39000,21900,60900
"TR","1989-01-23",1989,1,23,0,38800,22000,60800
"TR","1989-01-24",1989,1,24,0,38600,22100,60700
"TR","1989-01-25",1989,1,25,0,38400,22200,60600
"TR","1989-01-26",1989,1,26,0,38200,22300,60500
"TR","1989-01-27",1989,1,27,51500,38400,22000,111900
"TR","1989-01-28",1989,1,28,0,38300,22000,60300
"TR","1989-01-29",1989,1,29,0,38100,22100,60200
"TR","1989-01-30",1989,1,30,0,37900,22200,60100
"TR","1989-01-31",1989,1,31,0,37700,22300,60000
"TR","1989-02-01",1989,2,32,0,37600,22300,59900
"TR","1989-02-02",1989,2,33,2210,37400,22300,61910
"TR","1989-02-03",1989,2,34,12300,37400,22200,71900
"TR","1989-02-04",1989,2,35,10500,37400,22200,70100
"TR","1989-02-05",1989,2,36,0,37300,22200,59500
"TR","1989-02-06",1989,2,37,0,37200,22200,59400
"TR","1989-02-07",1989,2,38,0,37100,22200,59300
"TR","1989-02-08",1989,2,39,0,37000,22200,59200
"TR","1989-02-09",1989,2,40,10200,36900,22100,69200
"TR","1989-02-10",1989,2,41,0,36800,22100,58900
"TR","1989-02-11",1989,2,42,756,36700,22100,59556
"TR","1989-02-12",1989,2,43,756,36600,22100,59456
"TR","1989-02-13",1989,2,44,0,36500,22100,58600
"TR","1989-02-14",1989,2,45,0,36400,22100,58500
"TR","1989-02-15",1989,2,46,1450,36400,22100,59950
"TR","1989-02-16",1989,2,47,0,36300,22100,58400
"TR","1989-02-17",1989,2,48,0,36200,22100,58300
"TR","1989-02-18",1989,2,49,0,36100,22100,58200
"TR","1989-02-19",1989,2,50,0,36000,22100,58100
"TR","1989-02-20",1989,2,51,0,35900,22100,58000
"TR","1989-02-21",1989,2,52,0,35800,22100,57900
"TR","1989-02-22",1989,2,53,0,35700,22100,57800
"TR","1989-02-23",1989,2,54,0,35700,22000,57700
"TR","1989-02-24",1989,2,55,0,35600,22000,57600
"TR","1989-02-25",1989,2,56,0,35500,22000,57500
"TR","1989-02-26",1989,2,57,10800,35500,22000,68300
"TR","1989-02-27",1989,2,58,33400,35700,21800,90900
"TR","1989-02-28",1989,2,59,8950,35700,21700,66350
"TR","1989-03-01",1989,3,60,47800,35900,21600,105300
"TR","1989-03-02",1989,3,61,17800,35900,21500,75200
"TR","1989-03-03",1989,3,62,0,35800,21500,57300
"TR","1989-03-04",1989,3,63,26500,35900,21500,83900
"TR","1989-03-05",1989,3,64,205000,37100,20700,262800
"TR","1989-03-06",1989,3,65,20700,37100,20600,78400
"TR","1989-03-07",1989,3,66,0,37000,20700,57700
"TR","1989-03-08",1989,3,67,0,36800,20900,57700
"TR","1989-03-09",1989,3,68,0,36600,21100,57700
"TR","1989-03-10",1989,3,69,1390,36300,21200,58890
"TR","1989-03-11",1989,3,70,0,36100,21300,57400
"TR","1989-03-12",1989,3,71,0,35800,21400,57200
"TR","1989-03-13",1989,3,72,0,35600,21500,57100
"TR","1989-03-14",1989,3,73,0,35300,21600,56900
"TR","1989-03-15",1989,3,74,10500,35100,21600,67200
"TR","1989-03-16",1989,3,75,493000,38200,19800,551000
"TR","1989-03-17",1989,3,76,0,38000,19500,57500
"TR","1989-03-18",1989,3,77,0,37800,19800,57600
"TR","1989-03-19",1989,3,78,0,37500,20100,57600
"TR","1989-03-20",1989,3,79,0,37300,20300,57600
"TR","1989-03-21",1989,3,80,4170,37000,20400,61570
"TR","1989-03-22",1989,3,81,0,36800,20600,57400
"TR","1989-03-23",1989,3,82,0,36500,20700,57200
"TR","1989-03-24",1989,3,83,0,36200,20900,57100
"TR","1989-03-25",1989,3,84,2780,35900,21000,59680
"TR","1989-03-26",1989,3,85,0,35500,21200,56700
"TR","1989-03-27",1989,3,86,0,35400,21400,56800
"TR","1989-03-28",1989,3,87,0,38000,22500,60500
"TR","1989-03-29",1989,3,88,0,40100,37700,77800
"TR","1989-03-30",1989,3,89,0,38100,26300,64400
"TR","1989-03-31",1989,3,90,0,37600,22300,59900
"TR","1989-04-01",1989,4,91,0,37200,22000,59200
"TR","1989-04-02",1989,4,92,0,37100,22000,59100
"TR","1989-04-03",1989,4,93,20900,39200,22500,82600
"TR","1989-04-04",1989,4,94,0,39700,29800,69500
"TR","1989-04-05",1989,4,95,164000,41600,29300,234900
"TR","1989-04-06",1989,4,96,8060,43700,33400,85160
"TR","1989-04-07",1989,4,97,0,42500,24100,66600
"TR","1989-04-08",1989,4,98,0,42500,24200,66700
"TR","1989-04-09",1989,4,99,0,41900,23200,65100
"TR","1989-04-10",1989,4,100,40000,41600,22100,103700
"TR","1989-04-11",1989,4,101,2410,41200,22100,65710
"TR","1989-04-12",1989,4,102,7060,40800,22200,70060
"TR","1989-04-13",1989,4,103,41400,40700,22100,104200
"TR","1989-04-14",1989,4,104,0,40700,22200,62900
"TR","1989-04-15",1989,4,105,27500,43400,28100,99000
"TR","1989-04-16",1989,4,106,0,43400,27900,71300
"TR","1989-04-17",1989,4,107,0,44400,31800,76200
"TR","1989-04-18",1989,4,108,63800,52100,73000,188900
"TR","1989-04-19",1989,4,109,0,45100,26900,72000
"TR","1989-04-20",1989,4,110,0,43400,30000,73400
"TR","1989-04-21",1989,4,111,0,42000,24700,66700
"TR","1989-04-22",1989,4,112,56400,42400,26200,125000
"TR","1989-04-23",1989,4,113,0,41300,23000,64300
"TR","1989-04-24",1989,4,114,0,40700,23100,63800
"TR","1989-04-25",1989,4,115,0,40200,23200,63400
"TR","1989-04-26",1989,4,116,38000,40500,23200,101700
"TR","1989-04-27",1989,4,117,38000,40300,23200,101500
"TR","1989-04-28",1989,4,118,8750,39400,23100,71250
"TR","1989-04-29",1989,4,119,15200,39300,23100,77600
"TR","1989-04-30",1989,4,120,24100,39100,23100,86300
"TR","1989-05-01",1989,5,121,40600,39500,23200,103300
"TR","1989-05-02",1989,5,122,0,38700,23100,61800
"TR","1989-05-03",1989,5,123,2800,38200,23300,64300
"TR","1989-05-04",1989,5,124,2390,37800,23400,63590
"TR","1989-05-05",1989,5,125,0,37400,23700,61100
"TR","1989-05-06",1989,5,126,160000,40800,24500,225300
"TR","1989-05-07",1989,5,127,11200,38900,23600,73700
"TR","1989-05-08",1989,5,128,0,38200,23700,61900
"TR","1989-05-09",1989,5,129,0,37600,23900,61500
"TR","1989-05-10",1989,5,130,0,36800,23800,60600
"TR","1989-05-11",1989,5,131,0,36000,23800,59800
"TR","1989-05-12",1989,5,132,0,35200,23700,58900
"TR","1989-05-13",1989,5,133,0,34400,23700,58100
"TR","1989-05-14",1989,5,134,133000,35900,23700,192600
"TR","1989-05-15",1989,5,135,35900,35200,23300,94400
"TR","1989-05-16",1989,5,136,14600,34500,23400,72500
"TR","1989-05-17",1989,5,137,0,33600,23400,57000
"TR","1989-05-18",1989,5,138,0,32800,23600,56400
"TR","1989-05-19",1989,5,139,48800,32900,23500,105200
"TR","1989-05-20",1989,5,140,209000,35800,23600,268400
"TR","1989-05-21",1989,5,141,208000,38300,23300,269600
"TR","1989-05-22",1989,5,142,9570,36600,22700,68870
"TR","1989-05-23",1989,5,143,0,35400,23000,58400
"TR","1989-05-24",1989,5,144,33300,34800,23100,91200
"TR","1989-05-25",1989,5,145,222000,38100,23200,283300
"TR","1989-05-26",1989,5,146,377000,45300,24600,446900
"TR","1989-05-27",1989,5,147,11400,40900,21800,74100
"TR","1989-05-28",1989,5,148,4780,40000,22100,66880
"TR","1989-05-29",1989,5,149,0,39000,22400,61400
"TR","1989-05-30",1989,5,150,144000,40600,22600,207200
"TR","1989-05-31",1989,5,151,251000,44700,23600,319300
"TR","1989-06-01",1989,6,152,96100,43500,28100,167700
"TR","1989-06-02",1989,6,153,16200,42100,22000,80300
"TR","1989-06-03",1989,6,154,67900,42100,22500,132500
"TR","1989-06-04",1989,6,155,61600,41900,22700,126200
"TR","1989-06-05",1989,6,156,0,40500,22500,63000
"TR","1989-06-06",1989,6,157,11100,39700,22800,73600
"TR","1989-06-07",1989,6,158,34000,39200,22900,96100
"TR","1989-06-08",1989,6,159,486000,51300,31000,568300
"TR","1989-06-09",1989,6,160,299000,57600,35600,392200
"TR","1989-06-10",1989,6,161,67000,52700,23800,143500
"TR","1989-06-11",1989,6,162,0,47500,21500,69000
"TR","1989-06-12",1989,6,163,6630,43900,22100,72630
"TR","1989-06-13",1989,6,164,168000,46200,22600,236800
"TR","1989-06-14",1989,6,165,153000,49700,26000,228700
"TR","1989-06-15",1989,6,166,39700,46500,22700,108900
"TR","1989-06-16",1989,6,167,64100,46600,24000,134700
"TR","1989-06-17",1989,6,168,2380,43700,22500,68580
"TR","1989-06-18",1989,6,169,0,42200,22800,65000
"TR","1989-06-19",1989,6,170,6630,40800,22900,70330
"TR","1989-06-20",1989,6,171,0,39600,23000,62600
"TR","1989-06-21",1989,6,172,0,38600,23200,61800
"TR","1989-06-22",1989,6,173,77400,38800,23200,139400
"TR","1989-06-23",1989,6,174,210000,41200,23200,274400
"TR","1989-06-24",1989,6,175,193000,42900,23100,259000
"TR","1989-06-25",1989,6,176,11200,40900,22600,74700
"TR","1989-06-26",1989,6,177,11100,39800,22900,73800
"TR","1989-06-27",1989,6,178,152000,41500,23400,216900
"TR","1989-06-28",1989,6,179,85800,41300,23300,150400
"TR","1989-06-29",1989,6,180,0,39700,23000,62700
"TR","1989-06-30",1989,6,181,0,38700,23300,62000
"TR","1989-07-01",1989,7,182,238000,42200,23900,304100
"TR","1989-07-02",1989,7,183,178000,42800,24000,244800
"TR","1989-07-03",1989,7,184,0,40100,22400,62500
"TR","1989-07-04",1989,7,185,0,38300,22700,61000
"TR","1989-07-05",1989,7,186,0,36500,22600,59100
"TR","1989-07-06",1989,7,187,0,35000,22800,57800
"TR","1989-07-07",1989,7,188,0,33500,22900,56400
"TR","1989-07-08",1989,7,189,0,32200,23000,55200
"TR","1989-07-09",1989,7,190,0,31300,23000,54300
"TR","1989-07-10",1989,7,191,0,30100,23200,53300
"TR","1989-07-11",1989,7,192,0,29000,23400,52400
"TR","1989-07-12",1989,7,193,7010,28600,23300,58910
"TR","1989-07-13",1989,7,194,0,28100,23300,51400
"TR","1989-07-14",1989,7,195,0,27600,23300,50900
"TR","1989-07-15",1989,7,196,0,26700,23400,50100
"TR","1989-07-16",1989,7,197,0,25600,23500,49100
"TR","1989-07-17",1989,7,198,0,24600,23600,48200
"TR","1989-07-18",1989,7,199,44800,24600,23600,93000
"TR","1989-07-19",1989,7,200,14000,24400,23400,61800
"TR","1989-07-20",1989,7,201,45400,25100,23400,93900
"TR","1989-07-21",1989,7,202,0,23900,23300,47200
"TR","1989-07-22",1989,7,203,0,23000,23500,46500
"TR","1989-07-23",1989,7,204,0,22200,23700,45900
"TR","1989-07-24",1989,7,205,0,21300,23900,45200
"TR","1989-07-25",1989,7,206,0,20800,24000,44800
"TR","1989-07-26",1989,7,207,0,20500,24100,44600
"TR","1989-07-27",1989,7,208,7010,20800,24000,51810
"TR","1989-07-28",1989,7,209,21200,21200,23900,66300
"TR","1989-07-29",1989,7,210,0,21300,23800,45100
"TR","1989-07-30",1989,7,211,44800,22400,23600,90800
"TR","1989-07-31",1989,7,212,79100,24100,23400,126600
"TR","1989-08-01",1989,8,213,0,23700,23000,46700
"TR","1989-08-02",1989,8,214,0,23200,23400,46600
"TR","1989-08-03",1989,8,215,0,22700,23700,46400
"TR","1989-08-04",1989,8,216,0,22300,24000,46300
"TR","1989-08-05",1989,8,217,63900,23300,24100,111300
"TR","1989-08-06",1989,8,218,6320,22000,24300,52620
"TR","1989-08-07",1989,8,219,0,21300,24600,45900
"TR","1989-08-08",1989,8,220,0,21500,24600,46100
"TR","1989-08-09",1989,8,221,0,21600,24600,46200
"TR","1989-08-10",1989,8,222,0,21000,24800,45800
"TR","1989-08-11",1989,8,223,0,20300,25200,45500
"TR","1989-08-12",1989,8,224,0,19700,25500,45200
"TR","1989-08-13",1989,8,225,523000,32000,25100,580100
"TR","1989-08-14",1989,8,226,202000,31600,23000,256600
"TR","1989-08-15",1989,8,227,694000,46600,48000,788600
"TR","1989-08-16",1989,8,228,57700,42300,20600,120600
"TR","1989-08-17",1989,8,229,0,41100,20700,61800
"TR","1989-08-18",1989,8,230,0,40000,21800,61800
"TR","1989-08-19",1989,8,231,0,38700,22200,60900
"TR","1989-08-20",1989,8,232,179000,40500,22600,242100
"TR","1989-08-21",1989,8,233,167000,41600,22800,231400
"TR","1989-08-22",1989,8,234,8430,39800,22100,70330
"TR","1989-08-23",1989,8,235,153000,41600,28800,223400
"TR","1989-08-24",1989,8,236,0,39900,22100,62000
"TR","1989-08-25",1989,8,237,0,38900,22400,61300
"TR","1989-08-26",1989,8,238,0,38000,22600,60600
"TR","1989-08-27",1989,8,239,16900,37300,22700,76900
"TR","1989-08-28",1989,8,240,28100,36900,22800,87800
"TR","1989-08-29",1989,8,241,0,35900,22800,58700
"TR","1989-08-30",1989,8,242,0,35200,22900,58100
"TR","1989-08-31",1989,8,243,0,34400,22900,57300
"TR","1989-09-01",1989,9,244,710000,51200,33600,794800
"TR","1989-09-02",1989,9,245,110000,45800,29700,185500
"TR","1989-09-03",1989,9,246,2850,42900,21300,67050
"TR","1989-09-04",1989,9,247,0,41600,21700,63300
"TR","1989-09-05",1989,9,248,95000,42500,22200,159700
"TR","1989-09-06",1989,9,249,104000,43000,23700,170700
"TR","1989-09-07",1989,9,250,0,41200,22100,63300
"TR","1989-09-08",1989,9,251,0,40000,22400,62400
"TR","1989-09-09",1989,9,252,129000,42100,23100,194200
"TR","1989-09-10",1989,9,253,6600,40500,22600,69700
"TR","1989-09-11",1989,9,254,0,39500,22600,62100
"TR","1989-09-12",1989,9,255,0,38700,22700,61400
"TR","1989-09-13",1989,9,256,0,38000,22700,60700
"TR","1989-09-14",1989,9,257,0,37400,22700,60100
"TR","1989-09-15",1989,9,258,0,36800,22700,59500
"TR","1989-09-16",1989,9,259,0,36200,22700,58900
"TR","1989-09-17",1989,9,260,0,35700,22800,58500
"TR","1989-09-18",1989,9,261,0,35000,22800,57800
"TR","1989-09-19",1989,9,262,0,34400,22900,57300
"TR","1989-09-20",1989,9,263,6600,33800,23000,63400
"TR","1989-09-21",1989,9,264,0,33100,23100,56200
"TR","1989-09-22",1989,9,265,0,32600,23100,55700
"TR","1989-09-23",1989,9,266,11600,32200,23100,66900
"TR","1989-09-24",1989,9,267,1420,31900,23000,56320
"TR","1989-09-25",1989,9,268,0,31700,22900,54600
"TR","1989-09-26",1989,9,269,0,31500,23000,54500
"TR","1989-09-27",1989,9,270,0,31300,22900,54200
"TR","1989-09-28",1989,9,271,0,31100,22900,54000
"TR","1989-09-29",1989,9,272,0,30800,23000,53800
"TR","1989-09-30",1989,9,273,0,30600,23000,53600
"TR","1989-10-01",1989,10,274,0,30300,23000,53300
"TR","1989-10-02",1989,10,275,0,30100,23200,53300
"TR","1989-10-03",1989,10,276,61600,30900,22900,115400
"TR","1989-10-04",1989,10,277,0,30900,22700,53600
"TR","1989-10-05",1989,10,278,0,30900,22800,53700
"TR","1989-10-06",1989,10,279,62400,32100,22600,117100
"TR","1989-10-07",1989,10,280,84100,33800,22500,140400
"TR","1989-10-08",1989,10,281,0,33300,22300,55600
"TR","1989-10-09",1989,10,282,0,32900,22400,55300
"TR","1989-10-10",1989,10,283,0,32700,22500,55200
"TR","1989-10-11",1989,10,284,135000,35300,22500,192800
"TR","1989-10-12",1989,10,285,1020,34400,22100,57520
"TR","1989-10-13",1989,10,286,0,33800,22300,56100
"TR","1989-10-14",1989,10,287,0,33300,22600,55900
"TR","1989-10-15",1989,10,288,1020,33000,22700,56720
"TR","1989-10-16",1989,10,289,0,32900,22700,55600
"TR","1989-10-17",1989,10,290,10300,33000,22700,66000
"TR","1989-10-18",1989,10,291,0,32900,22600,55500
"TR","1989-10-19",1989,10,292,0,32800,22600,55400
"TR","1989-10-20",1989,10,293,0,32800,22500,55300
"TR","1989-10-21",1989,10,294,0,32800,22500,55300
"TR","1989-10-22",1989,10,295,0,32700,22600,55300
"TR","1989-10-23",1989,10,296,0,32600,22700,55300
"TR","1989-10-24",1989,10,297,0,32500,22800,55300
"TR","1989-10-25",1989,10,298,0,32400,22900,55300
"TR","1989-10-26",1989,10,299,1020,32300,23000,56320
"TR","1989-10-27",1989,10,300,0,32100,23200,55300
"TR","1989-10-28",1989,10,301,0,32000,23300,55300
"TR","1989-10-29",1989,10,302,0,31900,23300,55200
"TR","1989-10-30",1989,10,303,141000,35000,23400,199400
"TR","1989-10-31",1989,10,304,62000,35200,22600,119800
"TR","1989-11-01",1989,11,305,196000,39200,22800,258000
"TR","1989-11-02",1989,11,306,75800,37500,21200,134500
"TR","1989-11-03",1989,11,307,70000,37500,21100,128600
"TR","1989-11-04",1989,11,308,5150,37300,21200,63650
"TR","1989-11-05",1989,11,309,118000,37900,20900,176800
"TR","1989-11-06",1989,11,310,130000,39100,20800,189900
"TR","1989-11-07",1989,11,311,65900,40700,21000,127600
"TR","1989-11-08",1989,11,312,82700,40500,20300,143500
"TR","1989-11-09",1989,11,313,5650,42900,21300,69850
"TR","1989-11-10",1989,11,314,13200,43700,23600,80500
"TR","1989-11-11",1989,11,315,2580,41800,21100,65480
"TR","1989-11-12",1989,11,316,21500,41600,23700,86800
"TR","1989-11-13",1989,11,317,0,40800,21100,61900
"TR","1989-11-14",1989,11,318,0,40200,20900,61100
"TR","1989-11-15",1989,11,319,0,39700,20900,60600
"TR","1989-11-16",1989,11,320,135000,40400,20300,195700
"TR","1989-11-17",1989,11,321,40000,40300,20200,100500
"TR","1989-11-18",1989,11,322,12900,40100,20200,73200
"TR","1989-11-19",1989,11,323,24600,40000,20300,84900
"TR","1989-11-20",1989,11,324,0,39600,20300,59900
"TR","1989-11-21",1989,11,325,0,39300,20500,59800
"TR","1989-11-22",1989,11,326,29700,39100,20500,89300
"TR","1989-11-23",1989,11,327,9670,38900,20600,69170
"TR","1989-11-24",1989,11,328,0,38700,20600,59300
"TR","1989-11-25",1989,11,329,0,38400,20600,59000
"TR","1989-11-26",1989,11,330,0,38200,20700,58900
"TR","1989-11-27",1989,11,331,0,37900,20800,58700
"TR","1989-11-28",1989,11,332,54000,38400,20800,113200
"TR","1989-11-29",1989,11,333,118000,38900,20300,177200
"TR","1989-11-30",1989,11,334,0,38600,20200,58800
"TR","1989-12-01",1989,12,335,0,38300,20400,58700
"TR","1989-12-02",1989,12,336,0,38100,20400,58500
"TR","1989-12-03",1989,12,337,15200,37900,20400,73500
"TR","1989-12-04",1989,12,338,1450,37700,20500,59650
"TR","1989-12-05",1989,12,339,0,37600,20500,58100
"TR","1989-12-06",1989,12,340,0,37400,20600,58000
"TR","1989-12-07",1989,12,341,3640,37200,20600,61440
"TR","1989-12-08",1989,12,342,0,37100,20600,57700
"TR","1989-12-09",1989,12,343,0,36900,20600,57500
"TR","1989-12-10",1989,12,344,24400,36900,20600,81900
"TR","1989-12-11",1989,12,345,1510,36800,20600,58910
"TR","1989-12-12",1989,12,346,1450,36600,20600,58650
"TR","1989-12-13",1989,12,347,2200,36500,20600,59300
"TR","1989-12-14",1989,12,348,0,36400,20600,57000
"TR","1989-12-15",1989,12,349,56600,36600,20400,113600
"TR","1989-12-16",1989,12,350,13200,36600,20300,70100
"TR","1989-12-17",1989,12,351,0,36400,20400,56800
"TR","1989-12-18",1989,12,352,7290,36300,20400,63990
"TR","1989-12-19",1989,12,353,754,36200,20400,57354
"TR","1989-12-20",1989,12,354,0,36100,20500,56600
"TR","1989-12-21",1989,12,355,0,35900,20500,56400
"TR","1989-12-22",1989,12,356,0,35800,20500,56300
"TR","1989-12-23",1989,12,357,0,35700,20600,56300
"TR","1989-12-24",1989,12,358,0,35600,20600,56200
"TR","1989-12-25",1989,12,359,5150,35500,20600,61250
"TR","1989-12-26",1989,12,360,33100,35600,20400,89100
"TR","1989-12-27",1989,12,361,22600,35600,20300,78500
"TR","1989-12-28",1989,12,362,754,35500,20400,56654
"TR","1989-12-29",1989,12,363,0,35400,20400,55800
"TR","1989-12-30",1989,12,364,47600,35600,20300,103500
"TR","1989-12-31",1989,12,365,0,35500,20200,55700
"TR","1990-01-01",1990,1,1,9620,35400,20300,65320
"TR","1990-01-02",1990,1,2,10100,35300,20300,65700
"TR","1990-01-03",1990,1,3,0,35200,20300,55500
"TR","1990-01-04",1990,1,4,0,35000,20400,55400
"TR","1990-01-05",1990,1,5,0,34800,20500,55300
"TR","1990-01-06",1990,1,6,0,34700,20500,55200
"TR","1990-01-07",1990,1,7,0,34600,20500,55100
"TR","1990-01-08",1990,1,8,0,34400,20500,54900
"TR","1990-01-09",1990,1,9,0,34300,20600,54900
"TR","1990-01-10",1990,1,10,0,34100,20600,54700
"TR","1990-01-11",1990,1,11,0,34000,20600,54600
"TR","1990-01-12",1990,1,12,35300,34200,20500,90000
"TR","1990-01-13",1990,1,13,33600,34300,20300,88200
"TR","1990-01-14",1990,1,14,0,34200,20300,54500
"TR","1990-01-15",1990,1,15,0,34100,20400,54500
"TR","1990-01-16",1990,1,16,0,34000,20400,54400
"TR","1990-01-17",1990,1,17,0,33800,20500,54300
"TR","1990-01-18",1990,1,18,7600,33800,20500,61900
"TR","1990-01-19",1990,1,19,8090,33700,20500,62290
"TR","1990-01-20",1990,1,20,0,33600,20500,54100
"TR","1990-01-21",1990,1,21,0,33500,20500,54000
"TR","1990-01-22",1990,1,22,0,33400,20500,53900
"TR","1990-01-23",1990,1,23,45800,33700,20300,99800
"TR","1990-01-24",1990,1,24,0,33500,20300,53800
"TR","1990-01-25",1990,1,25,165000,34700,19700,219400
"TR","1990-01-26",1990,1,26,0,34500,19700,54200
"TR","1990-01-27",1990,1,27,10900,34400,19800,65100
"TR","1990-01-28",1990,1,28,0,34200,19900,54100
"TR","1990-01-29",1990,1,29,97100,34800,19600,151500
"TR","1990-01-30",1990,1,30,0,34600,19600,54200
"TR","1990-01-31",1990,1,31,0,34400,19800,54200
"TR","1990-02-01",1990,2,32,0,34200,19900,54100
"TR","1990-02-02",1990,2,33,0,34000,19900,53900
"TR","1990-02-03",1990,2,34,0,33900,20000,53900
"TR","1990-02-04",1990,2,35,13400,33800,20000,67200
"TR","1990-02-05",1990,2,36,3780,33700,20000,57480
"TR","1990-02-06",1990,2,37,0,33500,20000,53500
"TR","1990-02-07",1990,2,38,0,33400,20100,53500
"TR","1990-02-08",1990,2,39,0,33200,20100,53300
"TR","1990-02-09",1990,2,40,0,33100,20100,53200
"TR","1990-02-10",1990,2,41,0,33000,20100,53100
"TR","1990-02-11",1990,2,42,0,32800,20200,53000
"TR","1990-02-12",1990,2,43,0,32700,20200,52900
"TR","1990-02-13",1990,2,44,756,32700,20200,53656
"TR","1990-02-14",1990,2,45,0,32600,20200,52800
"TR","1990-02-15",1990,2,46,0,32500,20200,52700
"TR","1990-02-16",1990,2,47,0,32400,20200,52600
"TR","1990-02-17",1990,2,48,88500,33000,19800,141300
"TR","1990-02-18",1990,2,49,17400,33000,19700,70100
"TR","1990-02-19",1990,2,50,0,32900,19800,52700
"TR","1990-02-20",1990,2,51,0,32800,19800,52600
"TR","1990-02-21",1990,2,52,0,32700,19900,52600
"TR","1990-02-22",1990,2,53,0,32500,20000,52500
"TR","1990-02-23",1990,2,54,0,32400,20000,52400
"TR","1990-02-24",1990,2,55,0,32300,20000,52300
"TR","1990-02-25",1990,2,56,35900,32400,19900,88200
"TR","1990-02-26",1990,2,57,756,32300,19900,52956
"TR","1990-02-27",1990,2,58,15800,32400,19800,68000
"TR","1990-02-28",1990,2,59,8650,32300,19800,60750
"TR","1990-03-01",1990,3,60,756,32200,19900,52856
"TR","1990-03-02",1990,3,61,0,31900,20000,51900
"TR","1990-03-03",1990,3,62,0,31700,20100,51800
"TR","1990-03-04",1990,3,63,0,31600,20100,51700
"TR","1990-03-05",1990,3,64,21600,31700,20000,73300
"TR","1990-03-06",1990,3,65,0,31600,20000,51600
"TR","1990-03-07",1990,3,66,0,31500,20000,51500
"TR","1990-03-08",1990,3,67,0,31400,20100,51500
"TR","1990-03-09",1990,3,68,4140,31200,20100,55440
"TR","1990-03-10",1990,3,69,64800,31700,19800,116300
"TR","1990-03-11",1990,3,70,0,31500,19900,51400
"TR","1990-03-12",1990,3,71,24500,35000,23900,83400
"TR","1990-03-13",1990,3,72,154000,59600,118000,331600
"TR","1990-03-14",1990,3,73,0,48200,48600,96800
"TR","1990-03-15",1990,3,74,79300,49300,59500,188100
"TR","1990-03-16",1990,3,75,22300,46300,23800,92400
"TR","1990-03-17",1990,3,76,0,42700,19600,62300
"TR","1990-03-18",1990,3,77,49300,42200,19700,111200
"TR","1990-03-19",1990,3,78,24700,41600,19700,86000
"TR","1990-03-20",1990,3,79,0,41100,19900,61000
"TR","1990-03-21",1990,3,80,0,40600,20200,60800
"TR","1990-03-22",1990,3,81,4140,40500,20500,65140
"TR","1990-03-23",1990,3,82,0,39400,20400,59800
"TR","1990-03-24",1990,3,83,0,38600,20300,58900
"TR","1990-03-25",1990,3,84,0,38300,20200,58500
"TR","1990-03-26",1990,3,85,0,37900,20300,58200
"TR","1990-03-27",1990,3,86,0,37400,20300,57700
"TR","1990-03-28",1990,3,87,0,37000,20300,57300
"TR","1990-03-29",1990,3,88,0,36500,20300,56800
"TR","1990-03-30",1990,3,89,0,36000,20300,56300
"TR","1990-03-31",1990,3,90,0,35400,20300,55700
"TR","1990-04-01",1990,4,91,0,34800,20600,55400
"TR","1990-04-02",1990,4,92,45600,35300,20700,101600
"TR","1990-04-03",1990,4,93,156000,36600,20200,212800
"TR","1990-04-04",1990,4,94,0,36100,20200,56300
"TR","1990-04-05",1990,4,95,0,35900,20700,56600
"TR","1990-04-06",1990,4,96,0,35300,20800,56100
"TR","1990-04-07",1990,4,97,0,34900,20800,55700
"TR","1990-04-08",1990,4,98,0,34600,20800,55400
"TR","1990-04-09",1990,4,99,0,34200,20800,55000
"TR","1990-04-10",1990,4,100,29100,34400,20800,84300
"TR","1990-04-11",1990,4,101,9880,34100,20700,64680
"TR","1990-04-12",1990,4,102,0,33700,20600,54300
"TR","1990-04-13",1990,4,103,0,33500,20600,54100
"TR","1990-04-14",1990,4,104,0,33300,20700,54000
"TR","1990-04-15",1990,4,105,0,33100,20800,53900
"TR","1990-04-16",1990,4,106,56500,33900,21000,111400
"TR","1990-04-17",1990,4,107,0,33100,20700,53800
"TR","1990-04-18",1990,4,108,29600,33300,20800,83700
"TR","1990-04-19",1990,4,109,0,32800,20700,53500
"TR","1990-04-20",1990,4,110,0,32400,20800,53200
"TR","1990-04-21",1990,4,111,0,32100,20900,53000
"TR","1990-04-22",1990,4,112,0,31900,21000,52900
"TR","1990-04-23",1990,4,113,0,31600,21100,52700
"TR","1990-04-24",1990,4,114,0,31400,21200,52600
"TR","1990-04-25",1990,4,115,84000,32800,21700,138500
"TR","1990-04-26",1990,4,116,6720,31800,20900,59420
"TR","1990-04-27",1990,4,117,0,31200,21000,52200
"TR","1990-04-28",1990,4,118,258000,37200,22900,318100
"TR","1990-04-29",1990,4,119,267000,40600,34700,342300
"TR","1990-04-30",1990,4,120,90400,38500,21900,150800
"TR","1990-05-01",1990,5,121,37400,37700,19500,94600
"TR","1990-05-02",1990,5,122,0,36600,19500,56100
"TR","1990-05-03",1990,5,123,0,36100,19600,55700
"TR","1990-05-04",1990,5,124,0,35600,19800,55400
"TR","1990-05-05",1990,5,125,0,35100,19900,55000
"TR","1990-05-06",1990,5,126,0,34500,20000,54500
"TR","1990-05-07",1990,5,127,0,34000,20100,54100
"TR","1990-05-08",1990,5,128,0,33400,20400,53800
"TR","1990-05-09",1990,5,129,0,32700,20700,53400
"TR","1990-05-10",1990,5,130,278000,39300,21100,338400
"TR","1990-05-11",1990,5,131,356000,38900,19400,414300
"TR","1990-05-12",1990,5,132,0,38900,19700,58600
"TR","1990-05-13",1990,5,133,0,38600,32500,71100
"TR","1990-05-14",1990,5,134,0,37400,23500,60900
"TR","1990-05-15",1990,5,135,115000,38800,22500,176300
"TR","1990-05-16",1990,5,136,172000,41400,29800,243200
"TR","1990-05-17",1990,5,137,757000,80100,74400,911500
"TR","1990-05-18",1990,5,138,27800,64000,22100,113900
"TR","1990-05-19",1990,5,139,28900,58700,18300,105900
"TR","1990-05-20",1990,5,140,0,53000,18800,71800
"TR","1990-05-21",1990,5,141,155000,57300,24500,236800
"TR","1990-05-22",1990,5,142,0,51200,19400,70600
"TR","1990-05-23",1990,5,143,0,46900,19700,66600
"TR","1990-05-24",1990,5,144,204000,53300,28500,285800
"TR","1990-05-25",1990,5,145,0,48100,20000,68100
"TR","1990-05-26",1990,5,146,0,44600,20400,65000
"TR","1990-05-27",1990,5,147,111000,45600,20800,177400
"TR","1990-05-28",1990,5,148,119000,47200,21100,187300
"TR","1990-05-29",1990,5,149,0,43200,20600,63800
"TR","1990-05-30",1990,5,150,0,41800,20900,62700
"TR","1990-05-31",1990,5,151,0,40400,20900,61300
"TR","1990-06-01",1990,6,152,0,39400,21000,60400
"TR","1990-06-02",1990,6,153,10400,38500,21300,70200
"TR","1990-06-03",1990,6,154,0,37600,21500,59100
"TR","1990-06-04",1990,6,155,319000,42200,22200,383400
"TR","1990-06-05",1990,6,156,47600,40400,21000,109000
"TR","1990-06-06",1990,6,157,25100,39800,21300,86200
"TR","1990-06-07",1990,6,158,188000,42400,22400,252800
"TR","1990-06-08",1990,6,159,0,40500,21700,62200
"TR","1990-06-09",1990,6,160,5580,39200,21900,66680
"TR","1990-06-10",1990,6,161,30900,38800,22100,91800
"TR","1990-06-11",1990,6,162,2790,38000,22000,62790
"TR","1990-06-12",1990,6,163,0,37200,22200,59400
"TR","1990-06-13",1990,6,164,1010000,75100,46900,1132000
"TR","1990-06-14",1990,6,165,297000,68100,33500,398600
"TR","1990-06-15",1990,6,166,0,56200,19600,75800
"TR","1990-06-16",1990,6,167,12300,50800,20300,83400
"TR","1990-06-17",1990,6,168,40600,48200,20800,109600
"TR","1990-06-18",1990,6,169,189000,52600,22400,264000
"TR","1990-06-19",1990,6,170,7150,47700,21600,76450
"TR","1990-06-20",1990,6,171,0,44300,21900,66200
"TR","1990-06-21",1990,6,172,2790,43200,22300,68290
"TR","1990-06-22",1990,6,173,22100,42400,22500,87000
"TR","1990-06-23",1990,6,174,121000,43400,23200,187600
"TR","1990-06-24",1990,6,175,4770,42100,22700,69570
"TR","1990-06-25",1990,6,176,35400,41600,23200,100200
"TR","1990-06-26",1990,6,177,0,40000,23200,63200
"TR","1990-06-27",1990,6,178,130000,41200,23700,194900
"TR","1990-06-28",1990,6,179,0,39800,23200,63000
"TR","1990-06-29",1990,6,180,12600,39100,23400,75100
"TR","1990-06-30",1990,6,181,86500,39800,23800,150100
"TR","1990-07-01",1990,7,182,129000,41400,23900,194300
"TR","1990-07-02",1990,7,183,0,39200,23500,62700
"TR","1990-07-03",1990,7,184,0,37500,23600,61100
"TR","1990-07-04",1990,7,185,0,36100,23700,59800
"TR","1990-07-05",1990,7,186,0,35100,23600,58700
"TR","1990-07-06",1990,7,187,0,34300,23600,57900
"TR","1990-07-07",1990,7,188,0,33600,23600,57200
"TR","1990-07-08",1990,7,189,224000,36500,23400,283900
"TR","1990-07-09",1990,7,190,423000,43700,23800,490500
"TR","1990-07-10",1990,7,191,55900,40000,22200,118100
"TR","1990-07-11",1990,7,192,0,38100,22300,60400
"TR","1990-07-12",1990,7,193,0,36800,22600,59400
"TR","1990-07-13",1990,7,194,0,36000,22800,58800
"TR","1990-07-14",1990,7,195,0,35000,23000,58000
"TR","1990-07-15",1990,7,196,56100,34500,23100,113700
"TR","1990-07-16",1990,7,197,67300,34700,23000,125000
"TR","1990-07-17",1990,7,198,34500,34300,22900,91700
"TR","1990-07-18",1990,7,199,24600,33800,22900,81300
"TR","1990-07-19",1990,7,200,80300,34300,23100,137700
"TR","1990-07-20",1990,7,201,91300,34900,22900,149100
"TR","1990-07-21",1990,7,202,48400,34200,22900,105500
"TR","1990-07-22",1990,7,203,0,32700,22800,55500
"TR","1990-07-23",1990,7,204,42000,32500,22800,97300
"TR","1990-07-24",1990,7,205,114000,33700,23000,170700
"TR","1990-07-25",1990,7,206,0,32400,22700,55100
"TR","1990-07-26",1990,7,207,0,31400,22900,54300
"TR","1990-07-27",1990,7,208,35000,31100,22900,89000
"TR","1990-07-28",1990,7,209,35200,31000,22900,89100
"TR","1990-07-29",1990,7,210,18100,30500,22900,71500
"TR","1990-07-30",1990,7,211,93600,31700,22900,148200
"TR","1990-07-31",1990,7,212,90700,32200,22800,145700
"TR","1990-08-01",1990,8,213,0,31000,22600,53600
"TR","1990-08-02",1990,8,214,0,29900,23100,53000
"TR","1990-08-03",1990,8,215,0,29200,23500,52700
"TR","1990-08-04",1990,8,216,16700,28900,23600,69200
"TR","1990-08-05",1990,8,217,0,28300,23800,52100
"TR","1990-08-06",1990,8,218,0,28200,23800,52000
"TR","1990-08-07",1990,8,219,0,27700,24100,51800
"TR","1990-08-08",1990,8,220,0,27000,24300,51300
"TR","1990-08-09",1990,8,221,0,26300,24600,50900
"TR","1990-08-10",1990,8,222,274000,30700,24300,329000
"TR","1990-08-11",1990,8,223,549000,40100,29500,618600
"TR","1990-08-12",1990,8,224,0,35000,21900,56900
"TR","1990-08-13",1990,8,225,2660,34300,22500,59460
"TR","1990-08-14",1990,8,226,148000,36000,23100,207100
"TR","1990-08-15",1990,8,227,0,34100,22800,56900
"TR","1990-08-16",1990,8,228,293000,38800,32500,364300
"TR","1990-08-17",1990,8,229,0,36100,22500,58600
"TR","1990-08-18",1990,8,230,358000,43700,29400,431100
"TR","1990-08-19",1990,8,231,134000,41700,25000,200700
"TR","1990-08-20",1990,8,232,334000,49300,49300,432600
"TR","1990-08-21",1990,8,233,33000,45000,21800,99800
"TR","1990-08-22",1990,8,234,0,43600,21800,65400
"TR","1990-08-23",1990,8,235,0,42300,22200,64500
"TR","1990-08-24",1990,8,236,0,40900,22500,63400
"TR","1990-08-25",1990,8,237,5330,39900,22600,67830
"TR","1990-08-26",1990,8,238,191000,42700,23300,257000
"TR","1990-08-27",1990,8,239,392000,54500,45100,491600
"TR","1990-08-28",1990,8,240,11400,46300,22300,80000
"TR","1990-08-29",1990,8,241,42200,44400,22200,108800
"TR","1990-08-30",1990,8,242,42600,43800,22600,109000
"TR","1990-08-31",1990,8,243,0,42000,22800,64800
"TR","1990-09-01",1990,9,244,107000,42300,23300,172600
"TR","1990-09-02",1990,9,245,5000,41000,23000,69000
"TR","1990-09-03",1990,9,246,0,39800,23100,62900
"TR","1990-09-04",1990,9,247,19800,39200,23200,82200
"TR","1990-09-05",1990,9,248,35900,38900,23500,98300
"TR","1990-09-06",1990,9,249,224000,43100,23900,291000
"TR","1990-09-07",1990,9,250,686000,70400,57300,813700
"TR","1990-09-08",1990,9,251,212000,68300,34400,314700
"TR","1990-09-09",1990,9,252,0,58800,21300,80100
"TR","1990-09-10",1990,9,253,26400,54000,22100,102500
"TR","1990-09-11",1990,9,254,4270,49400,22500,76170
"TR","1990-09-12",1990,9,255,85800,49000,23100,157900
"TR","1990-09-13",1990,9,256,168000,55300,29600,252900
"TR","1990-09-14",1990,9,257,106000,53500,25300,184800
"TR","1990-09-15",1990,9,258,253000,66600,44300,363900
"TR","1990-09-16",1990,9,259,64100,60100,24100,148300
"TR","1990-09-17",1990,9,260,50600,57000,25800,133400
"TR","1990-09-18",1990,9,261,0,52200,23300,75500
"TR","1990-09-19",1990,9,262,46200,50400,23800,120400
"TR","1990-09-20",1990,9,263,86300,52000,26900,165200
"TR","1990-09-21",1990,9,264,33000,49200,24200,106400
"TR","1990-09-22",1990,9,265,60100,49400,26800,136300
"TR","1990-09-23",1990,9,266,37700,47500,24700,109900
"TR","1990-09-24",1990,9,267,24200,46100,24900,95200
"TR","1990-09-25",1990,9,268,0,45000,24900,69900
"TR","1990-09-26",1990,9,269,0,44300,25100,69400
"TR","1990-09-27",1990,9,270,0,43400,25200,68600
"TR","1990-09-28",1990,9,271,0,42600,25200,67800
"TR","1990-09-29",1990,9,272,0,41900,25300,67200
"TR","1990-09-30",1990,9,273,33000,41800,25200,1e+05
"TR","1990-10-01",1990,10,274,68400,42900,25300,136600
"TR","1990-10-02",1990,10,275,82900,44400,25500,152800
"TR","1990-10-03",1990,10,276,64400,45300,26100,135800
"TR","1990-10-04",1990,10,277,158000,49000,32800,239800
"TR","1990-10-05",1990,10,278,98900,53000,35200,187100
"TR","1990-10-06",1990,10,279,0,49000,26200,75200
"TR","1990-10-07",1990,10,280,16100,46600,25100,87800
"TR","1990-10-08",1990,10,281,11700,45600,25200,82500
"TR","1990-10-09",1990,10,282,0,44800,25200,70000
"TR","1990-10-10",1990,10,283,0,44300,25400,69700
"TR","1990-10-11",1990,10,284,0,44000,25500,69500
"TR","1990-10-12",1990,10,285,99300,46100,25700,171100
"TR","1990-10-13",1990,10,286,8130,45800,25600,79530
"TR","1990-10-14",1990,10,287,0,44800,25700,70500
"TR","1990-10-15",1990,10,288,356000,63900,36900,456800
"TR","1990-10-16",1990,10,289,32600,57900,35700,126200
"TR","1990-10-17",1990,10,290,0,52800,24800,77600
"TR","1990-10-18",1990,10,291,830000,109000,79800,1018800
"TR","1990-10-19",1990,10,292,264000,93900,39400,397300
"TR","1990-10-20",1990,10,293,6850,86700,24000,117550
"TR","1990-10-21",1990,10,294,0,82300,25200,107500
"TR","1990-10-22",1990,10,295,332000,94400,34100,460500
"TR","1990-10-23",1990,10,296,0,82800,28800,111600
"TR","1990-10-24",1990,10,297,0,77600,30100,107700
"TR","1990-10-25",1990,10,298,0,70600,31200,101800
"TR","1990-10-26",1990,10,299,23400,67000,26800,117200
"TR","1990-10-27",1990,10,300,0,62900,27300,90200
"TR","1990-10-28",1990,10,301,48300,61600,28000,137900
"TR","1990-10-29",1990,10,302,6850,58700,28100,93650
"TR","1990-10-30",1990,10,303,0,56300,28400,84700
"TR","1990-10-31",1990,10,304,0,54300,28800,83100
"TR","1990-11-01",1990,11,305,0,52900,29000,81900
"TR","1990-11-02",1990,11,306,0,51400,29200,80600
"TR","1990-11-03",1990,11,307,0,50000,29200,79200
"TR","1990-11-04",1990,11,308,0,49300,29200,78500
"TR","1990-11-05",1990,11,309,36800,50200,29200,116200
"TR","1990-11-06",1990,11,310,0,49000,29100,78100
"TR","1990-11-07",1990,11,311,0,48700,29300,78000
"TR","1990-11-08",1990,11,312,0,48500,29400,77900
"TR","1990-11-09",1990,11,313,0,48300,29400,77700
"TR","1990-11-10",1990,11,314,2160,48200,29600,79960
"TR","1990-11-11",1990,11,315,0,48000,29700,77700
"TR","1990-11-12",1990,11,316,0,47800,29800,77600
"TR","1990-11-13",1990,11,317,0,47600,29900,77500
"TR","1990-11-14",1990,11,318,0,47400,30000,77400
"TR","1990-11-15",1990,11,319,0,47300,30000,77300
"TR","1990-11-16",1990,11,320,0,47000,30200,77200
"TR","1990-11-17",1990,11,321,0,46800,30300,77100
"TR","1990-11-18",1990,11,322,0,46600,30300,76900
"TR","1990-11-19",1990,11,323,0,46400,30400,76800
"TR","1990-11-20",1990,11,324,0,46300,30400,76700
"TR","1990-11-21",1990,11,325,0,46100,30500,76600
"TR","1990-11-22",1990,11,326,168000,50600,31500,250100
"TR","1990-11-23",1990,11,327,13300,48500,30100,91900
"TR","1990-11-24",1990,11,328,0,47500,29900,77400
"TR","1990-11-25",1990,11,329,0,47000,29900,76900
"TR","1990-11-26",1990,11,330,0,46800,29800,76600
"TR","1990-11-27",1990,11,331,0,46500,29800,76300
"TR","1990-11-28",1990,11,332,66700,47300,29500,143500
"TR","1990-11-29",1990,11,333,82100,49400,29200,160700
"TR","1990-11-30",1990,11,334,39200,50100,29000,118300
"TR","1990-12-01",1990,12,335,0,49000,29100,78100
"TR","1990-12-02",1990,12,336,0,48300,29200,77500
"TR","1990-12-03",1990,12,337,0,47800,29200,77000
"TR","1990-12-04",1990,12,338,0,47400,29200,76600
"TR","1990-12-05",1990,12,339,98300,49300,28800,176400
"TR","1990-12-06",1990,12,340,0,48500,28700,77200
"TR","1990-12-07",1990,12,341,0,47900,28800,76700
"TR","1990-12-08",1990,12,342,0,47300,28800,76100
"TR","1990-12-09",1990,12,343,0,47000,28900,75900
"TR","1990-12-10",1990,12,344,0,46900,28900,75800
"TR","1990-12-11",1990,12,345,0,46800,28900,75700
"TR","1990-12-12",1990,12,346,0,46600,28900,75500
"TR","1990-12-13",1990,12,347,0,46400,28900,75300
"TR","1990-12-14",1990,12,348,0,46300,28800,75100
"TR","1990-12-15",1990,12,349,0,46100,28800,74900
"TR","1990-12-16",1990,12,350,14800,46100,28700,89600
"TR","1990-12-17",1990,12,351,54800,46300,28400,129500
"TR","1990-12-18",1990,12,352,754,46200,28300,75254
"TR","1990-12-19",1990,12,353,8790,46100,28300,83190
"TR","1990-12-20",1990,12,354,0,46000,28300,74300
"TR","1990-12-21",1990,12,355,0,45800,28300,74100
"TR","1990-12-22",1990,12,356,1450,45700,28300,75450
"TR","1990-12-23",1990,12,357,47800,45900,28000,121700
"TR","1990-12-24",1990,12,358,0,45700,28000,73700
"TR","1990-12-25",1990,12,359,0,45600,28000,73600
"TR","1990-12-26",1990,12,360,30500,45700,27800,104000
"TR","1990-12-27",1990,12,361,0,45500,27800,73300
"TR","1990-12-28",1990,12,362,0,45400,27800,73200
"TR","1990-12-29",1990,12,363,0,45200,27800,73000
"TR","1990-12-30",1990,12,364,5150,45100,27800,78050
"TR","1990-12-31",1990,12,365,0,45000,27800,72800
"TR","1991-01-01",1991,1,1,0,44800,27700,72500
"TR","1991-01-02",1991,1,2,0,44700,27700,72400
"TR","1991-01-03",1991,1,3,0,44600,27700,72300
"TR","1991-01-04",1991,1,4,0,44400,27600,72000
"TR","1991-01-05",1991,1,5,0,44300,27600,71900
"TR","1991-01-06",1991,1,6,0,44200,27600,71800
"TR","1991-01-07",1991,1,7,0,44000,27500,71500
"TR","1991-01-08",1991,1,8,0,43900,27500,71400
"TR","1991-01-09",1991,1,9,0,43800,27400,71200
"TR","1991-01-10",1991,1,10,49800,44000,27200,121000
"TR","1991-01-11",1991,1,11,0,43900,27100,71000
"TR","1991-01-12",1991,1,12,25900,43900,27000,96800
"TR","1991-01-13",1991,1,13,12300,43800,27000,83100
"TR","1991-01-14",1991,1,14,17000,43800,26900,87700
"TR","1991-01-15",1991,1,15,62700,44000,26600,133300
"TR","1991-01-16",1991,1,16,39600,44200,26500,110300
"TR","1991-01-17",1991,1,17,0,44000,26500,70500
"TR","1991-01-18",1991,1,18,3670,43800,26600,74070
"TR","1991-01-19",1991,1,19,0,43600,26600,70200
"TR","1991-01-20",1991,1,20,0,43400,26700,70100
"TR","1991-01-21",1991,1,21,1260,43200,26700,71160
"TR","1991-01-22",1991,1,22,0,43100,26700,69800
"TR","1991-01-23",1991,1,23,19800,43100,26600,89500
"TR","1991-01-24",1991,1,24,85300,43400,26200,154900
"TR","1991-01-25",1991,1,25,0,43200,26100,69300
"TR","1991-01-26",1991,1,26,0,43100,26200,69300
"TR","1991-01-27",1991,1,27,0,42900,26300,69200
"TR","1991-01-28",1991,1,28,14600,42800,26300,83700
"TR","1991-01-29",1991,1,29,110000,43300,25800,179100
"TR","1991-01-30",1991,1,30,0,43200,25700,68900
"TR","1991-01-31",1991,1,31,0,43000,25900,68900
"TR","1991-02-01",1991,2,32,1260,42800,25900,69960
"TR","1991-02-02",1991,2,33,0,42600,26000,68600
"TR","1991-02-03",1991,2,34,0,42500,26000,68500
"TR","1991-02-04",1991,2,35,0,42300,26000,68300
"TR","1991-02-05",1991,2,36,0,42100,26100,68200
"TR","1991-02-06",1991,2,37,0,41900,26100,68000
"TR","1991-02-07",1991,2,38,0,41700,26100,67800
"TR","1991-02-08",1991,2,39,0,41500,26100,67600
"TR","1991-02-09",1991,2,40,0,41400,26100,67500
"TR","1991-02-10",1991,2,41,0,41600,26200,67800
"TR","1991-02-11",1991,2,42,0,41300,26100,67400
"TR","1991-02-12",1991,2,43,0,41000,26000,67000
"TR","1991-02-13",1991,2,44,0,40900,26000,66900
"TR","1991-02-14",1991,2,45,0,40700,26000,66700
"TR","1991-02-15",1991,2,46,42700,40900,25800,109400
"TR","1991-02-16",1991,2,47,11300,40800,25700,77800
"TR","1991-02-17",1991,2,48,0,40700,25700,66400
"TR","1991-02-18",1991,2,49,0,40600,25700,66300
"TR","1991-02-19",1991,2,50,0,40400,25700,66100
"TR","1991-02-20",1991,2,51,44300,40600,25500,110400
"TR","1991-02-21",1991,2,52,1950,40500,25500,67950
"TR","1991-02-22",1991,2,53,0,40300,25500,65800
"TR","1991-02-23",1991,2,54,0,40200,25500,65700
"TR","1991-02-24",1991,2,55,0,40100,25500,65600
"TR","1991-02-25",1991,2,56,77600,40500,25200,143300
"TR","1991-02-26",1991,2,57,0,40400,25100,65500
"TR","1991-02-27",1991,2,58,0,40200,25200,65400
"TR","1991-02-28",1991,2,59,10700,40100,25200,76000
"TR","1991-03-01",1991,3,60,0,40000,25200,65200
"TR","1991-03-02",1991,3,61,0,39800,25300,65100
"TR","1991-03-03",1991,3,62,30500,39800,25200,95500
"TR","1991-03-04",1991,3,63,0,39600,25200,64800
"TR","1991-03-05",1991,3,64,0,39400,25200,64600
"TR","1991-03-06",1991,3,65,10600,39300,25300,75200
"TR","1991-03-07",1991,3,66,202000,40400,24400,266800
"TR","1991-03-08",1991,3,67,49800,40600,24100,114500
"TR","1991-03-09",1991,3,68,0,40400,24200,64600
"TR","1991-03-10",1991,3,69,31500,40400,24300,96200
"TR","1991-03-11",1991,3,70,0,40100,24400,64500
"TR","1991-03-12",1991,3,71,0,39800,24600,64400
"TR","1991-03-13",1991,3,72,0,39600,24700,64300
"TR","1991-03-14",1991,3,73,0,39300,24800,64100
"TR","1991-03-15",1991,3,74,0,39000,24900,63900
"TR","1991-03-16",1991,3,75,0,38700,25000,63700
"TR","1991-03-17",1991,3,76,0,38400,25100,63500
"TR","1991-03-18",1991,3,77,0,38300,25100,63400
"TR","1991-03-19",1991,3,78,0,38400,25200,63600
"TR","1991-03-20",1991,3,79,1200,40700,25500,67400
"TR","1991-03-21",1991,3,80,91700,54100,42300,188100
"TR","1991-03-22",1991,3,81,246000,50800,41800,338600
"TR","1991-03-23",1991,3,82,243000,49600,29400,322000
"TR","1991-03-24",1991,3,83,351000,56300,26800,434100
"TR","1991-03-25",1991,3,84,43500,56100,27200,126800
"TR","1991-03-26",1991,3,85,17200,58400,32300,107900
"TR","1991-03-27",1991,3,86,25600,65200,50900,141700
"TR","1991-03-28",1991,3,87,106000,99300,64300,269600
"TR","1991-03-29",1991,3,88,357000,77700,28900,463600
"TR","1991-03-30",1991,3,89,10400,70200,23900,104500
"TR","1991-03-31",1991,3,90,0,64200,24200,88400
"TR","1991-04-01",1991,4,91,8370,59800,24700,92870
"TR","1991-04-02",1991,4,92,0,57300,25300,82600
"TR","1991-04-03",1991,4,93,0,56100,28200,84300
"TR","1991-04-04",1991,4,94,0,56800,34600,91400
"TR","1991-04-05",1991,4,95,0,56800,42100,98900
"TR","1991-04-06",1991,4,96,0,54600,29100,83700
"TR","1991-04-07",1991,4,97,0,51900,26400,78300
"TR","1991-04-08",1991,4,98,114000,54500,26800,195300
"TR","1991-04-09",1991,4,99,571000,93600,66900,731500
"TR","1991-04-10",1991,4,100,418000,82000,27900,527900
"TR","1991-04-11",1991,4,101,67700,78700,25000,171400
"TR","1991-04-12",1991,4,102,0,73900,26000,99900
"TR","1991-04-13",1991,4,103,0,71100,30100,101200
"TR","1991-04-14",1991,4,104,273000,87300,34500,394800
"TR","1991-04-15",1991,4,105,59300,79600,42500,181400
"TR","1991-04-16",1991,4,106,181000,84700,40900,306600
"TR","1991-04-17",1991,4,107,74700,84100,46600,205400
"TR","1991-04-18",1991,4,108,0,74600,34500,109100
"TR","1991-04-19",1991,4,109,0,68700,27900,96600
"TR","1991-04-20",1991,4,110,0,64400,28300,92700
"TR","1991-04-21",1991,4,111,0,61600,28700,90300
"TR","1991-04-22",1991,4,112,0,59000,29100,88100
"TR","1991-04-23",1991,4,113,99100,61800,30200,191100
"TR","1991-04-24",1991,4,114,131000,65700,31500,228200
"TR","1991-04-25",1991,4,115,16900,61600,30200,108700
"TR","1991-04-26",1991,4,116,0,58400,30300,88700
"TR","1991-04-27",1991,4,117,0,56000,30600,86600
"TR","1991-04-28",1991,4,118,0,54200,30500,84700
"TR","1991-04-29",1991,4,119,237000,64500,33000,334500
"TR","1991-04-30",1991,4,120,169000,67500,37500,274000
"TR","1991-05-01",1991,5,121,175000,74400,41900,291300
"TR","1991-05-02",1991,5,122,70200,71500,35100,176800
"TR","1991-05-03",1991,5,123,9980,66300,30900,107180
"TR","1991-05-04",1991,5,124,92200,67700,36200,196100
"TR","1991-05-05",1991,5,125,64100,67500,35100,166700
"TR","1991-05-06",1991,5,126,135000,70200,36700,241900
"TR","1991-05-07",1991,5,127,333000,90000,57500,480500
"TR","1991-05-08",1991,5,128,63300,79200,35100,177600
"TR","1991-05-09",1991,5,129,6710,72600,31400,110710
"TR","1991-05-10",1991,5,130,0,67800,31700,99500
"TR","1991-05-11",1991,5,131,0,63300,32300,95600
"TR","1991-05-12",1991,5,132,0,58700,31800,90500
"TR","1991-05-13",1991,5,133,0,54800,31700,86500
"TR","1991-05-14",1991,5,134,0,51800,31500,83300
"TR","1991-05-15",1991,5,135,0,50200,31600,81800
"TR","1991-05-16",1991,5,136,111000,51200,31800,194000
"TR","1991-05-17",1991,5,137,333000,62900,33300,429200
"TR","1991-05-18",1991,5,138,32000,59100,31900,123000
"TR","1991-05-19",1991,5,139,0,55800,31800,87600
"TR","1991-05-20",1991,5,140,11200,54400,32100,97700
"TR","1991-05-21",1991,5,141,0,52000,32300,84300
"TR","1991-05-22",1991,5,142,0,50000,32300,82300
"TR","1991-05-23",1991,5,143,0,49000,32000,81000
"TR","1991-05-24",1991,5,144,14400,48600,32000,95000
"TR","1991-05-25",1991,5,145,26100,48400,32000,106500
"TR","1991-05-26",1991,5,146,402000,62300,33500,497800
"TR","1991-05-27",1991,5,147,573000,91800,41700,706500
"TR","1991-05-28",1991,5,148,133000,85000,34400,252400
"TR","1991-05-29",1991,5,149,370000,96900,47000,513900
"TR","1991-05-30",1991,5,150,480000,112000,68500,660500
"TR","1991-05-31",1991,5,151,133000,101000,39300,273300
"TR","1991-06-01",1991,6,152,143000,101000,38800,282800
"TR","1991-06-02",1991,6,153,221000,103000,38200,362200
"TR","1991-06-03",1991,6,154,0,95300,31500,126800
"TR","1991-06-04",1991,6,155,0,90800,32200,123000
"TR","1991-06-05",1991,6,156,0,86500,32200,118700
"TR","1991-06-06",1991,6,157,0,83100,32400,115500
"TR","1991-06-07",1991,6,158,0,77000,32600,109600
"TR","1991-06-08",1991,6,159,0,71900,32800,104700
"TR","1991-06-09",1991,6,160,155000,73100,33900,262000
"TR","1991-06-10",1991,6,161,30500,69000,33400,132900
"TR","1991-06-11",1991,6,162,0,64600,33400,98000
"TR","1991-06-12",1991,6,163,203000,70100,35000,308100
"TR","1991-06-13",1991,6,164,1e+05,69000,35000,204000
"TR","1991-06-14",1991,6,165,22100,65000,34200,121300
"TR","1991-06-15",1991,6,166,491000,88800,39900,619700
"TR","1991-06-16",1991,6,167,106000,78900,35200,220100
"TR","1991-06-17",1991,6,168,16700,72700,34500,123900
"TR","1991-06-18",1991,6,169,0,68000,34500,102500
"TR","1991-06-19",1991,6,170,44200,65800,34900,144900
"TR","1991-06-20",1991,6,171,38000,63800,34800,136600
"TR","1991-06-21",1991,6,172,368000,82300,39600,489900
"TR","1991-06-22",1991,6,173,388000,98100,58100,544200
"TR","1991-06-23",1991,6,174,31000,85900,35900,152800
"TR","1991-06-24",1991,6,175,0,78500,34600,113100
"TR","1991-06-25",1991,6,176,0,73400,34900,108300
"TR","1991-06-26",1991,6,177,0,68800,34800,103600
"TR","1991-06-27",1991,6,178,0,64800,34700,99500
"TR","1991-06-28",1991,6,179,310000,77700,38100,425800
"TR","1991-06-29",1991,6,180,365000,93500,43600,502100
"TR","1991-06-30",1991,6,181,219000,97600,67800,384400
"TR","1991-07-01",1991,7,182,113000,92100,37800,242900
"TR","1991-07-02",1991,7,183,62600,86700,36100,185400
"TR","1991-07-03",1991,7,184,172000,89500,45100,306600
"TR","1991-07-04",1991,7,185,79900,83400,37000,200300
"TR","1991-07-05",1991,7,186,84300,81300,37100,202700
"TR","1991-07-06",1991,7,187,44100,76900,36600,157600
"TR","1991-07-07",1991,7,188,1510,72000,36000,109510
"TR","1991-07-08",1991,7,189,25200,68100,35700,129000
"TR","1991-07-09",1991,7,190,71300,68000,36200,175500
"TR","1991-07-10",1991,7,191,2800,64200,35300,102300
"TR","1991-07-11",1991,7,192,13600,61400,35400,110400
"TR","1991-07-12",1991,7,193,30800,58900,35300,125000
"TR","1991-07-13",1991,7,194,162000,62300,36100,260400
"TR","1991-07-14",1991,7,195,52400,60900,35500,148800
"TR","1991-07-15",1991,7,196,0,57400,35000,92400
"TR","1991-07-16",1991,7,197,0,54600,35100,89700
"TR","1991-07-17",1991,7,198,179000,58100,35700,272800
"TR","1991-07-18",1991,7,199,255000,67400,37600,360000
"TR","1991-07-19",1991,7,200,14000,61800,35400,111200
"TR","1991-07-20",1991,7,201,2660,58000,35200,95860
"TR","1991-07-21",1991,7,202,14000,55600,35000,104600
"TR","1991-07-22",1991,7,203,93100,57600,35700,186400
"TR","1991-07-23",1991,7,204,11600,55200,35100,101900
"TR","1991-07-24",1991,7,205,0,52900,35000,87900
"TR","1991-07-25",1991,7,206,21000,52100,34500,107600
"TR","1991-07-26",1991,7,207,123000,54900,35500,213400
"TR","1991-07-27",1991,7,208,0,53200,34600,87800
"TR","1991-07-28",1991,7,209,154000,56800,35700,246500
"TR","1991-07-29",1991,7,210,211000,63400,36200,310600
"TR","1991-07-30",1991,7,211,237000,73200,37300,347500
"TR","1991-07-31",1991,7,212,19700,66000,34500,120200
"TR","1991-08-01",1991,8,213,0,61400,34500,95900
"TR","1991-08-02",1991,8,214,0,57700,34800,92500
"TR","1991-08-03",1991,8,215,10500,55200,34700,100400
"TR","1991-08-04",1991,8,216,86700,57300,35500,179500
"TR","1991-08-05",1991,8,217,3990,55100,35000,94090
"TR","1991-08-06",1991,8,218,0,52800,35300,88100
"TR","1991-08-07",1991,8,219,0,51600,35300,86900
"TR","1991-08-08",1991,8,220,0,50600,34900,85500
"TR","1991-08-09",1991,8,221,0,50000,34900,84900
"TR","1991-08-10",1991,8,222,0,49100,35100,84200
"TR","1991-08-11",1991,8,223,0,48000,35100,83100
"TR","1991-08-12",1991,8,224,0,46900,35200,82100
"TR","1991-08-13",1991,8,225,0,46000,35200,81200
"TR","1991-08-14",1991,8,226,0,45100,35200,80300
"TR","1991-08-15",1991,8,227,126000,46700,35300,208000
"TR","1991-08-16",1991,8,228,13600,45000,35000,93600
"TR","1991-08-17",1991,8,229,169000,47700,35000,251700
"TR","1991-08-18",1991,8,230,509000,64100,36900,610000
"TR","1991-08-19",1991,8,231,0,55300,33600,88900
"TR","1991-08-20",1991,8,232,0,53200,34200,87400
"TR","1991-08-21",1991,8,233,0,51600,34500,86100
"TR","1991-08-22",1991,8,234,0,50400,34700,85100
"TR","1991-08-23",1991,8,235,0,49100,34600,83700
"TR","1991-08-24",1991,8,236,0,48400,34500,82900
"TR","1991-08-25",1991,8,237,79100,49600,34700,163400
"TR","1991-08-26",1991,8,238,36200,49400,34500,120100
"TR","1991-08-27",1991,8,239,27700,49000,34500,111200
"TR","1991-08-28",1991,8,240,0,47900,34300,82200
"TR","1991-08-29",1991,8,241,0,47100,34300,81400
"TR","1991-08-30",1991,8,242,0,46100,34400,80500
"TR","1991-08-31",1991,8,243,0,45100,34300,79400
"TR","1991-09-01",1991,9,244,0,44100,34300,78400
"TR","1991-09-02",1991,9,245,0,43700,34100,77800
"TR","1991-09-03",1991,9,246,119000,45700,34000,198700
"TR","1991-09-04",1991,9,247,184000,49000,34300,267300
"TR","1991-09-05",1991,9,248,49200,48700,33700,131600
"TR","1991-09-06",1991,9,249,19800,48000,33700,101500
"TR","1991-09-07",1991,9,250,178000,51600,34600,264200
"TR","1991-09-08",1991,9,251,222000,57500,35500,315000
"TR","1991-09-09",1991,9,252,154000,59300,34100,247400
"TR","1991-09-10",1991,9,253,191000,66500,34500,292000
"TR","1991-09-11",1991,9,254,135000,69200,36900,241100
"TR","1991-09-12",1991,9,255,59400,66100,32500,158000
"TR","1991-09-13",1991,9,256,25800,62800,32600,121200
"TR","1991-09-14",1991,9,257,43500,60700,32800,137000
"TR","1991-09-15",1991,9,258,97600,61200,34400,193200
"TR","1991-09-16",1991,9,259,128000,65200,39300,232500
"TR","1991-09-17",1991,9,260,0,59400,32200,91600
"TR","1991-09-18",1991,9,261,16000,56900,32300,105200
"TR","1991-09-19",1991,9,262,54700,57200,32700,144600
"TR","1991-09-20",1991,9,263,37700,56900,32600,127200
"TR","1991-09-21",1991,9,264,5710,55300,32400,93410
"TR","1991-09-22",1991,9,265,0,53500,32300,85800
"TR","1991-09-23",1991,9,266,13200,52500,32500,98200
"TR","1991-09-24",1991,9,267,0,51100,32300,83400
"TR","1991-09-25",1991,9,268,26400,51000,32300,109700
"TR","1991-09-26",1991,9,269,83800,54300,32600,170700
"TR","1991-09-27",1991,9,270,70900,58000,32900,161800
"TR","1991-09-28",1991,9,271,0,56000,32200,88200
"TR","1991-09-29",1991,9,272,0,54100,32300,86400
"TR","1991-09-30",1991,9,273,15800,52800,32200,100800
"TR","1991-10-01",1991,10,274,27300,52600,32300,112200
"TR","1991-10-02",1991,10,275,88500,55600,32500,176600
"TR","1991-10-03",1991,10,276,102000,61900,36500,200400
"TR","1991-10-04",1991,10,277,0,58200,31800,90000
"TR","1991-10-05",1991,10,278,55000,57600,32000,144600
"TR","1991-10-06",1991,10,279,179000,65800,41900,286700
"TR","1991-10-07",1991,10,280,113000,68000,37800,218800
"TR","1991-10-08",1991,10,281,13100,66800,38100,118000
"TR","1991-10-09",1991,10,282,0,62100,30900,93000
"TR","1991-10-10",1991,10,283,0,59100,31300,90400
"TR","1991-10-11",1991,10,284,6350,57200,31200,94750
"TR","1991-10-12",1991,10,285,13500,56200,31300,101000
"TR","1991-10-13",1991,10,286,5210,54700,31200,91110
"TR","1991-10-14",1991,10,287,41300,55400,31400,128100
"TR","1991-10-15",1991,10,288,109000,59800,32100,200900
"TR","1991-10-16",1991,10,289,45700,60600,31800,138100
"TR","1991-10-17",1991,10,290,7630,58700,31500,97830
"TR","1991-10-18",1991,10,291,0,56000,31400,87400
"TR","1991-10-19",1991,10,292,0,54100,31500,85600
"TR","1991-10-20",1991,10,293,0,53100,31200,84300
"TR","1991-10-21",1991,10,294,0,52600,31100,83700
"TR","1991-10-22",1991,10,295,12600,52500,31200,96300
"TR","1991-10-23",1991,10,296,0,51500,31000,82500
"TR","1991-10-24",1991,10,297,0,51000,31100,82100
"TR","1991-10-25",1991,10,298,217000,63000,34800,314800
"TR","1991-10-26",1991,10,299,122000,67700,42300,232000
"TR","1991-10-27",1991,10,300,40700,64900,34400,140000
"TR","1991-10-28",1991,10,301,10300,61400,30900,102600
"TR","1991-10-29",1991,10,302,0,58700,30700,89400
"TR","1991-10-30",1991,10,303,112000,64000,36300,212300
"TR","1991-10-31",1991,10,304,117000,69600,39700,226300
"TR","1991-11-01",1991,11,305,254000,69000,30000,353000
"TR","1991-11-02",1991,11,306,531000,77600,28300,636900
"TR","1991-11-03",1991,11,307,661000,83300,25900,770200
"TR","1991-11-04",1991,11,308,32800,80900,25900,139600
"TR","1991-11-05",1991,11,309,7220,77100,26700,111020
"TR","1991-11-06",1991,11,310,0,72200,27300,99500
"TR","1991-11-07",1991,11,311,57300,69900,27600,154800
"TR","1991-11-08",1991,11,312,0,66400,27900,94300
"TR","1991-11-09",1991,11,313,0,63800,28300,92100
"TR","1991-11-10",1991,11,314,0,61500,28700,90200
"TR","1991-11-11",1991,11,315,71800,61800,28700,162300
"TR","1991-11-12",1991,11,316,0,59900,29000,88900
"TR","1991-11-13",1991,11,317,0,58300,29400,87700
"TR","1991-11-14",1991,11,318,0,56900,29700,86600
"TR","1991-11-15",1991,11,319,0,55800,30000,85800
"TR","1991-11-16",1991,11,320,60800,56900,29800,147500
"TR","1991-11-17",1991,11,321,0,55800,29900,85700
"TR","1991-11-18",1991,11,322,1e+05,57000,29600,186600
"TR","1991-11-19",1991,11,323,238000,62600,28700,329300
"TR","1991-11-20",1991,11,324,0,60100,28800,88900
"TR","1991-11-21",1991,11,325,0,58400,29300,87700
"TR","1991-11-22",1991,11,326,55900,61900,31900,149700
"TR","1991-11-23",1991,11,327,51300,66200,40500,158000
"TR","1991-11-24",1991,11,328,128000,65200,30300,223500
"TR","1991-11-25",1991,11,329,272000,68900,28400,369300
"TR","1991-11-26",1991,11,330,25400,66200,28200,119800
"TR","1991-11-27",1991,11,331,0,63600,28600,92200
"TR","1991-11-28",1991,11,332,33400,62600,28900,124900
"TR","1991-11-29",1991,11,333,0,60600,29200,89800
"TR","1991-11-30",1991,11,334,0,59000,29400,88400
"TR","1991-12-01",1991,12,335,318000,66500,28300,412800
"TR","1991-12-02",1991,12,336,0,63800,28300,92100
"TR","1991-12-03",1991,12,337,0,61500,28700,90200
"TR","1991-12-04",1991,12,338,18800,60200,29000,108000
"TR","1991-12-05",1991,12,339,0,58600,29200,87800
"TR","1991-12-06",1991,12,340,9220,57700,29400,96320
"TR","1991-12-07",1991,12,341,19500,57100,29500,106100
"TR","1991-12-08",1991,12,342,21300,56700,29500,107500
"TR","1991-12-09",1991,12,343,2840,55900,29700,88440
"TR","1991-12-10",1991,12,344,0,55100,29800,84900
"TR","1991-12-11",1991,12,345,0,54400,29900,84300
"TR","1991-12-12",1991,12,346,0,53900,30000,83900
"TR","1991-12-13",1991,12,347,92400,55700,29700,177800
"TR","1991-12-14",1991,12,348,54600,56200,29400,140200
"TR","1991-12-15",1991,12,349,2340,55300,29500,87140
"TR","1991-12-16",1991,12,350,0,54500,29700,84200
"TR","1991-12-17",1991,12,351,754,53900,29800,84454
"TR","1991-12-18",1991,12,352,13600,53700,29900,97200
"TR","1991-12-19",1991,12,353,15700,53700,29900,99300
"TR","1991-12-20",1991,12,354,0,53200,29900,83100
"TR","1991-12-21",1991,12,355,7270,52900,29900,90070
"TR","1991-12-22",1991,12,356,0,52400,30000,82400
"TR","1991-12-23",1991,12,357,0,52200,30100,82300
"TR","1991-12-24",1991,12,358,0,52100,30100,82200
"TR","1991-12-25",1991,12,359,0,51900,30100,82000
"TR","1991-12-26",1991,12,360,0,51800,30100,81900
"TR","1991-12-27",1991,12,361,0,51600,30200,81800
"TR","1991-12-28",1991,12,362,0,51500,30200,81700
"TR","1991-12-29",1991,12,363,0,51300,30200,81500
"TR","1991-12-30",1991,12,364,0,51200,30200,81400
"TR","1991-12-31",1991,12,365,0,51000,30200,81200
"TR","1992-01-01",1992,1,1,0,50900,30200,81100
"TR","1992-01-02",1992,1,2,0,50700,30200,80900
"TR","1992-01-03",1992,1,3,11300,50600,30100,92000
"TR","1992-01-04",1992,1,4,48500,50900,29900,129300
"TR","1992-01-05",1992,1,5,0,50800,29900,80700
"TR","1992-01-06",1992,1,6,1880,50600,29900,82380
"TR","1992-01-07",1992,1,7,2020,50400,29900,82320
"TR","1992-01-08",1992,1,8,0,50300,30000,80300
"TR","1992-01-09",1992,1,9,46400,50400,29800,126600
"TR","1992-01-10",1992,1,10,36500,50500,29600,116600
"TR","1992-01-11",1992,1,11,0,50300,29600,79900
"TR","1992-01-12",1992,1,12,0,50200,29600,79800
"TR","1992-01-13",1992,1,13,0,50000,29700,79700
"TR","1992-01-14",1992,1,14,28100,50000,29600,107700
"TR","1992-01-15",1992,1,15,8790,49900,29500,88190
"TR","1992-01-16",1992,1,16,0,49800,29500,79300
"TR","1992-01-17",1992,1,17,18800,49700,29400,97900
"TR","1992-01-18",1992,1,18,27500,49800,29300,106600
"TR","1992-01-19",1992,1,19,0,49700,29300,79000
"TR","1992-01-20",1992,1,20,23200,49700,29200,102100
"TR","1992-01-21",1992,1,21,38600,49900,29000,117500
"TR","1992-01-22",1992,1,22,0,49700,29100,78800
"TR","1992-01-23",1992,1,23,59700,50000,28800,138500
"TR","1992-01-24",1992,1,24,102000,51400,28400,181800
"TR","1992-01-25",1992,1,25,18200,51000,28300,97500
"TR","1992-01-26",1992,1,26,0,50300,28500,78800
"TR","1992-01-27",1992,1,27,9380,50100,28600,88080
"TR","1992-01-28",1992,1,28,45100,50600,28400,124100
"TR","1992-01-29",1992,1,29,0,50000,28500,78500
"TR","1992-01-30",1992,1,30,0,49800,28600,78400
"TR","1992-01-31",1992,1,31,0,49500,28700,78200
"TR","1992-02-01",1992,2,32,0,49300,28800,78100
"TR","1992-02-02",1992,2,33,0,49100,28800,77900
"TR","1992-02-03",1992,2,34,0,48900,28800,77700
"TR","1992-02-04",1992,2,35,0,48700,28800,77500
"TR","1992-02-05",1992,2,36,0,48600,28800,77400
"TR","1992-02-06",1992,2,37,0,48400,28800,77200
"TR","1992-02-07",1992,2,38,0,48200,28700,76900
"TR","1992-02-08",1992,2,39,19300,48200,28600,96100
"TR","1992-02-09",1992,2,40,9720,48100,28600,86420
"TR","1992-02-10",1992,2,41,1420,48000,28500,77920
"TR","1992-02-11",1992,2,42,5630,47800,28500,81930
"TR","1992-02-12",1992,2,43,5480,47800,28500,81780
"TR","1992-02-13",1992,2,44,1130,47600,28500,77230
"TR","1992-02-14",1992,2,45,0,47500,28500,76000
"TR","1992-02-15",1992,2,46,0,47300,28500,75800
"TR","1992-02-16",1992,2,47,0,47200,28500,75700
"TR","1992-02-17",1992,2,48,0,47000,28400,75400
"TR","1992-02-18",1992,2,49,0,46900,28400,75300
"TR","1992-02-19",1992,2,50,0,46700,28400,75100
"TR","1992-02-20",1992,2,51,0,46600,28400,75000
"TR","1992-02-21",1992,2,52,16900,46500,28300,91700
"TR","1992-02-22",1992,2,53,23300,46600,28200,98100
"TR","1992-02-23",1992,2,54,17100,46600,28100,91800
"TR","1992-02-24",1992,2,55,0,46500,28100,74600
"TR","1992-02-25",1992,2,56,81400,46800,27700,155900
"TR","1992-02-26",1992,2,57,87000,47400,27300,161700
"TR","1992-02-27",1992,2,58,0,47200,27300,74500
"TR","1992-02-28",1992,2,59,5630,47100,27500,80230
"TR","1992-02-29",1992,2,60,25700,47100,27400,100200
"TR","1992-03-01",1992,3,61,0,46900,27500,74400
"TR","1992-03-02",1992,3,62,0,46700,27600,74300
"TR","1992-03-03",1992,3,63,0,46400,27700,74100
"TR","1992-03-04",1992,3,64,0,46100,27800,73900
"TR","1992-03-05",1992,3,65,0,45800,27800,73600
"TR","1992-03-06",1992,3,66,134000,46300,27200,207500
"TR","1992-03-07",1992,3,67,93300,46900,26700,166900
"TR","1992-03-08",1992,3,68,59900,48100,26600,134600
"TR","1992-03-09",1992,3,69,98700,48400,26400,173500
"TR","1992-03-10",1992,3,70,192000,49700,25800,267500
"TR","1992-03-11",1992,3,71,111000,51600,25400,188000
"TR","1992-03-12",1992,3,72,0,50000,25600,75600
"TR","1992-03-13",1992,3,73,0,48800,25900,74700
"TR","1992-03-14",1992,3,74,0,48400,26100,74500
"TR","1992-03-15",1992,3,75,0,48100,26300,74400
"TR","1992-03-16",1992,3,76,0,47800,26400,74200
"TR","1992-03-17",1992,3,77,0,47500,26600,74100
"TR","1992-03-18",1992,3,78,0,47000,26800,73800
"TR","1992-03-19",1992,3,79,0,46700,26800,73500
"TR","1992-03-20",1992,3,80,0,46400,26900,73300
"TR","1992-03-21",1992,3,81,10500,46200,26900,83600
"TR","1992-03-22",1992,3,82,0,45900,27000,72900
"TR","1992-03-23",1992,3,83,0,45600,27000,72600
"TR","1992-03-24",1992,3,84,0,45300,27100,72400
"TR","1992-03-25",1992,3,85,0,44900,27200,72100
"TR","1992-03-26",1992,3,86,4460,44600,27300,76360
"TR","1992-03-27",1992,3,87,2230,44400,27300,73930
"TR","1992-03-28",1992,3,88,0,44200,27300,71500
"TR","1992-03-29",1992,3,89,0,44000,27300,71300
"TR","1992-03-30",1992,3,90,6830,43800,27300,77930
"TR","1992-03-31",1992,3,91,4460,43500,27300,75260
"TR","1992-04-01",1992,4,92,0,43300,27300,70600
"TR","1992-04-02",1992,4,93,24100,43300,27200,94600
"TR","1992-04-03",1992,4,94,0,43200,27100,70300
"TR","1992-04-04",1992,4,95,0,43100,27200,70300
"TR","1992-04-05",1992,4,96,9880,43300,27100,80280
"TR","1992-04-06",1992,4,97,0,44000,27100,71100
"TR","1992-04-07",1992,4,98,0,45000,27200,72200
"TR","1992-04-08",1992,4,99,33000,58100,48300,139400
"TR","1992-04-09",1992,4,100,0,51300,33800,85100
"TR","1992-04-10",1992,4,101,0,51700,33200,84900
"TR","1992-04-11",1992,4,102,89400,55700,41900,187000
"TR","1992-04-12",1992,4,103,225000,54400,27200,306600
"TR","1992-04-13",1992,4,104,1410,52100,26500,80010
"TR","1992-04-14",1992,4,105,0,50800,26700,77500
"TR","1992-04-15",1992,4,106,2410,50200,26900,79510
"TR","1992-04-16",1992,4,107,76000,51500,26900,154400
"TR","1992-04-17",1992,4,108,145000,57500,33000,235500
"TR","1992-04-18",1992,4,109,0,55900,30500,86400
"TR","1992-04-19",1992,4,110,30400,71400,52400,154200
"TR","1992-04-20",1992,4,111,41700,141000,222000,404700
"TR","1992-04-21",1992,4,112,82000,318000,478000,878000
"TR","1992-04-22",1992,4,113,144000,393000,527000,1064000
"TR","1992-04-23",1992,4,114,24900,140000,56400,221300
"TR","1992-04-24",1992,4,115,29900,129000,44900,203800
"TR","1992-04-25",1992,4,116,3280,122000,42400,167680
"TR","1992-04-26",1992,4,117,2820,117000,41800,161620
"TR","1992-04-27",1992,4,118,0,112000,36800,148800
"TR","1992-04-28",1992,4,119,0,107000,39200,146200
"TR","1992-04-29",1992,4,120,0,103000,43400,146400
"TR","1992-04-30",1992,4,121,0,100000,42900,142900
"TR","1992-05-01",1992,5,122,0,96900,33200,130100
"TR","1992-05-02",1992,5,123,0,94200,33000,127200
"TR","1992-05-03",1992,5,124,77600,93700,33700,205000
"TR","1992-05-04",1992,5,125,15400,89200,32900,137500
"TR","1992-05-05",1992,5,126,0,85700,33000,118700
"TR","1992-05-06",1992,5,127,0,83100,33400,116500
"TR","1992-05-07",1992,5,128,0,78700,33700,112400
"TR","1992-05-08",1992,5,129,0,73500,33900,107400
"TR","1992-05-09",1992,5,130,0,68600,34200,102800
"TR","1992-05-10",1992,5,131,0,63300,33900,97200
"TR","1992-05-11",1992,5,132,0,59100,33800,92900
"TR","1992-05-12",1992,5,133,215000,63900,34200,313100
"TR","1992-05-13",1992,5,134,134000,66400,34700,235100
"TR","1992-05-14",1992,5,135,0,61900,33700,95600
"TR","1992-05-15",1992,5,136,48800,60900,34000,143700
"TR","1992-05-16",1992,5,137,133000,64800,35200,233000
"TR","1992-05-17",1992,5,138,377000,80900,43400,501300
"TR","1992-05-18",1992,5,139,398000,98700,65100,561800
"TR","1992-05-19",1992,5,140,124000,92100,40000,256100
"TR","1992-05-20",1992,5,141,0,85200,33400,118600
"TR","1992-05-21",1992,5,142,0,77600,33600,111200
"TR","1992-05-22",1992,5,143,33300,72200,33400,138900
"TR","1992-05-23",1992,5,144,88700,69700,33900,192300
"TR","1992-05-24",1992,5,145,237000,78800,36200,352000
"TR","1992-05-25",1992,5,146,0,72100,33900,106000
"TR","1992-05-26",1992,5,147,0,68500,34300,102800
"TR","1992-05-27",1992,5,148,0,65500,34300,99800
"TR","1992-05-28",1992,5,149,0,62800,34300,97100
"TR","1992-05-29",1992,5,150,0,60000,34300,94300
"TR","1992-05-30",1992,5,151,0,57200,34000,91200
"TR","1992-05-31",1992,5,152,0,54800,33800,88600
"TR","1992-06-01",1992,6,153,0,52800,33600,86400
"TR","1992-06-02",1992,6,154,22100,52200,33700,108000
"TR","1992-06-03",1992,6,155,0,51400,33500,84900
"TR","1992-06-04",1992,6,156,0,51100,33700,84800
"TR","1992-06-05",1992,6,157,11100,50700,33700,95500
"TR","1992-06-06",1992,6,158,87200,52100,33900,173200
"TR","1992-06-07",1992,6,159,93200,53200,33700,180100
"TR","1992-06-08",1992,6,160,48200,53600,33600,135400
"TR","1992-06-09",1992,6,161,2790,52400,33500,88690
"TR","1992-06-10",1992,6,162,0,51600,33600,85200
"TR","1992-06-11",1992,6,163,0,50900,33900,84800
"TR","1992-06-12",1992,6,164,0,49800,34000,83800
"TR","1992-06-13",1992,6,165,0,48800,34100,82900
"TR","1992-06-14",1992,6,166,0,48100,34100,82200
"TR","1992-06-15",1992,6,167,0,47700,34000,81700
"TR","1992-06-16",1992,6,168,77400,48600,33800,159800
"TR","1992-06-17",1992,6,169,88400,49700,33400,171500
"TR","1992-06-18",1992,6,170,97600,51000,33200,181800
"TR","1992-06-19",1992,6,171,219000,56900,33800,309700
"TR","1992-06-20",1992,6,172,24900,55000,32900,112800
"TR","1992-06-21",1992,6,173,7150,53400,33000,93550
"TR","1992-06-22",1992,6,174,0,52000,33100,85100
"TR","1992-06-23",1992,6,175,99500,54300,33400,187200
"TR","1992-06-24",1992,6,176,249000,64000,33900,346900
"TR","1992-06-25",1992,6,177,235000,69600,34100,338700
"TR","1992-06-26",1992,6,178,102000,68100,32700,202800
"TR","1992-06-27",1992,6,179,131000,72000,33100,236100
"TR","1992-06-28",1992,6,180,14000,67200,32100,113300
"TR","1992-06-29",1992,6,181,22100,63800,32500,118400
"TR","1992-06-30",1992,6,182,271000,76100,35000,382100
"TR","1992-07-01",1992,7,183,77400,71200,32100,180700
"TR","1992-07-02",1992,7,184,378000,85100,42700,505800
"TR","1992-07-03",1992,7,185,255000,86000,46400,387400
"TR","1992-07-04",1992,7,186,122000,82500,37700,242200
"TR","1992-07-05",1992,7,187,0,73700,30400,104100
"TR","1992-07-06",1992,7,188,1510,68200,30900,100610
"TR","1992-07-07",1992,7,189,0,63300,30900,94200
"TR","1992-07-08",1992,7,190,0,59300,31000,90300
"TR","1992-07-09",1992,7,191,1770,55900,31000,88670
"TR","1992-07-10",1992,7,192,125000,58000,31600,214600
"TR","1992-07-11",1992,7,193,113000,59600,32100,204700
"TR","1992-07-12",1992,7,194,25100,56700,31300,113100
"TR","1992-07-13",1992,7,195,114000,58300,32200,204500
"TR","1992-07-14",1992,7,196,104000,60000,32300,196300
"TR","1992-07-15",1992,7,197,50600,58300,31900,140800
"TR","1992-07-16",1992,7,198,28000,55800,31600,115400
"TR","1992-07-17",1992,7,199,0,52800,31300,84100
"TR","1992-07-18",1992,7,200,3020,51600,31200,85820
"TR","1992-07-19",1992,7,201,0,50600,31100,81700
"TR","1992-07-20",1992,7,202,49100,50700,31000,130800
"TR","1992-07-21",1992,7,203,59900,50800,31200,141900
"TR","1992-07-22",1992,7,204,35000,50500,31000,116500
"TR","1992-07-23",1992,7,205,35000,50200,31100,116300
"TR","1992-07-24",1992,7,206,0,49200,30900,80100
"TR","1992-07-25",1992,7,207,0,48500,30900,79400
"TR","1992-07-26",1992,7,208,0,47700,30800,78500
"TR","1992-07-27",1992,7,209,24600,47300,30800,102700
"TR","1992-07-28",1992,7,210,0,46600,30600,77200
"TR","1992-07-29",1992,7,211,0,46000,30700,76700
"TR","1992-07-30",1992,7,212,0,45200,30600,75800
"TR","1992-07-31",1992,7,213,0,44600,30500,75100
"TR","1992-08-01",1992,8,214,23800,44500,30400,98700
"TR","1992-08-02",1992,8,215,32300,44500,30600,107400
"TR","1992-08-03",1992,8,216,42600,44700,30900,118200
"TR","1992-08-04",1992,8,217,0,44000,30800,74800
"TR","1992-08-05",1992,8,218,0,43600,31000,74600
"TR","1992-08-06",1992,8,219,0,43100,31100,74200
"TR","1992-08-07",1992,8,220,0,42300,31400,73700
"TR","1992-08-08",1992,8,221,42200,42400,31300,115900
"TR","1992-08-09",1992,8,222,76100,43300,31400,150800
"TR","1992-08-10",1992,8,223,0,42400,31200,73600
"TR","1992-08-11",1992,8,224,158000,44900,32000,234900
"TR","1992-08-12",1992,8,225,21100,43700,31200,96000
"TR","1992-08-13",1992,8,226,34900,43700,31300,109900
"TR","1992-08-14",1992,8,227,2660,43200,31100,76960
"TR","1992-08-15",1992,8,228,0,42800,31200,74000
"TR","1992-08-16",1992,8,229,0,42400,31300,73700
"TR","1992-08-17",1992,8,230,0,41500,31600,73100
"TR","1992-08-18",1992,8,231,84300,42400,31400,158100
"TR","1992-08-19",1992,8,232,222000,46400,32000,300400
"TR","1992-08-20",1992,8,233,0,44800,30900,75700
"TR","1992-08-21",1992,8,234,0,44000,31300,75300
"TR","1992-08-22",1992,8,235,25600,43400,31300,100300
"TR","1992-08-23",1992,8,236,14600,43000,31300,88900
"TR","1992-08-24",1992,8,237,0,42200,31300,73500
"TR","1992-08-25",1992,8,238,0,41700,31300,73000
"TR","1992-08-26",1992,8,239,349000,48500,32600,430100
"TR","1992-08-27",1992,8,240,88600,47200,31200,167000
"TR","1992-08-28",1992,8,241,0,45800,30600,76400
"TR","1992-08-29",1992,8,242,0,45200,30900,76100
"TR","1992-08-30",1992,8,243,158000,48100,31400,237500
"TR","1992-08-31",1992,8,244,205000,51400,32200,288600
"TR","1992-09-01",1992,9,245,168000,53000,37800,258800
"TR","1992-09-02",1992,9,246,0,50300,29700,80000
"TR","1992-09-03",1992,9,247,69700,50800,30400,150900
"TR","1992-09-04",1992,9,248,130000,55700,36600,222300
"TR","1992-09-05",1992,9,249,0,51900,29800,81700
"TR","1992-09-06",1992,9,250,52500,51200,30300,134000
"TR","1992-09-07",1992,9,251,90900,53500,31400,175800
"TR","1992-09-08",1992,9,252,15800,50900,30200,96900
"TR","1992-09-09",1992,9,253,15500,49700,30200,95400
"TR","1992-09-10",1992,9,254,0,48700,30100,78800
"TR","1992-09-11",1992,9,255,5000,48100,30200,83300
"TR","1992-09-12",1992,9,256,0,47500,30100,77600
"TR","1992-09-13",1992,9,257,1670,46800,30200,78670
"TR","1992-09-14",1992,9,258,26400,46500,30100,103000
"TR","1992-09-15",1992,9,259,164000,49400,31100,244500
"TR","1992-09-16",1992,9,260,73200,49500,30500,153200
"TR","1992-09-17",1992,9,261,320000,65900,45900,431800
"TR","1992-09-18",1992,9,262,96700,61000,33300,191000
"TR","1992-09-19",1992,9,263,111000,62900,34200,208100
"TR","1992-09-20",1992,9,264,11900,58200,29000,99100
"TR","1992-09-21",1992,9,265,0,55000,29100,84100
"TR","1992-09-22",1992,9,266,0,52500,29300,81800
"TR","1992-09-23",1992,9,267,0,50300,29300,79600
"TR","1992-09-24",1992,9,268,0,49300,29300,78600
"TR","1992-09-25",1992,9,269,0,48600,29300,77900
"TR","1992-09-26",1992,9,270,0,47800,29300,77100
"TR","1992-09-27",1992,9,271,6600,47200,29300,83100
"TR","1992-09-28",1992,9,272,172000,51600,30200,253800
"TR","1992-09-29",1992,9,273,0,49900,29400,79300
"TR","1992-09-30",1992,9,274,0,49300,29500,78800
"TR","1992-10-01",1992,10,275,0,48600,29500,78100
"TR","1992-10-02",1992,10,276,0,47900,29600,77500
"TR","1992-10-03",1992,10,277,0,47000,29600,76600
"TR","1992-10-04",1992,10,278,0,46200,29500,75700
"TR","1992-10-05",1992,10,279,0,45600,29400,75000
"TR","1992-10-06",1992,10,280,0,45400,29300,74700
"TR","1992-10-07",1992,10,281,209000,50700,29800,289500
"TR","1992-10-08",1992,10,282,165000,53700,32400,251100
"TR","1992-10-09",1992,10,283,148000,59200,36200,243400
"TR","1992-10-10",1992,10,284,284000,75500,53000,412500
"TR","1992-10-11",1992,10,285,126000,75500,40800,242300
"TR","1992-10-12",1992,10,286,5510,68400,29100,103010
"TR","1992-10-13",1992,10,287,0,63200,27600,90800
"TR","1992-10-14",1992,10,288,21200,60400,28000,109600
"TR","1992-10-15",1992,10,289,0,57300,28000,85300
"TR","1992-10-16",1992,10,290,0,55100,28300,83400
"TR","1992-10-17",1992,10,291,36900,55400,28300,120600
"TR","1992-10-18",1992,10,292,0,53900,28400,82300
"TR","1992-10-19",1992,10,293,0,52500,28500,81000
"TR","1992-10-20",1992,10,294,0,51600,28600,80200
"TR","1992-10-21",1992,10,295,38800,51800,28500,119100
"TR","1992-10-22",1992,10,296,4010,51600,29000,84610
"TR","1992-10-23",1992,10,297,0,50400,28900,79300
"TR","1992-10-24",1992,10,298,0,50000,29100,79100
"TR","1992-10-25",1992,10,299,0,49600,29000,78600
"TR","1992-10-26",1992,10,300,0,49300,28900,78200
"TR","1992-10-27",1992,10,301,0,49000,28800,77800
"TR","1992-10-28",1992,10,302,0,48700,28800,77500
"TR","1992-10-29",1992,10,303,63500,50000,28900,142400
"TR","1992-10-30",1992,10,304,0,48900,28500,77400
"TR","1992-10-31",1992,10,305,0,48300,28600,76900
"TR","1992-11-01",1992,11,306,0,48000,28600,76600
"TR","1992-11-02",1992,11,307,60100,49000,28800,137900
"TR","1992-11-03",1992,11,308,131000,49800,28100,208900
"TR","1992-11-04",1992,11,309,127000,52800,28000,207800
"TR","1992-11-05",1992,11,310,13000,52500,28300,93800
"TR","1992-11-06",1992,11,311,37300,52100,28000,117400
"TR","1992-11-07",1992,11,312,28100,51500,28000,107600
"TR","1992-11-08",1992,11,313,0,50600,28200,78800
"TR","1992-11-09",1992,11,314,12200,50100,28200,90500
"TR","1992-11-10",1992,11,315,42400,50800,28300,121500
"TR","1992-11-11",1992,11,316,15000,56100,33100,104200
"TR","1992-11-12",1992,11,317,0,52800,31100,83900
"TR","1992-11-13",1992,11,318,16000,51700,32100,99800
"TR","1992-11-14",1992,11,319,45400,51400,27900,124700
"TR","1992-11-15",1992,11,320,4320,50600,27900,82820
"TR","1992-11-16",1992,11,321,0,49900,28000,77900
"TR","1992-11-17",1992,11,322,63000,50500,27800,141300
"TR","1992-11-18",1992,11,323,69400,51900,27500,148800
"TR","1992-11-19",1992,11,324,0,50900,27600,78500
"TR","1992-11-20",1992,11,325,0,49900,27800,77700
"TR","1992-11-21",1992,11,326,233000,54900,26900,314800
"TR","1992-11-22",1992,11,327,299000,62000,25800,386800
"TR","1992-11-23",1992,11,328,0,58700,25800,84500
"TR","1992-11-24",1992,11,329,0,56000,26300,82300
"TR","1992-11-25",1992,11,330,0,53800,26600,80400
"TR","1992-11-26",1992,11,331,0,52200,26900,79100
"TR","1992-11-27",1992,11,332,0,50900,27100,78000
"TR","1992-11-28",1992,11,333,0,50000,27200,77200
"TR","1992-11-29",1992,11,334,0,49700,27400,77100
"TR","1992-11-30",1992,11,335,0,49400,27500,76900
"TR","1992-12-01",1992,12,336,0,49200,27600,76800
"TR","1992-12-02",1992,12,337,13500,49100,27500,90100
"TR","1992-12-03",1992,12,338,13300,49000,27400,89700
"TR","1992-12-04",1992,12,339,5620,48800,27400,81820
"TR","1992-12-05",1992,12,340,26400,48800,27300,102500
"TR","1992-12-06",1992,12,341,7810,48700,27300,83810
"TR","1992-12-07",1992,12,342,0,48500,27300,75800
"TR","1992-12-08",1992,12,343,0,48400,27300,75700
"TR","1992-12-09",1992,12,344,0,48200,27400,75600
"TR","1992-12-10",1992,12,345,7870,48100,27400,83370
"TR","1992-12-11",1992,12,346,2420,47900,27400,77720
"TR","1992-12-12",1992,12,347,0,47800,27400,75200
"TR","1992-12-13",1992,12,348,0,47600,27400,75000
"TR","1992-12-14",1992,12,349,0,47500,27400,74900
"TR","1992-12-15",1992,12,350,22500,47400,27300,97200
"TR","1992-12-16",1992,12,351,151000,48200,26700,225900
"TR","1992-12-17",1992,12,352,89400,48800,26200,164400
"TR","1992-12-18",1992,12,353,0,48600,26300,74900
"TR","1992-12-19",1992,12,354,12400,48400,26500,87300
"TR","1992-12-20",1992,12,355,29300,48500,26500,104300
"TR","1992-12-21",1992,12,356,0,48300,26600,74900
"TR","1992-12-22",1992,12,357,0,48000,26700,74700
"TR","1992-12-23",1992,12,358,0,47800,26800,74600
"TR","1992-12-24",1992,12,359,0,47600,26800,74400
"TR","1992-12-25",1992,12,360,16900,47500,26800,91200
"TR","1992-12-26",1992,12,361,60900,47900,26500,135300
"TR","1992-12-27",1992,12,362,0,47700,26500,74200
"TR","1992-12-28",1992,12,363,0,47500,26600,74100
"TR","1992-12-29",1992,12,364,0,47300,26700,74000
"TR","1992-12-30",1992,12,365,39500,47400,26600,113500
"TR","1992-12-31",1992,12,366,50600,47400,26400,124400
"TR","1993-01-01",1993,1,1,70600,47800,26100,144500
"TR","1993-01-02",1993,1,2,1300,47600,26100,75000
"TR","1993-01-03",1993,1,3,9380,47500,26200,83080
"TR","1993-01-04",1993,1,4,19400,47400,26300,93100
"TR","1993-01-05",1993,1,5,11400,47200,26300,84900
"TR","1993-01-06",1993,1,6,5920,47100,26400,79420
"TR","1993-01-07",1993,1,7,0,46900,26400,73300
"TR","1993-01-08",1993,1,8,0,46700,26500,73200
"TR","1993-01-09",1993,1,9,0,46500,26500,73000
"TR","1993-01-10",1993,1,10,0,46300,26500,72800
"TR","1993-01-11",1993,1,11,0,46100,26500,72600
"TR","1993-01-12",1993,1,12,0,46000,26600,72600
"TR","1993-01-13",1993,1,13,79200,46300,26200,151700
"TR","1993-01-14",1993,1,14,79400,46700,25800,151900
"TR","1993-01-15",1993,1,15,25900,46700,25800,98400
"TR","1993-01-16",1993,1,16,24600,46700,25800,97100
"TR","1993-01-17",1993,1,17,0,46500,25900,72400
"TR","1993-01-18",1993,1,18,0,46300,26000,72300
"TR","1993-01-19",1993,1,19,0,46100,26100,72200
"TR","1993-01-20",1993,1,20,0,45900,26200,72100
"TR","1993-01-21",1993,1,21,65700,46000,25900,137600
"TR","1993-01-22",1993,1,22,122000,46700,25400,194100
"TR","1993-01-23",1993,1,23,12100,46500,25400,84000
"TR","1993-01-24",1993,1,24,56300,46500,25400,128200
"TR","1993-01-25",1993,1,25,88700,47000,25100,160800
"TR","1993-01-26",1993,1,26,0,46800,25200,72000
"TR","1993-01-27",1993,1,27,144000,47600,24900,216500
"TR","1993-01-28",1993,1,28,28100,47400,24800,100300
"TR","1993-01-29",1993,1,29,64300,47500,24800,136600
"TR","1993-01-30",1993,1,30,2370,47200,24900,74470
"TR","1993-01-31",1993,1,31,0,47000,25100,72100
"TR","1993-02-01",1993,2,32,0,46600,25300,71900
"TR","1993-02-02",1993,2,33,0,46300,25400,71700
"TR","1993-02-03",1993,2,34,0,46100,25500,71600
"TR","1993-02-04",1993,2,35,0,45800,25600,71400
"TR","1993-02-05",1993,2,36,0,45600,25700,71300
"TR","1993-02-06",1993,2,37,0,45300,25700,71000
"TR","1993-02-07",1993,2,38,2430,45100,25700,73230
"TR","1993-02-08",1993,2,39,0,44900,25800,70700
"TR","1993-02-09",1993,2,40,0,44700,25800,70500
"TR","1993-02-10",1993,2,41,0,44500,25800,70300
"TR","1993-02-11",1993,2,42,0,44300,25800,70100
"TR","1993-02-12",1993,2,43,0,44200,25800,70000
"TR","1993-02-13",1993,2,44,0,44000,25900,69900
"TR","1993-02-14",1993,2,45,0,43800,25900,69700
"TR","1993-02-15",1993,2,46,0,43700,25900,69600
"TR","1993-02-16",1993,2,47,0,43500,25900,69400
"TR","1993-02-17",1993,2,48,0,43400,25900,69300
"TR","1993-02-18",1993,2,49,0,43300,25900,69200
"TR","1993-02-19",1993,2,50,0,43100,25900,69000
"TR","1993-02-20",1993,2,51,0,43000,25800,68800
"TR","1993-02-21",1993,2,52,0,42900,25800,68700
"TR","1993-02-22",1993,2,53,783,42800,25800,69383
"TR","1993-02-23",1993,2,54,15600,42800,25800,84200
"TR","1993-02-24",1993,2,55,0,42700,25700,68400
"TR","1993-02-25",1993,2,56,0,42600,25700,68300
"TR","1993-02-26",1993,2,57,0,42400,25700,68100
"TR","1993-02-27",1993,2,58,0,42300,25700,68000
"TR","1993-02-28",1993,2,59,0,42200,25700,67900
"TR","1993-03-01",1993,3,60,0,42100,25700,67800
"TR","1993-03-02",1993,3,61,0,41900,25800,67700
"TR","1993-03-03",1993,3,62,0,41600,25900,67500
"TR","1993-03-04",1993,3,63,0,41300,26000,67300
"TR","1993-03-05",1993,3,64,0,41100,26100,67200
"TR","1993-03-06",1993,3,65,0,40900,26100,67000
"TR","1993-03-07",1993,3,66,0,40700,26100,66800
"TR","1993-03-08",1993,3,67,2070,40600,26100,68770
"TR","1993-03-09",1993,3,68,46400,40900,25800,113100
"TR","1993-03-10",1993,3,69,2070,40800,25700,68570
"TR","1993-03-11",1993,3,70,60600,41100,25500,127200
"TR","1993-03-12",1993,3,71,8390,41100,25400,74890
"TR","1993-03-13",1993,3,72,0,41000,25500,66500
"TR","1993-03-14",1993,3,73,0,40900,25500,66400
"TR","1993-03-15",1993,3,74,0,40800,25500,66300
"TR","1993-03-16",1993,3,75,0,40800,25500,66300
"TR","1993-03-17",1993,3,76,41400,40800,25300,107500
"TR","1993-03-18",1993,3,77,53600,41200,25100,119900
"TR","1993-03-19",1993,3,78,0,41100,25000,66100
"TR","1993-03-20",1993,3,79,4460,41000,25100,70560
"TR","1993-03-21",1993,3,80,0,40800,25200,66000
"TR","1993-03-22",1993,3,81,0,40600,25300,65900
"TR","1993-03-23",1993,3,82,0,40400,25300,65700
"TR","1993-03-24",1993,3,83,0,40200,25400,65600
"TR","1993-03-25",1993,3,84,0,39900,25500,65400
"TR","1993-03-26",1993,3,85,0,39600,25600,65200
"TR","1993-03-27",1993,3,86,0,39300,25700,65000
"TR","1993-03-28",1993,3,87,0,39100,25700,64800
"TR","1993-03-29",1993,3,88,0,42400,32300,74700
"TR","1993-03-30",1993,3,89,0,45200,39900,85100
"TR","1993-03-31",1993,3,90,0,47000,41100,88100
"TR","1993-04-01",1993,4,91,30800,62200,45000,138000
"TR","1993-04-02",1993,4,92,36200,46700,26700,109600
"TR","1993-04-03",1993,4,93,0,45600,26200,71800
"TR","1993-04-04",1993,4,94,0,44900,26100,71000
"TR","1993-04-05",1993,4,95,0,44500,26200,70700
"TR","1993-04-06",1993,4,96,0,44600,26200,70800
"TR","1993-04-07",1993,4,97,0,46500,29000,75500
"TR","1993-04-08",1993,4,98,4470,52400,41000,97870
"TR","1993-04-09",1993,4,99,98800,51100,36500,186400
"TR","1993-04-10",1993,4,100,94200,53900,41900,190000
"TR","1993-04-11",1993,4,101,12900,52900,39500,105300
"TR","1993-04-12",1993,4,102,131000,60100,36400,227500
"TR","1993-04-13",1993,4,103,279000,63900,26200,369100
"TR","1993-04-14",1993,4,104,5650,63900,29600,99150
"TR","1993-04-15",1993,4,105,0,60900,30800,91700
"TR","1993-04-16",1993,4,106,41000,61000,30900,132900
"TR","1993-04-17",1993,4,107,239000,63800,27400,330200
"TR","1993-04-18",1993,4,108,63300,62500,25700,151500
"TR","1993-04-19",1993,4,109,7600,64800,32800,105200
"TR","1993-04-20",1993,4,110,0,61600,35100,96700
"TR","1993-04-21",1993,4,111,0,59000,31200,90200
"TR","1993-04-22",1993,4,112,0,57800,33000,90800
"TR","1993-04-23",1993,4,113,0,56400,29000,85400
"TR","1993-04-24",1993,4,114,0,55700,27300,83000
"TR","1993-04-25",1993,4,115,32100,54800,27300,114200
"TR","1993-04-26",1993,4,116,12300,53100,27300,92700
"TR","1993-04-27",1993,4,117,0,51300,27200,78500
"TR","1993-04-28",1993,4,118,91200,53400,27700,172300
"TR","1993-04-29",1993,4,119,165000,62300,33500,260800
"TR","1993-04-30",1993,4,120,18200,57000,27300,102500
"TR","1993-05-01",1993,5,121,26000,55300,27400,108700
"TR","1993-05-02",1993,5,122,149000,59400,29200,237600
"TR","1993-05-03",1993,5,123,2e+05,68700,39700,308400
"TR","1993-05-04",1993,5,124,283000,82000,48000,413000
"TR","1993-05-05",1993,5,125,248000,89500,47400,384900
"TR","1993-05-06",1993,5,126,46100,80800,31100,158000
"TR","1993-05-07",1993,5,127,0,71300,26700,98000
"TR","1993-05-08",1993,5,128,11100,65700,26800,103600
"TR","1993-05-09",1993,5,129,16000,62200,27000,105200
"TR","1993-05-10",1993,5,130,0,58700,27300,86000
"TR","1993-05-11",1993,5,131,5600,55400,27600,88600
"TR","1993-05-12",1993,5,132,254000,67300,31800,353100
"TR","1993-05-13",1993,5,133,14000,60300,28200,102500
"TR","1993-05-14",1993,5,134,0,56000,28100,84100
"TR","1993-05-15",1993,5,135,4780,53100,28400,86280
"TR","1993-05-16",1993,5,136,0,50700,28300,79000
"TR","1993-05-17",1993,5,137,0,49700,28300,78000
"TR","1993-05-18",1993,5,138,48800,50100,28500,127400
"TR","1993-05-19",1993,5,139,153000,55400,29400,237800
"TR","1993-05-20",1993,5,140,8400,53300,28800,90500
"TR","1993-05-21",1993,5,141,0,51500,28900,80400
"TR","1993-05-22",1993,5,142,0,50400,29200,79600
"TR","1993-05-23",1993,5,143,22200,49900,29200,101300
"TR","1993-05-24",1993,5,144,168000,53300,29800,251100
"TR","1993-05-25",1993,5,145,231000,62300,30800,324100
"TR","1993-05-26",1993,5,146,23300,57900,29000,110200
"TR","1993-05-27",1993,5,147,7000,55200,29100,91300
"TR","1993-05-28",1993,5,148,88700,56000,29500,174200
"TR","1993-05-29",1993,5,149,1e+05,58600,29900,188500
"TR","1993-05-30",1993,5,150,0,55200,29200,84400
"TR","1993-05-31",1993,5,151,190000,61600,30300,281900
"TR","1993-06-01",1993,6,152,337000,83000,53300,473300
"TR","1993-06-02",1993,6,153,19900,71200,29300,120400
"TR","1993-06-03",1993,6,154,0,65400,28400,93800
"TR","1993-06-04",1993,6,155,11100,61700,28800,101600
"TR","1993-06-05",1993,6,156,0,58300,28900,87200
"TR","1993-06-06",1993,6,157,0,55500,29100,84600
"TR","1993-06-07",1993,6,158,75200,55600,29400,160200
"TR","1993-06-08",1993,6,159,197000,63400,30900,291300
"TR","1993-06-09",1993,6,160,332000,80500,47800,460300
"TR","1993-06-10",1993,6,161,310000,91300,50500,451800
"TR","1993-06-11",1993,6,162,67600,81000,31100,179700
"TR","1993-06-12",1993,6,163,0,72600,28500,101100
"TR","1993-06-13",1993,6,164,0,66900,29000,95900
"TR","1993-06-14",1993,6,165,22100,62800,29100,114000
"TR","1993-06-15",1993,6,166,165000,66300,30600,261900
"TR","1993-06-16",1993,6,167,37900,63500,29900,131300
"TR","1993-06-17",1993,6,168,11100,60100,29900,101100
"TR","1993-06-18",1993,6,169,558000,98200,60200,716400
"TR","1993-06-19",1993,6,170,101000,85200,37700,223900
"TR","1993-06-20",1993,6,171,674000,117000,63900,854900
"TR","1993-06-21",1993,6,172,610000,129000,89200,828200
"TR","1993-06-22",1993,6,173,62900,107000,33500,203400
"TR","1993-06-23",1993,6,174,1400,101000,28700,131100
"TR","1993-06-24",1993,6,175,0,94100,29300,123400
"TR","1993-06-25",1993,6,176,44200,90300,30500,165000
"TR","1993-06-26",1993,6,177,131000,91300,32900,255200
"TR","1993-06-27",1993,6,178,0,86100,32100,118200
"TR","1993-06-28",1993,6,179,22100,80500,32600,135200
"TR","1993-06-29",1993,6,180,0,75000,32700,107700
"TR","1993-06-30",1993,6,181,0,70700,33200,103900
"TR","1993-07-01",1993,7,182,0,66700,33400,100100
"TR","1993-07-02",1993,7,183,0,62700,33400,96100
"TR","1993-07-03",1993,7,184,173000,66800,34700,274500
"TR","1993-07-04",1993,7,185,31300,63300,33900,128500
"TR","1993-07-05",1993,7,186,168000,67600,35700,271300
"TR","1993-07-06",1993,7,187,13300,62900,34400,110600
"TR","1993-07-07",1993,7,188,43800,60900,34600,139300
"TR","1993-07-08",1993,7,189,14000,57900,34300,106200
"TR","1993-07-09",1993,7,190,41000,56800,34400,132200
"TR","1993-07-10",1993,7,191,71200,57000,34600,162800
"TR","1993-07-11",1993,7,192,0,54600,34000,88600
"TR","1993-07-12",1993,7,193,0,53600,34000,87600
"TR","1993-07-13",1993,7,194,13100,52800,33900,99800
"TR","1993-07-14",1993,7,195,42000,52900,33900,128800
"TR","1993-07-15",1993,7,196,48200,53000,34000,135200
"TR","1993-07-16",1993,7,197,1770,52000,33700,87470
"TR","1993-07-17",1993,7,198,0,51200,33700,84900
"TR","1993-07-18",1993,7,199,0,50600,33800,84400
"TR","1993-07-19",1993,7,200,0,49700,33700,83400
"TR","1993-07-20",1993,7,201,0,49000,33600,82600
"TR","1993-07-21",1993,7,202,0,48400,33600,82000
"TR","1993-07-22",1993,7,203,0,47900,33500,81400
"TR","1993-07-23",1993,7,204,0,47100,33600,80700
"TR","1993-07-24",1993,7,205,0,46500,33400,79900
"TR","1993-07-25",1993,7,206,0,46100,33400,79500
"TR","1993-07-26",1993,7,207,227000,50000,33800,310800
"TR","1993-07-27",1993,7,208,10200,48600,32800,91600
"TR","1993-07-28",1993,7,209,63100,49000,33000,145100
"TR","1993-07-29",1993,7,210,76200,49500,33000,158700
"TR","1993-07-30",1993,7,211,77400,49800,32900,160100
"TR","1993-07-31",1993,7,212,2660,48600,32700,83960
"TR","1993-08-01",1993,8,213,14000,48000,32800,94800
"TR","1993-08-02",1993,8,214,10700,47400,33000,91100
"TR","1993-08-03",1993,8,215,0,46700,33100,79800
"TR","1993-08-04",1993,8,216,72700,47600,33500,153800
"TR","1993-08-05",1993,8,217,79000,48600,33600,161200
"TR","1993-08-06",1993,8,218,0,47700,33300,81000
"TR","1993-08-07",1993,8,219,162000,50700,34200,246900
"TR","1993-08-08",1993,8,220,0,49300,33500,82800
"TR","1993-08-09",1993,8,221,0,48500,33800,82300
"TR","1993-08-10",1993,8,222,147000,50500,34100,231600
"TR","1993-08-11",1993,8,223,120000,51700,34300,206000
"TR","1993-08-12",1993,8,224,0,49700,33800,83500
"TR","1993-08-13",1993,8,225,0,48500,33900,82400
"TR","1993-08-14",1993,8,226,113000,50200,34300,197500
"TR","1993-08-15",1993,8,227,0,48800,33700,82500
"TR","1993-08-16",1993,8,228,10500,48100,33700,92300
"TR","1993-08-17",1993,8,229,2660,47300,33600,83560
"TR","1993-08-18",1993,8,230,0,46600,33500,80100
"TR","1993-08-19",1993,8,231,0,46000,33400,79400
"TR","1993-08-20",1993,8,232,0,45300,33300,78600
"TR","1993-08-21",1993,8,233,0,44800,33100,77900
"TR","1993-08-22",1993,8,234,0,44400,33000,77400
"TR","1993-08-23",1993,8,235,0,43700,33200,76900
"TR","1993-08-24",1993,8,236,10700,43200,33100,87000
"TR","1993-08-25",1993,8,237,13300,43000,33000,89300
"TR","1993-08-26",1993,8,238,0,42400,32900,75300
"TR","1993-08-27",1993,8,239,0,42000,33000,75000
"TR","1993-08-28",1993,8,240,174000,44700,33100,251800
"TR","1993-08-29",1993,8,241,97700,45600,32700,176000
"TR","1993-08-30",1993,8,242,0,44700,32300,77000
"TR","1993-08-31",1993,8,243,32500,44600,32400,109500
"TR","1993-09-01",1993,9,244,217000,48900,33400,299300
"TR","1993-09-02",1993,9,245,0,46800,32500,79300
"TR","1993-09-03",1993,9,246,19800,46400,32700,98900
"TR","1993-09-04",1993,9,247,47300,46600,32900,126800
"TR","1993-09-05",1993,9,248,0,45800,32700,78500
"TR","1993-09-06",1993,9,249,0,45300,32700,78000
"TR","1993-09-07",1993,9,250,0,44800,32600,77400
"TR","1993-09-08",1993,9,251,0,44400,32500,76900
"TR","1993-09-09",1993,9,252,121000,46500,32800,200300
"TR","1993-09-10",1993,9,253,143000,48800,32900,224700
"TR","1993-09-11",1993,9,254,49300,48100,32400,129800
"TR","1993-09-12",1993,9,255,19800,47500,32200,99500
"TR","1993-09-13",1993,9,256,44000,47600,32400,124000
"TR","1993-09-14",1993,9,257,158000,50600,32700,241300
"TR","1993-09-15",1993,9,258,461000,70800,35900,567700
"TR","1993-09-16",1993,9,259,2850,61500,29800,94150
"TR","1993-09-17",1993,9,260,0,57700,30200,87900
"TR","1993-09-18",1993,9,261,0,55000,30500,85500
"TR","1993-09-19",1993,9,262,0,52600,30600,83200
"TR","1993-09-20",1993,9,263,0,50600,30700,81300
"TR","1993-09-21",1993,9,264,152000,54900,31300,238200
"TR","1993-09-22",1993,9,265,41600,53700,30900,126200
"TR","1993-09-23",1993,9,266,0,51000,30700,81700
"TR","1993-09-24",1993,9,267,3920,49800,30800,84520
"TR","1993-09-25",1993,9,268,0,49000,30800,79800
"TR","1993-09-26",1993,9,269,0,48400,30700,79100
"TR","1993-09-27",1993,9,270,23800,48100,30700,102600
"TR","1993-09-28",1993,9,271,42100,48500,30800,121400
"TR","1993-09-29",1993,9,272,52000,49200,30600,131800
"TR","1993-09-30",1993,9,273,22800,49400,30600,102800
"TR","1993-10-01",1993,10,274,1610,48700,30500,80810
"TR","1993-10-02",1993,10,275,67600,49900,30600,148100
"TR","1993-10-03",1993,10,276,2280,49500,30500,82280
"TR","1993-10-04",1993,10,277,20500,49000,30600,100100
"TR","1993-10-05",1993,10,278,31300,48900,30800,111000
"TR","1993-10-06",1993,10,279,40100,49500,30500,120100
"TR","1993-10-07",1993,10,280,1740,49100,30600,81440
"TR","1993-10-08",1993,10,281,219000,57400,31300,307700
"TR","1993-10-09",1993,10,282,107000,58900,34100,2e+05
"TR","1993-10-10",1993,10,283,178000,60800,30600,269400
"TR","1993-10-11",1993,10,284,0,59000,31500,90500
"TR","1993-10-12",1993,10,285,0,58800,36400,95200
"TR","1993-10-13",1993,10,286,0,56100,32200,88300
"TR","1993-10-14",1993,10,287,0,53800,29400,83200
"TR","1993-10-15",1993,10,288,0,52200,29400,81600
"TR","1993-10-16",1993,10,289,16100,51200,29500,96800
"TR","1993-10-17",1993,10,290,83200,54900,29900,168000
"TR","1993-10-18",1993,10,291,2030,53000,29600,84630
"TR","1993-10-19",1993,10,292,48300,53000,29800,131100
"TR","1993-10-20",1993,10,293,96800,57700,35000,189500
"TR","1993-10-21",1993,10,294,40200,56500,31200,127900
"TR","1993-10-22",1993,10,295,164000,66200,41000,271200
"TR","1993-10-23",1993,10,296,0,61000,28700,89700
"TR","1993-10-24",1993,10,297,0,57600,28900,86500
"TR","1993-10-25",1993,10,298,0,55100,29100,84200
"TR","1993-10-26",1993,10,299,169000,61600,32100,262700
"TR","1993-10-27",1993,10,300,0,56700,28900,85600
"TR","1993-10-28",1993,10,301,0,54200,29000,83200
"TR","1993-10-29",1993,10,302,6860,52700,29000,88560
"TR","1993-10-30",1993,10,303,8160,51800,29100,89060
"TR","1993-10-31",1993,10,304,24500,51200,28900,104600
"TR","1993-11-01",1993,11,305,16500,50900,29000,96400
"TR","1993-11-02",1993,11,306,0,50300,29100,79400
"TR","1993-11-03",1993,11,307,0,50000,29200,79200
"TR","1993-11-04",1993,11,308,0,49400,29100,78500
"TR","1993-11-05",1993,11,309,140000,51600,29200,220800
"TR","1993-11-06",1993,11,310,180000,55400,28600,264000
"TR","1993-11-07",1993,11,311,19300,54000,28100,101400
"TR","1993-11-08",1993,11,312,0,52600,28300,80900
"TR","1993-11-09",1993,11,313,0,51400,28500,79900
"TR","1993-11-10",1993,11,314,0,50500,28700,79200
"TR","1993-11-11",1993,11,315,0,50100,28800,78900
"TR","1993-11-12",1993,11,316,120000,51300,28300,199600
"TR","1993-11-13",1993,11,317,1e+05,52300,27800,180100
"TR","1993-11-14",1993,11,318,176000,55900,27300,259200
"TR","1993-11-15",1993,11,319,38400,57000,34200,129600
"TR","1993-11-16",1993,11,320,53800,57100,31900,142800
"TR","1993-11-17",1993,11,321,0,54500,28500,83000
"TR","1993-11-18",1993,11,322,0,52700,28800,81500
"TR","1993-11-19",1993,11,323,0,51500,29000,80500
"TR","1993-11-20",1993,11,324,0,52000,32100,84100
"TR","1993-11-21",1993,11,325,0,50600,28700,79300
"TR","1993-11-22",1993,11,326,0,50100,28700,78800
"TR","1993-11-23",1993,11,327,0,49800,28700,78500
"TR","1993-11-24",1993,11,328,0,49600,28800,78400
"TR","1993-11-25",1993,11,329,0,49400,28800,78200
"TR","1993-11-26",1993,11,330,0,49200,28800,78000
"TR","1993-11-27",1993,11,331,319000,54000,27500,400500
"TR","1993-11-28",1993,11,332,32500,53500,27100,113100
"TR","1993-11-29",1993,11,333,6850,52300,27400,86550
"TR","1993-11-30",1993,11,334,0,51100,27600,78700
"TR","1993-12-01",1993,12,335,0,50100,27800,77900
"TR","1993-12-02",1993,12,336,0,49800,27900,77700
"TR","1993-12-03",1993,12,337,18800,49700,27900,96400
"TR","1993-12-04",1993,12,338,3640,49500,28000,81140
"TR","1993-12-05",1993,12,339,0,49200,28000,77200
"TR","1993-12-06",1993,12,340,0,49000,28100,77100
"TR","1993-12-07",1993,12,341,36800,49000,28000,113800
"TR","1993-12-08",1993,12,342,0,48800,28000,76800
"TR","1993-12-09",1993,12,343,0,48600,28000,76600
"TR","1993-12-10",1993,12,344,0,48400,28100,76500
"TR","1993-12-11",1993,12,345,24100,48400,28000,100500
"TR","1993-12-12",1993,12,346,0,48200,28000,76200
"TR","1993-12-13",1993,12,347,0,48000,28000,76000
"TR","1993-12-14",1993,12,348,0,47800,28100,75900
"TR","1993-12-15",1993,12,349,75300,48500,27700,151500
"TR","1993-12-16",1993,12,350,0,48400,27700,76100
"TR","1993-12-17",1993,12,351,0,48200,27800,76000
"TR","1993-12-18",1993,12,352,6740,48000,27900,82640
"TR","1993-12-19",1993,12,353,1920,47900,27900,77720
"TR","1993-12-20",1993,12,354,13500,47800,27800,89100
"TR","1993-12-21",1993,12,355,12600,47700,27800,88100
"TR","1993-12-22",1993,12,356,26500,47700,27700,101900
"TR","1993-12-23",1993,12,357,5620,47600,27700,80920
"TR","1993-12-24",1993,12,358,1920,47400,27700,77020
"TR","1993-12-25",1993,12,359,0,47300,27700,75000
"TR","1993-12-26",1993,12,360,0,47100,27700,74800
"TR","1993-12-27",1993,12,361,0,47000,27700,74700
"TR","1993-12-28",1993,12,362,0,46800,27700,74500
"TR","1993-12-29",1993,12,363,0,46700,27700,74400
"TR","1993-12-30",1993,12,364,20000,46700,27600,94300
"TR","1993-12-31",1993,12,365,5620,46600,27600,79820
"TR","1994-01-01",1994,1,1,28100,46500,27500,102100
"TR","1994-01-02",1994,1,2,64200,47000,27200,138400
"TR","1994-01-03",1994,1,3,0,46800,27200,74000
"TR","1994-01-04",1994,1,4,0,46700,27300,74000
"TR","1994-01-05",1994,1,5,0,46500,27300,73800
"TR","1994-01-06",1994,1,6,3210,46400,27300,76910
"TR","1994-01-07",1994,1,7,87300,46700,27000,161000
"TR","1994-01-08",1994,1,8,61000,46900,26700,134600
"TR","1994-01-09",1994,1,9,28200,47000,26600,101800
"TR","1994-01-10",1994,1,10,0,46800,26700,73500
"TR","1994-01-11",1994,1,11,0,46600,26800,73400
"TR","1994-01-12",1994,1,12,3930,46400,26900,77230
"TR","1994-01-13",1994,1,13,8090,46300,26900,81290
"TR","1994-01-14",1994,1,14,0,46100,26900,73000
"TR","1994-01-15",1994,1,15,0,46000,27000,73000
"TR","1994-01-16",1994,1,16,0,45800,27000,72800
"TR","1994-01-17",1994,1,17,9380,45700,27000,82080
"TR","1994-01-18",1994,1,18,31900,45800,26800,104500
"TR","1994-01-19",1994,1,19,0,45700,26800,72500
"TR","1994-01-20",1994,1,20,0,45500,26800,72300
"TR","1994-01-21",1994,1,21,0,45400,26900,72300
"TR","1994-01-22",1994,1,22,0,45200,26900,72100
"TR","1994-01-23",1994,1,23,0,45100,26900,72000
"TR","1994-01-24",1994,1,24,0,44900,26900,71800
"TR","1994-01-25",1994,1,25,0,44800,26900,71700
"TR","1994-01-26",1994,1,26,46900,44800,26700,118400
"TR","1994-01-27",1994,1,27,12500,44800,26600,83900
"TR","1994-01-28",1994,1,28,34200,44900,26500,105600
"TR","1994-01-29",1994,1,29,46000,44900,26300,117200
"TR","1994-01-30",1994,1,30,9280,44900,26300,80480
"TR","1994-01-31",1994,1,31,0,44700,26400,71100
"TR","1994-02-01",1994,2,32,0,44600,26400,71000
"TR","1994-02-02",1994,2,33,0,44400,26500,70900
"TR","1994-02-03",1994,2,34,0,44300,26500,70800
"TR","1994-02-04",1994,2,35,0,44200,26500,70700
"TR","1994-02-05",1994,2,36,0,44000,26500,70500
"TR","1994-02-06",1994,2,37,0,43900,26500,70400
"TR","1994-02-07",1994,2,38,0,43800,26500,70300
"TR","1994-02-08",1994,2,39,0,43700,26500,70200
"TR","1994-02-09",1994,2,40,5630,43600,26500,75730
"TR","1994-02-10",1994,2,41,7500,43600,26500,77600
"TR","1994-02-11",1994,2,42,7890,43500,26400,77790
"TR","1994-02-12",1994,2,43,0,43400,26400,69800
"TR","1994-02-13",1994,2,44,20300,43400,26300,90000
"TR","1994-02-14",1994,2,45,23600,43500,26200,93300
"TR","1994-02-15",1994,2,46,0,43400,26200,69600
"TR","1994-02-16",1994,2,47,0,43200,26300,69500
"TR","1994-02-17",1994,2,48,0,43100,26300,69400
"TR","1994-02-18",1994,2,49,0,43000,26300,69300
"TR","1994-02-19",1994,2,50,0,42800,26300,69100
"TR","1994-02-20",1994,2,51,26800,42900,26200,95900
"TR","1994-02-21",1994,2,52,4980,43000,26300,74280
"TR","1994-02-22",1994,2,53,0,42900,26200,69100
"TR","1994-02-23",1994,2,54,0,42800,26200,69000
"TR","1994-02-24",1994,2,55,8060,42700,26200,76960
"TR","1994-02-25",1994,2,56,14500,42800,26100,83400
"TR","1994-02-26",1994,2,57,0,42700,26100,68800
"TR","1994-02-27",1994,2,58,2430,42600,26100,71130
"TR","1994-02-28",1994,2,59,0,42500,26100,68600
"TR","1994-03-01",1994,3,60,0,42400,26100,68500
"TR","1994-03-02",1994,3,61,0,42200,26100,68300
"TR","1994-03-03",1994,3,62,0,42000,26100,68100
"TR","1994-03-04",1994,3,63,0,41800,26200,68000
"TR","1994-03-05",1994,3,64,0,41600,26200,67800
"TR","1994-03-06",1994,3,65,0,41400,26300,67700
"TR","1994-03-07",1994,3,66,0,41500,26300,67800
"TR","1994-03-08",1994,3,67,0,41200,26300,67500
"TR","1994-03-09",1994,3,68,2230,41200,26300,69730
"TR","1994-03-10",1994,3,69,0,41100,26200,67300
"TR","1994-03-11",1994,3,70,0,41000,26200,67200
"TR","1994-03-12",1994,3,71,4140,40900,26200,71240
"TR","1994-03-13",1994,3,72,0,40800,26200,67000
"TR","1994-03-14",1994,3,73,0,40600,26200,66800
"TR","1994-03-15",1994,3,74,0,40500,26200,66700
"TR","1994-03-16",1994,3,75,0,40300,26200,66500
"TR","1994-03-17",1994,3,76,0,40200,26200,66400
"TR","1994-03-18",1994,3,77,12400,40200,26100,78700
"TR","1994-03-19",1994,3,78,12500,40200,26000,78700
"TR","1994-03-20",1994,3,79,6210,40100,26000,72310
"TR","1994-03-21",1994,3,80,11400,40000,26000,77400
"TR","1994-03-22",1994,3,81,1210,44500,36400,82110
"TR","1994-03-23",1994,3,82,0,43900,33600,77500
"TR","1994-03-24",1994,3,83,0,43600,32100,75700
"TR","1994-03-25",1994,3,84,217000,43700,25700,286400
"TR","1994-03-26",1994,3,85,1310,43300,25300,69910
"TR","1994-03-27",1994,3,86,29000,43200,25400,97600
"TR","1994-03-28",1994,3,87,25900,43300,25500,94700
"TR","1994-03-29",1994,3,88,34100,44500,29100,107700
"TR","1994-03-30",1994,3,89,106000,44700,26000,176700
"TR","1994-03-31",1994,3,90,29600,44300,25000,98900
"TR","1994-04-01",1994,4,91,0,43800,25200,69000
"TR","1994-04-02",1994,4,92,0,45400,28700,74100
"TR","1994-04-03",1994,4,93,0,45700,31200,76900
"TR","1994-04-04",1994,4,94,0,44300,25900,70200
"TR","1994-04-05",1994,4,95,45600,45800,30000,121400
"TR","1994-04-06",1994,4,96,29200,45100,26200,100500
"TR","1994-04-07",1994,4,97,0,44500,25500,70000
"TR","1994-04-08",1994,4,98,0,44200,25500,69700
"TR","1994-04-09",1994,4,99,11200,47800,31900,90900
"TR","1994-04-10",1994,4,100,30800,52500,42700,126000
"TR","1994-04-11",1994,4,101,1410,52300,38400,92110
"TR","1994-04-12",1994,4,102,0,48000,33900,81900
"TR","1994-04-13",1994,4,103,34900,47700,32700,115300
"TR","1994-04-14",1994,4,104,32700,47200,28000,107900
"TR","1994-04-15",1994,4,105,0,46100,26200,72300
"TR","1994-04-16",1994,4,106,110000,48900,31100,190000
"TR","1994-04-17",1994,4,107,163000,52900,37000,252900
"TR","1994-04-18",1994,4,108,0,49000,26000,75000
"TR","1994-04-19",1994,4,109,0,47800,26100,73900
"TR","1994-04-20",1994,4,110,0,47000,26100,73100
"TR","1994-04-21",1994,4,111,0,46400,26100,72500
"TR","1994-04-22",1994,4,112,0,46000,26100,72100
"TR","1994-04-23",1994,4,113,25800,46100,26100,98000
"TR","1994-04-24",1994,4,114,18200,45600,26100,89900
"TR","1994-04-25",1994,4,115,0,44600,26000,70600
"TR","1994-04-26",1994,4,116,162000,48400,26800,237200
"TR","1994-04-27",1994,4,117,139000,49500,29100,217600
"TR","1994-04-28",1994,4,118,162000,55000,37700,254700
"TR","1994-04-29",1994,4,119,71500,52800,27600,151900
"TR","1994-04-30",1994,4,120,98300,55700,31500,185500
"TR","1994-05-01",1994,5,121,0,52400,27100,79500
"TR","1994-05-02",1994,5,122,0,49900,26000,75900
"TR","1994-05-03",1994,5,123,0,48700,26200,74900
"TR","1994-05-04",1994,5,124,0,47700,26300,74000
"TR","1994-05-05",1994,5,125,39900,48000,26300,114200
"TR","1994-05-06",1994,5,126,170000,54100,31800,255900
"TR","1994-05-07",1994,5,127,0,49500,26000,75500
"TR","1994-05-08",1994,5,128,0,48200,26300,74500
"TR","1994-05-09",1994,5,129,6650,47300,26300,80250
"TR","1994-05-10",1994,5,130,4200,46600,26200,77000
"TR","1994-05-11",1994,5,131,4430,45400,26200,76030
"TR","1994-05-12",1994,5,132,12600,44500,26100,83200
"TR","1994-05-13",1994,5,133,0,43500,25900,69400
"TR","1994-05-14",1994,5,134,0,43000,26000,69000
"TR","1994-05-15",1994,5,135,95300,44000,26100,165400
"TR","1994-05-16",1994,5,136,175000,46700,26600,248300
"TR","1994-05-17",1994,5,137,0,45000,25800,70800
"TR","1994-05-18",1994,5,138,0,44100,26100,70200
"TR","1994-05-19",1994,5,139,0,43100,26200,69300
"TR","1994-05-20",1994,5,140,0,41800,26200,68000
"TR","1994-05-21",1994,5,141,0,40700,26300,67000
"TR","1994-05-22",1994,5,142,0,39700,26400,66100
"TR","1994-05-23",1994,5,143,0,38900,26400,65300
"TR","1994-05-24",1994,5,144,0,38200,26500,64700
"TR","1994-05-25",1994,5,145,4200,37500,26500,68200
"TR","1994-05-26",1994,5,146,337000,43400,26200,406600
"TR","1994-05-27",1994,5,147,77800,41900,25100,144800
"TR","1994-05-28",1994,5,148,0,40600,25100,65700
"TR","1994-05-29",1994,5,149,0,39700,25500,65200
"TR","1994-05-30",1994,5,150,13300,38700,25700,77700
"TR","1994-05-31",1994,5,151,278000,43500,26200,347700
"TR","1994-06-01",1994,6,152,271000,47600,25800,344400
"TR","1994-06-02",1994,6,153,0,44400,24600,69000
"TR","1994-06-03",1994,6,154,0,43400,25300,68700
"TR","1994-06-04",1994,6,155,0,42200,25800,68000
"TR","1994-06-05",1994,6,156,0,41100,26100,67200
"TR","1994-06-06",1994,6,157,212000,44000,26200,282200
"TR","1994-06-07",1994,6,158,221000,47300,26200,294500
"TR","1994-06-08",1994,6,159,28000,44700,25600,98300
"TR","1994-06-09",1994,6,160,0,43000,25700,68700
"TR","1994-06-10",1994,6,161,0,42200,26000,68200
"TR","1994-06-11",1994,6,162,46400,42000,26100,114500
"TR","1994-06-12",1994,6,163,182000,44600,26600,253200
"TR","1994-06-13",1994,6,164,246000,49000,26900,321900
"TR","1994-06-14",1994,6,165,347000,62400,39100,448500
"TR","1994-06-15",1994,6,166,0,54200,24500,78700
"TR","1994-06-16",1994,6,167,0,50100,24900,75000
"TR","1994-06-17",1994,6,168,55300,48300,25200,128800
"TR","1994-06-18",1994,6,169,13300,46700,25200,85200
"TR","1994-06-19",1994,6,170,286000,56400,26800,369200
"TR","1994-06-20",1994,6,171,0,50500,25100,75600
"TR","1994-06-21",1994,6,172,0,47100,25400,72500
"TR","1994-06-22",1994,6,173,4770,45800,25500,76070
"TR","1994-06-23",1994,6,174,0,44800,25500,70300
"TR","1994-06-24",1994,6,175,105000,45700,25700,176400
"TR","1994-06-25",1994,6,176,231000,48600,26700,306300
"TR","1994-06-26",1994,6,177,4190,46600,25500,76290
"TR","1994-06-27",1994,6,178,27900,45900,25800,99600
"TR","1994-06-28",1994,6,179,0,44600,25700,70300
"TR","1994-06-29",1994,6,180,257000,49300,26400,332700
"TR","1994-06-30",1994,6,181,214000,51900,26900,292800
"TR","1994-07-01",1994,7,182,26500,48300,25000,99800
"TR","1994-07-02",1994,7,183,7970,46600,25000,79570
"TR","1994-07-03",1994,7,184,0,44900,25100,70000
"TR","1994-07-04",1994,7,185,0,43300,25000,68300
"TR","1994-07-05",1994,7,186,42000,42700,24900,109600
"TR","1994-07-06",1994,7,187,125000,43800,25000,193800
"TR","1994-07-07",1994,7,188,403000,52400,27500,482900
"TR","1994-07-08",1994,7,189,17600,47200,24200,89000
"TR","1994-07-09",1994,7,190,36400,46000,24400,106800
"TR","1994-07-10",1994,7,191,253000,55700,33200,341900
"TR","1994-07-11",1994,7,192,1770,49000,24100,74870
"TR","1994-07-12",1994,7,193,0,46900,24200,71100
"TR","1994-07-13",1994,7,194,0,45600,24400,70000
"TR","1994-07-14",1994,7,195,0,44200,24400,68600
"TR","1994-07-15",1994,7,196,0,42900,24300,67200
"TR","1994-07-16",1994,7,197,6200,42100,24300,72600
"TR","1994-07-17",1994,7,198,33600,41600,24300,99500
"TR","1994-07-18",1994,7,199,309000,46100,25600,380700
"TR","1994-07-19",1994,7,200,0,43600,24200,67800
"TR","1994-07-20",1994,7,201,98300,44200,24600,167100
"TR","1994-07-21",1994,7,202,188000,46500,25400,259900
"TR","1994-07-22",1994,7,203,68700,45600,24400,138700
"TR","1994-07-23",1994,7,204,60700,45000,24600,130300
"TR","1994-07-24",1994,7,205,0,43400,24200,67600
"TR","1994-07-25",1994,7,206,14600,42400,24300,81300
"TR","1994-07-26",1994,7,207,40900,42100,24300,107300
"TR","1994-07-27",1994,7,208,45600,41800,24300,111700
"TR","1994-07-28",1994,7,209,7190,40800,24200,72190
"TR","1994-07-29",1994,7,210,0,40000,24200,64200
"TR","1994-07-30",1994,7,211,8410,39200,24300,71910
"TR","1994-07-31",1994,7,212,0,38200,24300,62500
"TR","1994-08-01",1994,8,213,47600,38000,24300,109900
"TR","1994-08-02",1994,8,214,115000,39300,24600,178900
"TR","1994-08-03",1994,8,215,0,37900,24400,62300
"TR","1994-08-04",1994,8,216,116000,39200,24800,180000
"TR","1994-08-05",1994,8,217,112000,39800,25300,177100
"TR","1994-08-06",1994,8,218,0,38000,24800,62800
"TR","1994-08-07",1994,8,219,0,37100,25100,62200
"TR","1994-08-08",1994,8,220,242000,41600,25500,309100
"TR","1994-08-09",1994,8,221,262000,44600,26300,332900
"TR","1994-08-10",1994,8,222,0,41500,24400,65900
"TR","1994-08-11",1994,8,223,0,40600,24800,65400
"TR","1994-08-12",1994,8,224,0,39700,25000,64700
"TR","1994-08-13",1994,8,225,10500,38800,25100,74400
"TR","1994-08-14",1994,8,226,1330,37900,25200,64430
"TR","1994-08-15",1994,8,227,0,37100,25300,62400
"TR","1994-08-16",1994,8,228,0,36500,25300,61800
"TR","1994-08-17",1994,8,229,0,35800,25300,61100
"TR","1994-08-18",1994,8,230,0,35000,25500,60500
"TR","1994-08-19",1994,8,231,330000,41200,26400,397600
"TR","1994-08-20",1994,8,232,112000,40800,25400,178200
"TR","1994-08-21",1994,8,233,76700,40600,25500,142800
"TR","1994-08-22",1994,8,234,0,39100,25200,64300
"TR","1994-08-23",1994,8,235,0,38300,25400,63700
"TR","1994-08-24",1994,8,236,8430,37500,25500,71430
"TR","1994-08-25",1994,8,237,0,36600,25500,62100
"TR","1994-08-26",1994,8,238,21100,36200,25500,82800
"TR","1994-08-27",1994,8,239,23700,35600,25700,85000
"TR","1994-08-28",1994,8,240,116000,37000,25700,178700
"TR","1994-08-29",1994,8,241,128000,38500,25800,192300
"TR","1994-08-30",1994,8,242,0,37200,25200,62400
"TR","1994-08-31",1994,8,243,204000,41500,25800,271300
"TR","1994-09-01",1994,9,244,166000,42400,26300,234700
"TR","1994-09-02",1994,9,245,0,40300,24600,64900
"TR","1994-09-03",1994,9,246,0,39600,24900,64500
"TR","1994-09-04",1994,9,247,0,38800,25100,63900
"TR","1994-09-05",1994,9,248,0,38000,25200,63200
"TR","1994-09-06",1994,9,249,33000,37700,25200,95900
"TR","1994-09-07",1994,9,250,42500,37800,25300,105600
"TR","1994-09-08",1994,9,251,0,36800,25100,61900
"TR","1994-09-09",1994,9,252,0,36200,25300,61500
"TR","1994-09-10",1994,9,253,0,35500,25300,60800
"TR","1994-09-11",1994,9,254,0,34800,25300,60100
"TR","1994-09-12",1994,9,255,0,34200,25400,59600
"TR","1994-09-13",1994,9,256,108000,35600,25500,169100
"TR","1994-09-14",1994,9,257,386000,44700,26900,457600
"TR","1994-09-15",1994,9,258,203000,44900,26000,273900
"TR","1994-09-16",1994,9,259,718000,80200,56600,854800
"TR","1994-09-17",1994,9,260,209000,74000,37700,320700
"TR","1994-09-18",1994,9,261,2500,63700,22600,88800
"TR","1994-09-19",1994,9,262,0,56800,22900,79700
"TR","1994-09-20",1994,9,263,0,52400,23400,75800
"TR","1994-09-21",1994,9,264,50200,50300,23700,124200
"TR","1994-09-22",1994,9,265,283000,61200,30500,374700
"TR","1994-09-23",1994,9,266,150000,60500,30900,241400
"TR","1994-09-24",1994,9,267,131000,64400,32100,227500
"TR","1994-09-25",1994,9,268,1670,58200,24100,83970
"TR","1994-09-26",1994,9,269,26400,54600,23900,104900
"TR","1994-09-27",1994,9,270,141000,61300,33200,235500
"TR","1994-09-28",1994,9,271,62700,61100,29200,153000
"TR","1994-09-29",1994,9,272,66500,62000,30200,158700
"TR","1994-09-30",1994,9,273,9640,57800,25500,92940
"TR","1994-10-01",1994,10,274,13200,54500,24300,92000
"TR","1994-10-02",1994,10,275,72100,57100,28700,157900
"TR","1994-10-03",1994,10,276,0,53900,24900,78800
"TR","1994-10-04",1994,10,277,0,51300,25000,76300
"TR","1994-10-05",1994,10,278,23900,49900,25100,98900
"TR","1994-10-06",1994,10,279,0,48900,25200,74100
"TR","1994-10-07",1994,10,280,0,48100,25400,73500
"TR","1994-10-08",1994,10,281,138000,51400,25900,215300
"TR","1994-10-09",1994,10,282,35100,50800,26500,112400
"TR","1994-10-10",1994,10,283,14700,49500,25500,89700
"TR","1994-10-11",1994,10,284,0,48500,25500,74000
"TR","1994-10-12",1994,10,285,0,47800,25700,73500
"TR","1994-10-13",1994,10,286,0,47200,25800,73000
"TR","1994-10-14",1994,10,287,0,46800,25900,72700
"TR","1994-10-15",1994,10,288,0,46400,25900,72300
"TR","1994-10-16",1994,10,289,0,46000,25900,71900
"TR","1994-10-17",1994,10,290,0,45600,26000,71600
"TR","1994-10-18",1994,10,291,428000,64900,41500,534400
"TR","1994-10-19",1994,10,292,221000,72400,41400,334800
"TR","1994-10-20",1994,10,293,0,62700,26300,89000
"TR","1994-10-21",1994,10,294,0,57900,24900,82800
"TR","1994-10-22",1994,10,295,0,54800,25200,80000
"TR","1994-10-23",1994,10,296,218000,65200,34500,317700
"TR","1994-10-24",1994,10,297,129000,69700,36500,235200
"TR","1994-10-25",1994,10,298,28900,65200,27800,121900
"TR","1994-10-26",1994,10,299,2280,60500,25100,87880
"TR","1994-10-27",1994,10,300,13200,58100,25500,96800
"TR","1994-10-28",1994,10,301,0,55400,25700,81100
"TR","1994-10-29",1994,10,302,29000,54300,26100,109400
"TR","1994-10-30",1994,10,303,32300,53700,26400,112400
"TR","1994-10-31",1994,10,304,0,51600,26300,77900
"TR","1994-11-01",1994,11,305,0,50600,26400,77000
"TR","1994-11-02",1994,11,306,0,50200,26500,76700
"TR","1994-11-03",1994,11,307,0,49700,26400,76100
"TR","1994-11-04",1994,11,308,0,49200,26400,75600
"TR","1994-11-05",1994,11,309,33000,49500,26500,109000
"TR","1994-11-06",1994,11,310,13600,48800,26300,88700
"TR","1994-11-07",1994,11,311,0,48300,26300,74600
"TR","1994-11-08",1994,11,312,0,47900,26400,74300
"TR","1994-11-09",1994,11,313,0,47500,26400,73900
"TR","1994-11-10",1994,11,314,0,47200,26400,73600
"TR","1994-11-11",1994,11,315,0,46900,26500,73400
"TR","1994-11-12",1994,11,316,0,46600,26700,73300
"TR","1994-11-13",1994,11,317,0,46300,26800,73100
"TR","1994-11-14",1994,11,318,16800,46300,27000,90100
"TR","1994-11-15",1994,11,319,44600,46900,27200,118700
"TR","1994-11-16",1994,11,320,0,46500,27000,73500
"TR","1994-11-17",1994,11,321,0,45900,27000,72900
"TR","1994-11-18",1994,11,322,1120,45700,27000,73820
"TR","1994-11-19",1994,11,323,41000,46300,27200,114500
"TR","1994-11-20",1994,11,324,0,45500,26800,72300
"TR","1994-11-21",1994,11,325,0,45300,27000,72300
"TR","1994-11-22",1994,11,326,330000,47700,25700,403400
"TR","1994-11-23",1994,11,327,207000,50000,24700,281700
"TR","1994-11-24",1994,11,328,0,48700,24900,73600
"TR","1994-11-25",1994,11,329,0,48400,25300,73700
"TR","1994-11-26",1994,11,330,0,48100,25600,73700
"TR","1994-11-27",1994,11,331,0,47800,25800,73600
"TR","1994-11-28",1994,11,332,160000,48300,25300,233600
"TR","1994-11-29",1994,11,333,156000,50800,24700,231500
"TR","1994-11-30",1994,11,334,53100,51200,24600,128900
"TR","1994-12-01",1994,12,335,0,49700,24800,74500
"TR","1994-12-02",1994,12,336,0,48700,25100,73800
"TR","1994-12-03",1994,12,337,0,48400,25300,73700
"TR","1994-12-04",1994,12,338,0,48100,25400,73500
"TR","1994-12-05",1994,12,339,0,47800,25500,73300
"TR","1994-12-06",1994,12,340,2420,47500,25600,75520
"TR","1994-12-07",1994,12,341,0,47300,25700,73000
"TR","1994-12-08",1994,12,342,0,47100,25800,72900
"TR","1994-12-09",1994,12,343,18000,46900,25700,90600
"TR","1994-12-10",1994,12,344,14200,46800,25700,86700
"TR","1994-12-11",1994,12,345,2250,46700,25700,74650
"TR","1994-12-12",1994,12,346,0,46500,25800,72300
"TR","1994-12-13",1994,12,347,0,46300,25800,72100
"TR","1994-12-14",1994,12,348,0,46100,25900,72000
"TR","1994-12-15",1994,12,349,0,45900,25900,71800
"TR","1994-12-16",1994,12,350,0,45800,25900,71700
"TR","1994-12-17",1994,12,351,8400,45700,25900,80000
"TR","1994-12-18",1994,12,352,3550,45500,25900,74950
"TR","1994-12-19",1994,12,353,0,45400,25900,71300
"TR","1994-12-20",1994,12,354,0,45200,25900,71100
"TR","1994-12-21",1994,12,355,0,45100,25900,71000
"TR","1994-12-22",1994,12,356,0,44900,25900,70800
"TR","1994-12-23",1994,12,357,0,44800,25900,70700
"TR","1994-12-24",1994,12,358,0,44600,25900,70500
"TR","1994-12-25",1994,12,359,0,44500,25900,70400
"TR","1994-12-26",1994,12,360,0,44300,25900,70200
"TR","1994-12-27",1994,12,361,0,44200,25900,70100
"TR","1994-12-28",1994,12,362,0,44100,25900,70000
"TR","1994-12-29",1994,12,363,0,44000,25900,69900
"TR","1994-12-30",1994,12,364,0,43900,25900,69800
"TR","1994-12-31",1994,12,365,1120,43800,25900,70820
"TR","1995-01-01",1995,1,1,6060,43700,25800,75560
"TR","1995-01-02",1995,1,2,0,43600,25800,69400
"TR","1995-01-03",1995,1,3,0,43500,25800,69300
"TR","1995-01-04",1995,1,4,0,43400,25800,69200
"TR","1995-01-05",1995,1,5,0,43300,25800,69100
"TR","1995-01-06",1995,1,6,0,43200,25700,68900
"TR","1995-01-07",1995,1,7,24400,43300,25600,93300
"TR","1995-01-08",1995,1,8,25700,43400,25500,94600
"TR","1995-01-09",1995,1,9,0,43300,25400,68700
"TR","1995-01-10",1995,1,10,0,43200,25500,68700
"TR","1995-01-11",1995,1,11,18800,43200,25400,87400
"TR","1995-01-12",1995,1,12,28600,43300,25300,97200
"TR","1995-01-13",1995,1,13,0,43200,25300,68500
"TR","1995-01-14",1995,1,14,23300,43200,25300,91800
"TR","1995-01-15",1995,1,15,0,43000,25300,68300
"TR","1995-01-16",1995,1,16,0,42900,25400,68300
"TR","1995-01-17",1995,1,17,0,42700,25400,68100
"TR","1995-01-18",1995,1,18,50600,43000,25200,118800
"TR","1995-01-19",1995,1,19,23300,43000,25000,91300
"TR","1995-01-20",1995,1,20,0,42900,25100,68000
"TR","1995-01-21",1995,1,21,4250,42800,25100,72150
"TR","1995-01-22",1995,1,22,18200,42700,25100,86000
"TR","1995-01-23",1995,1,23,121000,43400,24600,189000
"TR","1995-01-24",1995,1,24,16900,43400,24400,84700
"TR","1995-01-25",1995,1,25,0,43300,24500,67800
"TR","1995-01-26",1995,1,26,0,43100,24600,67700
"TR","1995-01-27",1995,1,27,0,42900,24700,67600
"TR","1995-01-28",1995,1,28,0,42800,24800,67600
"TR","1995-01-29",1995,1,29,0,42600,24800,67400
"TR","1995-01-30",1995,1,30,0,42400,24800,67200
"TR","1995-01-31",1995,1,31,0,42300,24900,67200
"TR","1995-02-01",1995,2,32,0,42100,24900,67000
"TR","1995-02-02",1995,2,33,0,42000,24900,66900
"TR","1995-02-03",1995,2,34,0,41800,24900,66700
"TR","1995-02-04",1995,2,35,0,41700,24900,66600
"TR","1995-02-05",1995,2,36,34100,41800,24700,100600
"TR","1995-02-06",1995,2,37,2550,41700,24700,68950
"TR","1995-02-07",1995,2,38,1130,41600,24700,67430
"TR","1995-02-08",1995,2,39,0,41400,24700,66100
"TR","1995-02-09",1995,2,40,0,41300,24700,66000
"TR","1995-02-10",1995,2,41,0,41200,24700,65900
"TR","1995-02-11",1995,2,42,32700,41300,24600,98600
"TR","1995-02-12",1995,2,43,1420,41300,24600,67320
"TR","1995-02-13",1995,2,44,0,41100,24600,65700
"TR","1995-02-14",1995,2,45,0,41000,24600,65600
"TR","1995-02-15",1995,2,46,0,40900,24600,65500
"TR","1995-02-16",1995,2,47,69400,41300,24300,135000
"TR","1995-02-17",1995,2,48,23700,41400,24200,89300
"TR","1995-02-18",1995,2,49,0,41300,24200,65500
"TR","1995-02-19",1995,2,50,0,41100,24300,65400
"TR","1995-02-20",1995,2,51,0,40900,24400,65300
"TR","1995-02-21",1995,2,52,28800,41000,24300,94100
"TR","1995-02-22",1995,2,53,1420,40900,24300,66620
"TR","1995-02-23",1995,2,54,0,40700,24300,65000
"TR","1995-02-24",1995,2,55,1130,40600,24300,66030
"TR","1995-02-25",1995,2,56,0,40400,24300,64700
"TR","1995-02-26",1995,2,57,0,40300,24400,64700
"TR","1995-02-27",1995,2,58,0,40200,24400,64600
"TR","1995-02-28",1995,2,59,0,40100,24400,64500
"TR","1995-03-01",1995,3,60,10100,40000,24300,74400
"TR","1995-03-02",1995,3,61,0,39900,24300,64200
"TR","1995-03-03",1995,3,62,0,39800,24300,64100
"TR","1995-03-04",1995,3,63,0,39700,24300,64000
"TR","1995-03-05",1995,3,64,0,39600,24300,63900
"TR","1995-03-06",1995,3,65,165000,40400,23600,229000
"TR","1995-03-07",1995,3,66,105000,40900,23100,169000
"TR","1995-03-08",1995,3,67,196000,42100,22500,260600
"TR","1995-03-09",1995,3,68,1390,42000,22500,65890
"TR","1995-03-10",1995,3,69,0,41700,22800,64500
"TR","1995-03-11",1995,3,70,0,41500,23000,64500
"TR","1995-03-12",1995,3,71,0,41100,23200,64300
"TR","1995-03-13",1995,3,72,0,40700,23500,64200
"TR","1995-03-14",1995,3,73,0,40300,23700,64000
"TR","1995-03-15",1995,3,74,0,40700,24100,64800
"TR","1995-03-16",1995,3,75,0,48100,34400,82500
"TR","1995-03-17",1995,3,76,0,45800,32500,78300
"TR","1995-03-18",1995,3,77,2820,49900,39800,92520
"TR","1995-03-19",1995,3,78,0,46500,28300,74800
"TR","1995-03-20",1995,3,79,11000,49000,31500,91500
"TR","1995-03-21",1995,3,80,328000,51500,32100,411600
"TR","1995-03-22",1995,3,81,158000,53900,25900,237800
"TR","1995-03-23",1995,3,82,0,51700,24500,76200
"TR","1995-03-24",1995,3,83,0,50500,26100,76600
"TR","1995-03-25",1995,3,84,0,52000,30200,82200
"TR","1995-03-26",1995,3,85,39300,58600,40700,138600
"TR","1995-03-27",1995,3,86,4460,56700,36200,97360
"TR","1995-03-28",1995,3,87,0,52600,30800,83400
"TR","1995-03-29",1995,3,88,0,50000,29100,79100
"TR","1995-03-30",1995,3,89,0,49000,28800,77800
"TR","1995-03-31",1995,3,90,0,48400,25600,74000
"TR","1995-04-01",1995,4,91,0,47800,25600,73400
"TR","1995-04-02",1995,4,92,33500,47500,25500,106500
"TR","1995-04-03",1995,4,93,19800,47800,25600,93200
"TR","1995-04-04",1995,4,94,20100,47400,25700,93200
"TR","1995-04-05",1995,4,95,37200,46900,25700,109800
"TR","1995-04-06",1995,4,96,62600,46700,25500,134800
"TR","1995-04-07",1995,4,97,86700,47100,25200,159000
"TR","1995-04-08",1995,4,98,0,46700,25400,72100
"TR","1995-04-09",1995,4,99,14500,46800,25700,87000
"TR","1995-04-10",1995,4,100,0,46500,25900,72400
"TR","1995-04-11",1995,4,101,0,46400,26100,72500
"TR","1995-04-12",1995,4,102,269000,50100,28600,347700
"TR","1995-04-13",1995,4,103,174000,57200,33700,264900
"TR","1995-04-14",1995,4,104,16900,59000,34300,110200
"TR","1995-04-15",1995,4,105,0,55500,31500,87000
"TR","1995-04-16",1995,4,106,0,52600,30200,82800
"TR","1995-04-17",1995,4,107,38200,51500,25700,115400
"TR","1995-04-18",1995,4,108,4820,49300,25700,79820
"TR","1995-04-19",1995,4,109,192000,57000,31100,280100
"TR","1995-04-20",1995,4,110,3e+05,63700,30400,394100
"TR","1995-04-21",1995,4,111,0,61000,32100,93100
"TR","1995-04-22",1995,4,112,12900,60700,36600,110200
"TR","1995-04-23",1995,4,113,17600,57600,26500,101700
"TR","1995-04-24",1995,4,114,17900,54800,25700,98400
"TR","1995-04-25",1995,4,115,0,52100,25800,77900
"TR","1995-04-26",1995,4,116,17900,50700,26000,94600
"TR","1995-04-27",1995,4,117,9640,49500,26100,85240
"TR","1995-04-28",1995,4,118,7680,48900,26200,82780
"TR","1995-04-29",1995,4,119,0,48300,26300,74600
"TR","1995-04-30",1995,4,120,0,47800,26400,74200
"TR","1995-05-01",1995,5,121,0,47300,26400,73700
"TR","1995-05-02",1995,5,122,0,46800,26500,73300
"TR","1995-05-03",1995,5,123,0,46400,26500,72900
"TR","1995-05-04",1995,5,124,0,45900,26700,72600
"TR","1995-05-05",1995,5,125,0,45300,26700,72000
"TR","1995-05-06",1995,5,126,1400,44900,26900,73200
"TR","1995-05-07",1995,5,127,0,44400,27200,71600
"TR","1995-05-08",1995,5,128,0,43800,27500,71300
"TR","1995-05-09",1995,5,129,0,43400,27600,71000
"TR","1995-05-10",1995,5,130,777000,81000,67100,925100
"TR","1995-05-11",1995,5,131,44100,62100,29000,135200
"TR","1995-05-12",1995,5,132,0,57100,25700,82800
"TR","1995-05-13",1995,5,133,0,53300,26400,79700
"TR","1995-05-14",1995,5,134,182000,56700,27100,265800
"TR","1995-05-15",1995,5,135,374000,81000,50800,505800
"TR","1995-05-16",1995,5,136,0,67700,26100,93800
"TR","1995-05-17",1995,5,137,269000,80200,38300,387500
"TR","1995-05-18",1995,5,138,9570,67500,25800,102870
"TR","1995-05-19",1995,5,139,0,61400,26100,87500
"TR","1995-05-20",1995,5,140,0,56500,26500,83000
"TR","1995-05-21",1995,5,141,0,52200,26700,78900
"TR","1995-05-22",1995,5,142,16100,49900,26700,92700
"TR","1995-05-23",1995,5,143,0,48800,26900,75700
"TR","1995-05-24",1995,5,144,229000,55800,28000,312800
"TR","1995-05-25",1995,5,145,0,52200,27200,79400
"TR","1995-05-26",1995,5,146,0,50000,27600,77600
"TR","1995-05-27",1995,5,147,0,49000,27800,76800
"TR","1995-05-28",1995,5,148,0,47800,27900,75700
"TR","1995-05-29",1995,5,149,452000,64500,30300,546800
"TR","1995-05-30",1995,5,150,17600,56300,27400,101300
"TR","1995-05-31",1995,5,151,0,52300,27800,80100
"TR","1995-06-01",1995,6,152,0,49400,28000,77400
"TR","1995-06-02",1995,6,153,0,47600,28100,75700
"TR","1995-06-03",1995,6,154,0,46400,28200,74600
"TR","1995-06-04",1995,6,155,68200,46400,28600,143200
"TR","1995-06-05",1995,6,156,0,45100,28500,73600
"TR","1995-06-06",1995,6,157,0,44100,28900,73000
"TR","1995-06-07",1995,6,158,68500,44500,28800,141800
"TR","1995-06-08",1995,6,159,95400,45300,28700,169400
"TR","1995-06-09",1995,6,160,29000,44900,28400,102300
"TR","1995-06-10",1995,6,161,0,44200,28500,72700
"TR","1995-06-11",1995,6,162,144000,46400,28700,219100
"TR","1995-06-12",1995,6,163,62600,46400,28500,137500
"TR","1995-06-13",1995,6,164,0,45300,28400,73700
"TR","1995-06-14",1995,6,165,0,44300,28900,73200
"TR","1995-06-15",1995,6,166,0,42900,29100,72000
"TR","1995-06-16",1995,6,167,0,41900,29300,71200
"TR","1995-06-17",1995,6,168,0,41200,29300,70500
"TR","1995-06-18",1995,6,169,0,40700,29300,70000
"TR","1995-06-19",1995,6,170,0,40000,29600,69600
"TR","1995-06-20",1995,6,171,0,39100,29900,69000
"TR","1995-06-21",1995,6,172,0,38500,29900,68400
"TR","1995-06-22",1995,6,173,0,38000,29900,67900
"TR","1995-06-23",1995,6,174,23700,37900,29800,91400
"TR","1995-06-24",1995,6,175,11900,37600,29700,79200
"TR","1995-06-25",1995,6,176,0,37100,29700,66800
"TR","1995-06-26",1995,6,177,0,36800,29800,66600
"TR","1995-06-27",1995,6,178,99500,38100,29600,167200
"TR","1995-06-28",1995,6,179,179000,40500,29100,248600
"TR","1995-06-29",1995,6,180,254000,44000,28800,326800
"TR","1995-06-30",1995,6,181,144000,45300,27900,217200
"TR","1995-07-01",1995,7,182,52500,44400,27700,124600
"TR","1995-07-02",1995,7,183,0,43000,27700,70700
"TR","1995-07-03",1995,7,184,0,42200,27900,70100
"TR","1995-07-04",1995,7,185,0,41300,28100,69400
"TR","1995-07-05",1995,7,186,7010,40500,28100,75610
"TR","1995-07-06",1995,7,187,39300,40300,28100,107700
"TR","1995-07-07",1995,7,188,86100,40900,28000,155000
"TR","1995-07-08",1995,7,189,45900,40700,27700,114300
"TR","1995-07-09",1995,7,190,7010,39900,27600,74510
"TR","1995-07-10",1995,7,191,17200,39400,27700,84300
"TR","1995-07-11",1995,7,192,0,38500,27700,66200
"TR","1995-07-12",1995,7,193,0,37400,27900,65300
"TR","1995-07-13",1995,7,194,81300,37600,27800,146700
"TR","1995-07-14",1995,7,195,83600,38000,27600,149200
"TR","1995-07-15",1995,7,196,154000,39000,27500,220500
"TR","1995-07-16",1995,7,197,290000,42100,27600,359700
"TR","1995-07-17",1995,7,198,104000,40900,26600,171500
"TR","1995-07-18",1995,7,199,49100,40300,26400,115800
"TR","1995-07-19",1995,7,200,203000,43300,26900,273200
"TR","1995-07-20",1995,7,201,22400,41700,26300,90400
"TR","1995-07-21",1995,7,202,93700,42400,26500,162600
"TR","1995-07-22",1995,7,203,37100,41500,26400,105000
"TR","1995-07-23",1995,7,204,71800,41700,26600,140100
"TR","1995-07-24",1995,7,205,0,40100,26400,66500
"TR","1995-07-25",1995,7,206,21000,39000,26500,86500
"TR","1995-07-26",1995,7,207,27200,38300,26500,92000
"TR","1995-07-27",1995,7,208,0,37300,26400,63700
"TR","1995-07-28",1995,7,209,18200,36800,26400,81400
"TR","1995-07-29",1995,7,210,87600,38000,26600,152200
"TR","1995-07-30",1995,7,211,0,36200,26400,62600
"TR","1995-07-31",1995,7,212,0,34900,26500,61400
"TR","1995-08-01",1995,8,213,0,33800,26600,60400
"TR","1995-08-02",1995,8,214,87500,34500,26900,148900
"TR","1995-08-03",1995,8,215,0,33500,26700,60200
"TR","1995-08-04",1995,8,216,33700,33500,26800,94000
"TR","1995-08-05",1995,8,217,17900,33200,26900,78000
"TR","1995-08-06",1995,8,218,37200,33500,27100,97800
"TR","1995-08-07",1995,8,219,0,32800,27000,59800
"TR","1995-08-08",1995,8,220,463000,42300,27900,533200
"TR","1995-08-09",1995,8,221,18200,38400,26100,82700
"TR","1995-08-10",1995,8,222,37500,38100,26500,102100
"TR","1995-08-11",1995,8,223,2270,36800,26800,65870
"TR","1995-08-12",1995,8,224,65300,37000,27000,129300
"TR","1995-08-13",1995,8,225,198000,40100,27300,265400
"TR","1995-08-14",1995,8,226,529000,55600,43300,627900
"TR","1995-08-15",1995,8,227,583000,82900,60800,726700
"TR","1995-08-16",1995,8,228,0,68900,25500,94400
"TR","1995-08-17",1995,8,229,0,61900,24400,86300
"TR","1995-08-18",1995,8,230,0,56200,24900,81100
"TR","1995-08-19",1995,8,231,0,51500,25200,76700
"TR","1995-08-20",1995,8,232,212000,55600,26300,293900
"TR","1995-08-21",1995,8,233,6820,50100,25600,82520
"TR","1995-08-22",1995,8,234,0,46700,25900,72600
"TR","1995-08-23",1995,8,235,0,45000,26200,71200
"TR","1995-08-24",1995,8,236,0,43700,26300,70000
"TR","1995-08-25",1995,8,237,0,42700,26200,68900
"TR","1995-08-26",1995,8,238,234000,46400,26800,307200
"TR","1995-08-27",1995,8,239,565000,69500,49000,683500
"TR","1995-08-28",1995,8,240,184000,69100,44600,297700
"TR","1995-08-29",1995,8,241,140000,67400,30900,238300
"TR","1995-08-30",1995,8,242,8430,60300,24700,93430
"TR","1995-08-31",1995,8,243,0,55200,25100,80300
"TR","1995-09-01",1995,9,244,0,50300,25700,76000
"TR","1995-09-02",1995,9,245,0,47600,25800,73400
"TR","1995-09-03",1995,9,246,0,46500,26000,72500
"TR","1995-09-04",1995,9,247,0,45600,26200,71800
"TR","1995-09-05",1995,9,248,26400,45000,26300,97700
"TR","1995-09-06",1995,9,249,0,44000,26400,70400
"TR","1995-09-07",1995,9,250,54500,44200,26600,125300
"TR","1995-09-08",1995,9,251,17100,43500,26600,87200
"TR","1995-09-09",1995,9,252,25000,43300,26600,94900
"TR","1995-09-10",1995,9,253,0,42600,26500,69100
"TR","1995-09-11",1995,9,254,0,42300,26700,69000
"TR","1995-09-12",1995,9,255,0,41700,26800,68500
"TR","1995-09-13",1995,9,256,0,41200,26800,68000
"TR","1995-09-14",1995,9,257,10600,40700,26900,78200
"TR","1995-09-15",1995,9,258,1420,40200,26900,68520
"TR","1995-09-16",1995,9,259,9450,39900,27000,76350
"TR","1995-09-17",1995,9,260,171000,42900,27400,241300
"TR","1995-09-18",1995,9,261,51700,42900,26900,121500
"TR","1995-09-19",1995,9,262,2500,41900,26900,71300
"TR","1995-09-20",1995,9,263,57100,42500,27100,126700
"TR","1995-09-21",1995,9,264,54200,42800,27200,124200
"TR","1995-09-22",1995,9,265,17500,42600,27000,87100
"TR","1995-09-23",1995,9,266,111000,44400,27400,182800
"TR","1995-09-24",1995,9,267,5830,43300,26900,76030
"TR","1995-09-25",1995,9,268,2820,42600,27000,72420
"TR","1995-09-26",1995,9,269,0,42000,27000,69000
"TR","1995-09-27",1995,9,270,0,41500,27100,68600
"TR","1995-09-28",1995,9,271,0,41000,27100,68100
"TR","1995-09-29",1995,9,272,0,40500,27200,67700
"TR","1995-09-30",1995,9,273,0,40000,27100,67100
"TR","1995-10-01",1995,10,274,226000,44700,27700,298400
"TR","1995-10-02",1995,10,275,571000,66800,44700,682500
"TR","1995-10-03",1995,10,276,37200,56000,29200,122400
"TR","1995-10-04",1995,10,277,97700,59600,32000,189300
"TR","1995-10-05",1995,10,278,0,55000,25400,80400
"TR","1995-10-06",1995,10,279,0,51800,25200,77000
"TR","1995-10-07",1995,10,280,242000,67600,43600,353200
"TR","1995-10-08",1995,10,281,585000,101000,67400,753400
"TR","1995-10-09",1995,10,282,36700,83400,26100,146200
"TR","1995-10-10",1995,10,283,16500,76200,24300,117000
"TR","1995-10-11",1995,10,284,8680,69200,25000,102880
"TR","1995-10-12",1995,10,285,0,63800,25500,89300
"TR","1995-10-13",1995,10,286,0,60000,26100,86100
"TR","1995-10-14",1995,10,287,0,56800,26500,83300
"TR","1995-10-15",1995,10,288,122000,60400,26900,209300
"TR","1995-10-16",1995,10,289,75400,61300,27000,163700
"TR","1995-10-17",1995,10,290,0,58100,27000,85100
"TR","1995-10-18",1995,10,291,0,55400,27500,82900
"TR","1995-10-19",1995,10,292,0,53200,27700,80900
"TR","1995-10-20",1995,10,293,17700,52200,27700,97600
"TR","1995-10-21",1995,10,294,40600,53100,27800,121500
"TR","1995-10-22",1995,10,295,124000,56800,27900,208700
"TR","1995-10-23",1995,10,296,35500,58400,30400,124300
"TR","1995-10-24",1995,10,297,0,55800,27800,83600
"TR","1995-10-25",1995,10,298,670000,78800,33600,782400
"TR","1995-10-26",1995,10,299,30500,78500,35500,144500
"TR","1995-10-27",1995,10,300,0,74800,35500,110300
"TR","1995-10-28",1995,10,301,25800,80700,47900,154400
"TR","1995-10-29",1995,10,302,60100,73000,30900,164000
"TR","1995-10-30",1995,10,303,44600,70200,29800,144600
"TR","1995-10-31",1995,10,304,41100,68000,31100,140200
"TR","1995-11-01",1995,11,305,0,63500,27900,91400
"TR","1995-11-02",1995,11,306,157000,66100,30200,253300
"TR","1995-11-03",1995,11,307,255000,70200,28700,353900
"TR","1995-11-04",1995,11,308,15100,66700,27200,109000
"TR","1995-11-05",1995,11,309,4320,63700,27700,95720
"TR","1995-11-06",1995,11,310,0,61200,28200,89400
"TR","1995-11-07",1995,11,311,0,59200,28700,87900
"TR","1995-11-08",1995,11,312,1e+05,59700,28500,188200
"TR","1995-11-09",1995,11,313,12600,58600,28600,99800
"TR","1995-11-10",1995,11,314,0,57200,28900,86100
"TR","1995-11-11",1995,11,315,72500,58300,28800,159600
"TR","1995-11-12",1995,11,316,0,57000,28900,85900
"TR","1995-11-13",1995,11,317,0,56000,29200,85200
"TR","1995-11-14",1995,11,318,0,55100,29300,84400
"TR","1995-11-15",1995,11,319,24000,54800,29400,108200
"TR","1995-11-16",1995,11,320,10000,54300,29500,93800
"TR","1995-11-17",1995,11,321,0,53600,29700,83300
"TR","1995-11-18",1995,11,322,10800,53300,29800,93900
"TR","1995-11-19",1995,11,323,43100,54200,29600,126900
"TR","1995-11-20",1995,11,324,360000,60000,28200,448200
"TR","1995-11-21",1995,11,325,527000,68000,26300,621300
"TR","1995-11-22",1995,11,326,108000,66400,26000,200400
"TR","1995-11-23",1995,11,327,0,62900,26600,89500
"TR","1995-11-24",1995,11,328,0,60300,27200,87500
"TR","1995-11-25",1995,11,329,40100,58900,27400,126400
"TR","1995-11-26",1995,11,330,266000,62700,26800,355500
"TR","1995-11-27",1995,11,331,129000,63700,26400,219100
"TR","1995-11-28",1995,11,332,0,60800,26800,87600
"TR","1995-11-29",1995,11,333,0,58600,27300,85900
"TR","1995-11-30",1995,11,334,0,56900,27700,84600
"TR","1995-12-01",1995,12,335,8170,55700,28000,91870
"TR","1995-12-02",1995,12,336,41700,55700,28100,125500
"TR","1995-12-03",1995,12,337,14300,54900,28200,97400
"TR","1995-12-04",1995,12,338,0,53900,28400,82300
"TR","1995-12-05",1995,12,339,3370,53200,28600,85170
"TR","1995-12-06",1995,12,340,29200,53400,28600,111200
"TR","1995-12-07",1995,12,341,7810,53000,28700,89510
"TR","1995-12-08",1995,12,342,0,52400,28800,81200
"TR","1995-12-09",1995,12,343,6740,52100,28900,87740
"TR","1995-12-10",1995,12,344,39900,52700,28800,121400
"TR","1995-12-11",1995,12,345,0,52200,28900,81100
"TR","1995-12-12",1995,12,346,0,51700,29000,80700
"TR","1995-12-13",1995,12,347,0,51300,29100,80400
"TR","1995-12-14",1995,12,348,107000,52800,28700,188500
"TR","1995-12-15",1995,12,349,137000,55900,28100,221000
"TR","1995-12-16",1995,12,350,0,54600,28100,82700
"TR","1995-12-17",1995,12,351,0,53500,28400,81900
"TR","1995-12-18",1995,12,352,0,52600,28600,81200
"TR","1995-12-19",1995,12,353,0,51800,28700,80500
"TR","1995-12-20",1995,12,354,0,51200,28900,80100
"TR","1995-12-21",1995,12,355,0,50900,28900,79800
"TR","1995-12-22",1995,12,356,1120,50700,29000,80820
"TR","1995-12-23",1995,12,357,0,50500,29000,79500
"TR","1995-12-24",1995,12,358,0,50300,29100,79400
"TR","1995-12-25",1995,12,359,6740,50200,29100,86040
"TR","1995-12-26",1995,12,360,30400,50300,29000,109700
"TR","1995-12-27",1995,12,361,14400,50300,28900,93600
"TR","1995-12-28",1995,12,362,1210,50100,28900,80210
"TR","1995-12-29",1995,12,363,0,49900,29000,78900
"TR","1995-12-30",1995,12,364,0,49800,29000,78800
"TR","1995-12-31",1995,12,365,1120,49600,29000,79720
"TR","1996-01-01",1996,1,1,13000,49600,29000,91600
"TR","1996-01-02",1996,1,2,41400,49800,28800,120000
"TR","1996-01-03",1996,1,3,0,49600,28800,78400
"TR","1996-01-04",1996,1,4,0,49400,28800,78200
"TR","1996-01-05",1996,1,5,0,49300,28800,78100
"TR","1996-01-06",1996,1,6,0,49100,28800,77900
"TR","1996-01-07",1996,1,7,0,49000,28800,77800
"TR","1996-01-08",1996,1,8,0,48800,28800,77600
"TR","1996-01-09",1996,1,9,0,48700,28800,77500
"TR","1996-01-10",1996,1,10,124000,49600,28300,201900
"TR","1996-01-11",1996,1,11,3550,49400,28200,81150
"TR","1996-01-12",1996,1,12,22100,49400,28200,99700
"TR","1996-01-13",1996,1,13,0,49200,28300,77500
"TR","1996-01-14",1996,1,14,0,49000,28400,77400
"TR","1996-01-15",1996,1,15,0,48700,28500,77200
"TR","1996-01-16",1996,1,16,0,48600,28500,77100
"TR","1996-01-17",1996,1,17,1880,48400,28500,78780
"TR","1996-01-18",1996,1,18,34900,48500,28300,111700
"TR","1996-01-19",1996,1,19,742000,62300,25600,829900
"TR","1996-01-20",1996,1,20,214000,64400,24600,303000
"TR","1996-01-21",1996,1,21,0,60600,25000,85600
"TR","1996-01-22",1996,1,22,0,57500,25500,83000
"TR","1996-01-23",1996,1,23,0,55100,25900,81000
"TR","1996-01-24",1996,1,24,0,53200,26200,79400
"TR","1996-01-25",1996,1,25,0,51700,26500,78200
"TR","1996-01-26",1996,1,26,0,50600,26700,77300
"TR","1996-01-27",1996,1,27,0,49700,26900,76600
"TR","1996-01-28",1996,1,28,174000,53400,26300,253700
"TR","1996-01-29",1996,1,29,46900,52700,26100,125700
"TR","1996-01-30",1996,1,30,113000,54400,25900,193300
"TR","1996-01-31",1996,1,31,8090,52800,26000,86890
"TR","1996-02-01",1996,2,32,0,51300,26300,77600
"TR","1996-02-02",1996,2,33,0,50200,26600,76800
"TR","1996-02-03",1996,2,34,0,49500,26700,76200
"TR","1996-02-04",1996,2,35,0,49200,26900,76100
"TR","1996-02-05",1996,2,36,0,48900,27000,75900
"TR","1996-02-06",1996,2,37,0,48600,27100,75700
"TR","1996-02-07",1996,2,38,0,48400,27100,75500
"TR","1996-02-08",1996,2,39,1220,48200,27200,76620
"TR","1996-02-09",1996,2,40,0,47900,27200,75100
"TR","1996-02-10",1996,2,41,0,47700,27300,75000
"TR","1996-02-11",1996,2,42,63700,47900,27000,138600
"TR","1996-02-12",1996,2,43,20100,47800,26900,94800
"TR","1996-02-13",1996,2,44,1220,47600,27000,75820
"TR","1996-02-14",1996,2,45,11300,47500,27100,85900
"TR","1996-02-15",1996,2,46,36000,47500,27000,110500
"TR","1996-02-16",1996,2,47,10900,47300,26900,85100
"TR","1996-02-17",1996,2,48,22500,47200,26900,96600
"TR","1996-02-18",1996,2,49,3650,47000,27000,77650
"TR","1996-02-19",1996,2,50,1130,46800,27000,74930
"TR","1996-02-20",1996,2,51,0,46600,27100,73700
"TR","1996-02-21",1996,2,52,22500,46500,27000,96000
"TR","1996-02-22",1996,2,53,0,46300,27000,73300
"TR","1996-02-23",1996,2,54,0,46100,27100,73200
"TR","1996-02-24",1996,2,55,17000,46000,27100,90100
"TR","1996-02-25",1996,2,56,54400,46300,26800,127500
"TR","1996-02-26",1996,2,57,0,46100,26800,72900
"TR","1996-02-27",1996,2,58,0,45900,26900,72800
"TR","1996-02-28",1996,2,59,110000,46400,26500,182900
"TR","1996-02-29",1996,2,60,37700,46500,26300,110500
"TR","1996-03-01",1996,3,61,0,46300,26400,72700
"TR","1996-03-02",1996,3,62,0,46100,26500,72600
"TR","1996-03-03",1996,3,63,0,45900,26600,72500
"TR","1996-03-04",1996,3,64,0,45600,26700,72300
"TR","1996-03-05",1996,3,65,37300,45600,26600,109500
"TR","1996-03-06",1996,3,66,72200,46100,26300,144600
"TR","1996-03-07",1996,3,67,2230,45900,26300,74430
"TR","1996-03-08",1996,3,68,0,45600,26400,72000
"TR","1996-03-09",1996,3,69,0,45400,26500,71900
"TR","1996-03-10",1996,3,70,0,45200,26500,71700
"TR","1996-03-11",1996,3,71,0,45000,26600,71600
"TR","1996-03-12",1996,3,72,0,44700,26700,71400
"TR","1996-03-13",1996,3,73,0,44300,26800,71100
"TR","1996-03-14",1996,3,74,0,44000,26900,70900
"TR","1996-03-15",1996,3,75,0,43700,27000,70700
"TR","1996-03-16",1996,3,76,0,43400,27000,70400
"TR","1996-03-17",1996,3,77,0,43200,27000,70200
"TR","1996-03-18",1996,3,78,24600,43100,26900,94600
"TR","1996-03-19",1996,3,79,11200,43000,26800,81000
"TR","1996-03-20",1996,3,80,48300,43200,26700,118200
"TR","1996-03-21",1996,3,81,0,43000,26600,69600
"TR","1996-03-22",1996,3,82,0,42800,26700,69500
"TR","1996-03-23",1996,3,83,0,42700,26700,69400
"TR","1996-03-24",1996,3,84,0,42400,26800,69200
"TR","1996-03-25",1996,3,85,235000,44100,25800,304900
"TR","1996-03-26",1996,3,86,1e+06,58200,22500,1080700
"TR","1996-03-27",1996,3,87,24600,55400,22000,102000
"TR","1996-03-28",1996,3,88,0,52400,22700,75100
"TR","1996-03-29",1996,3,89,0,49700,23200,72900
"TR","1996-03-30",1996,3,90,0,47400,23700,71100
"TR","1996-03-31",1996,3,91,0,46800,24200,71000
"TR","1996-04-01",1996,4,92,111000,47200,24000,182200
"TR","1996-04-02",1996,4,93,2230,46800,24200,73230
"TR","1996-04-03",1996,4,94,34800,46700,24300,105800
"TR","1996-04-04",1996,4,95,2230,46300,24500,73030
"TR","1996-04-05",1996,4,96,54500,46300,24500,125300
"TR","1996-04-06",1996,4,97,0,45900,24700,70600
"TR","1996-04-07",1996,4,98,0,45600,24900,70500
"TR","1996-04-08",1996,4,99,0,45200,25000,70200
"TR","1996-04-09",1996,4,100,0,44800,25100,69900
"TR","1996-04-10",1996,4,101,0,44500,25300,69800
"TR","1996-04-11",1996,4,102,0,44100,25400,69500
"TR","1996-04-12",1996,4,103,53200,44000,25200,122400
"TR","1996-04-13",1996,4,104,56300,44100,25100,125500
"TR","1996-04-14",1996,4,105,204000,45300,24300,273600
"TR","1996-04-15",1996,4,106,0,45000,24300,69300
"TR","1996-04-16",1996,4,107,79300,45300,24300,148900
"TR","1996-04-17",1996,4,108,7230,44900,24500,76630
"TR","1996-04-18",1996,4,109,0,44500,24800,69300
"TR","1996-04-19",1996,4,110,68400,50000,37400,155800
"TR","1996-04-20",1996,4,111,129000,384000,443000,956000
"TR","1996-04-21",1996,4,112,1920,236000,180000,417920
"TR","1996-04-22",1996,4,113,87900,172000,223000,482900
"TR","1996-04-23",1996,4,114,29400,172000,49800,251200
"TR","1996-04-24",1996,4,115,0,118000,29600,147600
"TR","1996-04-25",1996,4,116,1410,122000,48600,172010
"TR","1996-04-26",1996,4,117,136000,196000,195000,527000
"TR","1996-04-27",1996,4,118,147000,193000,43900,383900
"TR","1996-04-28",1996,4,119,0,121000,30500,151500
"TR","1996-04-29",1996,4,120,0,118000,35200,153200
"TR","1996-04-30",1996,4,121,0,114000,39200,153200
"TR","1996-05-01",1996,5,122,125000,115000,43100,283100
"TR","1996-05-02",1996,5,123,29800,109000,37200,176000
"TR","1996-05-03",1996,5,124,0,109000,40600,149600
"TR","1996-05-04",1996,5,125,0,114000,51100,165100
"TR","1996-05-05",1996,5,126,0,110000,51300,161300
"TR","1996-05-06",1996,5,127,55200,113000,63800,232000
"TR","1996-05-07",1996,5,128,78800,109000,44500,232300
"TR","1996-05-08",1996,5,129,16800,119000,66600,202400
"TR","1996-05-09",1996,5,130,54100,126000,164000,344100
"TR","1996-05-10",1996,5,131,41300,121000,107000,269300
"TR","1996-05-11",1996,5,132,106000,112000,88100,306100
"TR","1996-05-12",1996,5,133,0,101000,38500,139500
"TR","1996-05-13",1996,5,134,0,97100,40600,137700
"TR","1996-05-14",1996,5,135,0,93300,41500,134800
"TR","1996-05-15",1996,5,136,6650,90400,42000,139050
"TR","1996-05-16",1996,5,137,6180,86700,42100,134980
"TR","1996-05-17",1996,5,138,0,81600,42400,124000
"TR","1996-05-18",1996,5,139,0,77300,42700,120000
"TR","1996-05-19",1996,5,140,46700,75000,43000,164700
"TR","1996-05-20",1996,5,141,591000,110000,67000,768000
"TR","1996-05-21",1996,5,142,8870,87500,43100,139470
"TR","1996-05-22",1996,5,143,33300,82300,44000,159600
"TR","1996-05-23",1996,5,144,21500,77500,43500,142500
"TR","1996-05-24",1996,5,145,0,73400,43300,116700
"TR","1996-05-25",1996,5,146,0,70600,43300,113900
"TR","1996-05-26",1996,5,147,0,68200,43200,111400
"TR","1996-05-27",1996,5,148,0,66000,43000,109000
"TR","1996-05-28",1996,5,149,0,63600,42700,106300
"TR","1996-05-29",1996,5,150,0,61700,42100,103800
"TR","1996-05-30",1996,5,151,0,60000,42000,102000
"TR","1996-05-31",1996,5,152,0,58300,41600,99900
"TR","1996-06-01",1996,6,153,0,57000,41300,98300
"TR","1996-06-02",1996,6,154,0,56100,41200,97300
"TR","1996-06-03",1996,6,155,326000,69500,43500,439000
"TR","1996-06-04",1996,6,156,162000,71600,43000,276600
"TR","1996-06-05",1996,6,157,69500,70400,42600,182500
"TR","1996-06-06",1996,6,158,0,66800,42000,108800
"TR","1996-06-07",1996,6,159,237000,77600,45000,359600
"TR","1996-06-08",1996,6,160,22300,71800,42300,136400
"TR","1996-06-09",1996,6,161,7560,68300,42000,117860
"TR","1996-06-10",1996,6,162,0,64400,42000,106400
"TR","1996-06-11",1996,6,163,44200,62600,41600,148400
"TR","1996-06-12",1996,6,164,28400,61100,41200,130700
"TR","1996-06-13",1996,6,165,22100,59700,40900,122700
"TR","1996-06-14",1996,6,166,59600,60100,41200,160900
"TR","1996-06-15",1996,6,167,0,57400,40600,98000
"TR","1996-06-16",1996,6,168,30900,56500,40300,127700
"TR","1996-06-17",1996,6,169,4190,55100,39900,99190
"TR","1996-06-18",1996,6,170,22100,54900,39800,116800
"TR","1996-06-19",1996,6,171,140000,59600,40700,240300
"TR","1996-06-20",1996,6,172,44500,59500,40300,144300
"TR","1996-06-21",1996,6,173,2790,57400,39800,99990
"TR","1996-06-22",1996,6,174,99500,59500,40300,199300
"TR","1996-06-23",1996,6,175,177000,65900,41100,284000
"TR","1996-06-24",1996,6,176,95000,65800,40200,201000
"TR","1996-06-25",1996,6,177,116000,67700,40600,224300
"TR","1996-06-26",1996,6,178,0,63500,39300,102800
"TR","1996-06-27",1996,6,179,310000,75300,41900,427200
"TR","1996-06-28",1996,6,180,364000,93300,45600,502900
"TR","1996-06-29",1996,6,181,0,78700,37600,116300
"TR","1996-06-30",1996,6,182,116000,77000,38800,231800
"TR","1996-07-01",1996,7,183,40500,72300,38400,151200
"TR","1996-07-02",1996,7,184,93900,70100,38800,202800
"TR","1996-07-03",1996,7,185,127000,70800,39300,237100
"TR","1996-07-04",1996,7,186,0,65000,37900,102900
"TR","1996-07-05",1996,7,187,0,60200,37800,98000
"TR","1996-07-06",1996,7,188,0,55200,37300,92500
"TR","1996-07-07",1996,7,189,42000,54400,36500,132900
"TR","1996-07-08",1996,7,190,176000,59400,37800,273200
"TR","1996-07-09",1996,7,191,148000,62700,38000,248700
"TR","1996-07-10",1996,7,192,3540,58900,36700,99140
"TR","1996-07-11",1996,7,193,885,55900,36600,93385
"TR","1996-07-12",1996,7,194,0,53800,36400,90200
"TR","1996-07-13",1996,7,195,468000,74700,40800,583500
"TR","1996-07-14",1996,7,196,50900,65600,36700,153200
"TR","1996-07-15",1996,7,197,1770,61100,36400,99270
"TR","1996-07-16",1996,7,198,3020,57800,36300,97120
"TR","1996-07-17",1996,7,199,0,54800,36000,90800
"TR","1996-07-18",1996,7,200,0,53600,35800,89400
"TR","1996-07-19",1996,7,201,523000,80700,42400,646100
"TR","1996-07-20",1996,7,202,56300,68000,36200,160500
"TR","1996-07-21",1996,7,203,0,62300,35100,97400
"TR","1996-07-22",1996,7,204,15400,59200,35400,110000
"TR","1996-07-23",1996,7,205,0,55900,35100,91000
"TR","1996-07-24",1996,7,206,20400,54200,34900,109500
"TR","1996-07-25",1996,7,207,39300,54100,35000,128400
"TR","1996-07-26",1996,7,208,51600,54100,35200,140900
"TR","1996-07-27",1996,7,209,0,52800,34700,87500
"TR","1996-07-28",1996,7,210,0,52000,34700,86700
"TR","1996-07-29",1996,7,211,611000,78300,40200,729500
"TR","1996-07-30",1996,7,212,143000,70700,39500,253200
"TR","1996-07-31",1996,7,213,7820,64300,34600,106720
"TR","1996-08-01",1996,8,214,25300,61100,35000,121400
"TR","1996-08-02",1996,8,215,0,57300,34900,92200
"TR","1996-08-03",1996,8,216,0,54500,35200,89700
"TR","1996-08-04",1996,8,217,0,52700,35300,88000
"TR","1996-08-05",1996,8,218,0,51300,34900,86200
"TR","1996-08-06",1996,8,219,264000,56800,37000,357800
"TR","1996-08-07",1996,8,220,761000,109000,79800,949800
"TR","1996-08-08",1996,8,221,250000,99500,53100,402600
"TR","1996-08-09",1996,8,222,0,89400,33900,123300
"TR","1996-08-10",1996,8,223,0,82800,34800,117600
"TR","1996-08-11",1996,8,224,0,75500,35100,110600
"TR","1996-08-12",1996,8,225,0,69700,35300,105000
"TR","1996-08-13",1996,8,226,16900,65500,35400,117800
"TR","1996-08-14",1996,8,227,57200,64600,36000,157800
"TR","1996-08-15",1996,8,228,31600,61800,35900,129300
"TR","1996-08-16",1996,8,229,137000,65100,37400,239500
"TR","1996-08-17",1996,8,230,0,61000,36200,97200
"TR","1996-08-18",1996,8,231,0,57500,36500,94000
"TR","1996-08-19",1996,8,232,0,54700,36100,90800
"TR","1996-08-20",1996,8,233,14800,53900,36000,104700
"TR","1996-08-21",1996,8,234,66300,55000,36600,157900
"TR","1996-08-22",1996,8,235,0,53700,36100,89800
"TR","1996-08-23",1996,8,236,580000,88400,44300,712700
"TR","1996-08-24",1996,8,237,0,72100,35500,107600
"TR","1996-08-25",1996,8,238,0,66900,36100,103000
"TR","1996-08-26",1996,8,239,0,63000,36200,99200
"TR","1996-08-27",1996,8,240,58000,62400,36700,157100
"TR","1996-08-28",1996,8,241,0,58700,36300,95000
"TR","1996-08-29",1996,8,242,0,55300,36300,91600
"TR","1996-08-30",1996,8,243,0,53800,36100,89900
"TR","1996-08-31",1996,8,244,0,52500,36000,88500
"TR","1996-09-01",1996,9,245,0,51200,35800,87000
"TR","1996-09-02",1996,9,246,0,50300,35700,86000
"TR","1996-09-03",1996,9,247,0,49800,35700,85500
"TR","1996-09-04",1996,9,248,32800,49700,35700,118200
"TR","1996-09-05",1996,9,249,389000,60300,37700,487000
"TR","1996-09-06",1996,9,250,0,54600,35700,90300
"TR","1996-09-07",1996,9,251,0,53400,36100,89500
"TR","1996-09-08",1996,9,252,0,52200,36100,88300
"TR","1996-09-09",1996,9,253,46200,52100,36100,134400
"TR","1996-09-10",1996,9,254,0,51000,35900,86900
"TR","1996-09-11",1996,9,255,35600,51100,36000,122700
"TR","1996-09-12",1996,9,256,103000,53000,36700,192700
"TR","1996-09-13",1996,9,257,17100,52100,35900,105100
"TR","1996-09-14",1996,9,258,0,51300,35700,87000
"TR","1996-09-15",1996,9,259,0,50900,35800,86700
"TR","1996-09-16",1996,9,260,0,50400,35700,86100
"TR","1996-09-17",1996,9,261,0,49800,35600,85400
"TR","1996-09-18",1996,9,262,0,49300,35500,84800
"TR","1996-09-19",1996,9,263,0,48900,35400,84300
"TR","1996-09-20",1996,9,264,0,48500,35300,83800
"TR","1996-09-21",1996,9,265,0,48100,35300,83400
"TR","1996-09-22",1996,9,266,60600,49000,35400,145000
"TR","1996-09-23",1996,9,267,45300,49700,35100,130100
"TR","1996-09-24",1996,9,268,49800,50700,35300,135800
"TR","1996-09-25",1996,9,269,17100,50100,35000,102200
"TR","1996-09-26",1996,9,270,145000,53900,35600,234500
"TR","1996-09-27",1996,9,271,0,51600,34700,86300
"TR","1996-09-28",1996,9,272,180000,55900,36200,272100
"TR","1996-09-29",1996,9,273,16500,53900,34300,104700
"TR","1996-09-30",1996,9,274,5690,52800,34200,92690
"TR","1996-10-01",1996,10,275,7500,52200,34300,94000
"TR","1996-10-02",1996,10,276,0,51500,34400,85900
"TR","1996-10-03",1996,10,277,0,50900,34500,85400
"TR","1996-10-04",1996,10,278,0,50300,34300,84600
"TR","1996-10-05",1996,10,279,0,50000,34200,84200
"TR","1996-10-06",1996,10,280,0,49800,34200,84000
"TR","1996-10-07",1996,10,281,33200,50500,34200,117900
"TR","1996-10-08",1996,10,282,10400,49900,34000,94300
"TR","1996-10-09",1996,10,283,2670,49600,33900,86170
"TR","1996-10-10",1996,10,284,38700,50500,34000,123200
"TR","1996-10-11",1996,10,285,6850,50000,33700,90550
"TR","1996-10-12",1996,10,286,0,49600,33600,83200
"TR","1996-10-13",1996,10,287,0,49400,33800,83200
"TR","1996-10-14",1996,10,288,0,49300,34000,83300
"TR","1996-10-15",1996,10,289,16100,49500,34100,99700
"TR","1996-10-16",1996,10,290,21300,49500,34000,104800
"TR","1996-10-17",1996,10,291,134000,53700,34600,222300
"TR","1996-10-18",1996,10,292,376000,72800,37100,485900
"TR","1996-10-19",1996,10,293,38200,64400,32500,135100
"TR","1996-10-20",1996,10,294,0,60300,32200,92500
"TR","1996-10-21",1996,10,295,0,57900,32600,90500
"TR","1996-10-22",1996,10,296,48500,58800,32800,140100
"TR","1996-10-23",1996,10,297,56900,61100,33100,151100
"TR","1996-10-24",1996,10,298,396000,89800,57000,542800
"TR","1996-10-25",1996,10,299,106000,82300,43400,231700
"TR","1996-10-26",1996,10,300,0,74600,31900,106500
"TR","1996-10-27",1996,10,301,0,69000,31500,100500
"TR","1996-10-28",1996,10,302,0,65000,31900,96900
"TR","1996-10-29",1996,10,303,0,62100,32000,94100
"TR","1996-10-30",1996,10,304,391000,76300,38700,506000
"TR","1996-10-31",1996,10,305,366000,84600,39800,490400
"TR","1996-11-01",1996,11,306,2280,77400,31000,110680
"TR","1996-11-02",1996,11,307,10000,72800,31000,113800
"TR","1996-11-03",1996,11,308,8640,69300,31300,109240
"TR","1996-11-04",1996,11,309,0,66300,31700,98000
"TR","1996-11-05",1996,11,310,50100,69200,39100,158400
"TR","1996-11-06",1996,11,311,74300,75800,43600,193700
"TR","1996-11-07",1996,11,312,10000,80200,51200,141400
"TR","1996-11-08",1996,11,313,0,74800,37600,112400
"TR","1996-11-09",1996,11,314,0,69900,32800,102700
"TR","1996-11-10",1996,11,315,22000,67400,32800,122200
"TR","1996-11-11",1996,11,316,159000,68700,32200,259900
"TR","1996-11-12",1996,11,317,32400,67300,32300,132000
"TR","1996-11-13",1996,11,318,0,65300,32700,98000
"TR","1996-11-14",1996,11,319,0,63800,33000,96800
"TR","1996-11-15",1996,11,320,0,62500,33200,95700
"TR","1996-11-16",1996,11,321,0,61400,33400,94800
"TR","1996-11-17",1996,11,322,705000,80600,31100,816700
"TR","1996-11-18",1996,11,323,465000,83900,29400,578300
"TR","1996-11-19",1996,11,324,0,79800,29700,109500
"TR","1996-11-20",1996,11,325,0,74900,30400,105300
"TR","1996-11-21",1996,11,326,0,71000,31000,102000
"TR","1996-11-22",1996,11,327,0,67900,31500,99400
"TR","1996-11-23",1996,11,328,0,65500,32000,97500
"TR","1996-11-24",1996,11,329,22900,64100,32200,119200
"TR","1996-11-25",1996,11,330,10000,62700,32400,105100
"TR","1996-11-26",1996,11,331,10800,61700,32600,105100
"TR","1996-11-27",1996,11,332,0,60700,32800,93500
"TR","1996-11-28",1996,11,333,0,59900,33000,92900
"TR","1996-11-29",1996,11,334,0,59200,33100,92300
"TR","1996-11-30",1996,11,335,80100,60100,32900,173100
"TR","1996-12-01",1996,12,336,162000,63900,32200,258100
"TR","1996-12-02",1996,12,337,1210,62300,32200,95710
"TR","1996-12-03",1996,12,338,1210,61000,32600,94810
"TR","1996-12-04",1996,12,339,0,59900,32800,92700
"TR","1996-12-05",1996,12,340,0,59100,33000,92100
"TR","1996-12-06",1996,12,341,25400,58900,33000,117300
"TR","1996-12-07",1996,12,342,48500,59400,32800,140700
"TR","1996-12-08",1996,12,343,44900,59700,32700,137300
"TR","1996-12-09",1996,12,344,1210,58800,32800,92810
"TR","1996-12-10",1996,12,345,0,58100,33000,91100
"TR","1996-12-11",1996,12,346,0,57500,33100,90600
"TR","1996-12-12",1996,12,347,0,56900,33200,90100
"TR","1996-12-13",1996,12,348,6740,56600,33200,96540
"TR","1996-12-14",1996,12,349,0,56200,33200,89400
"TR","1996-12-15",1996,12,350,0,55900,33300,89200
"TR","1996-12-16",1996,12,351,141000,58900,32700,232600
"TR","1996-12-17",1996,12,352,2420,58000,32600,93020
"TR","1996-12-18",1996,12,353,0,57300,32700,90000
"TR","1996-12-19",1996,12,354,121000,59300,32300,212600
"TR","1996-12-20",1996,12,355,27600,58900,32200,118700
"TR","1996-12-21",1996,12,356,9080,58100,32300,99480
"TR","1996-12-22",1996,12,357,5680,57400,32400,95480
"TR","1996-12-23",1996,12,358,6740,56800,32500,96040
"TR","1996-12-24",1996,12,359,49900,57700,32400,140000
"TR","1996-12-25",1996,12,360,43100,58000,32200,133300
"TR","1996-12-26",1996,12,361,0,57100,32300,89400
"TR","1996-12-27",1996,12,362,0,56400,32400,88800
"TR","1996-12-28",1996,12,363,45000,56600,32300,133900
"TR","1996-12-29",1996,12,364,13100,56400,32300,101800
"TR","1996-12-30",1996,12,365,9080,55900,32300,97280
"TR","1996-12-31",1996,12,366,179000,59700,31600,270300
"TR","1997-01-01",1997,1,1,54600,59700,31300,145600
"TR","1997-01-02",1997,1,2,0,58200,31500,89700
"TR","1997-01-03",1997,1,3,2020,57000,31800,90820
"TR","1997-01-04",1997,1,4,0,56000,31900,87900
"TR","1997-01-05",1997,1,5,5530,55300,32000,92830
"TR","1997-01-06",1997,1,6,459000,65900,30300,555200
"TR","1997-01-07",1997,1,7,9480,63500,30000,102980
"TR","1997-01-08",1997,1,8,0,61300,30400,91700
"TR","1997-01-09",1997,1,9,0,59400,30800,90200
"TR","1997-01-10",1997,1,10,0,57900,31000,88900
"TR","1997-01-11",1997,1,11,95300,58700,30800,184800
"TR","1997-01-12",1997,1,12,17800,57900,30800,106500
"TR","1997-01-13",1997,1,13,2020,56800,31000,89820
"TR","1997-01-14",1997,1,14,2020,55900,31200,89120
"TR","1997-01-15",1997,1,15,0,55200,31300,86500
"TR","1997-01-16",1997,1,16,702,54600,31400,86702
"TR","1997-01-17",1997,1,17,2020,54100,31500,87620
"TR","1997-01-18",1997,1,18,0,53800,31500,85300
"TR","1997-01-19",1997,1,19,20100,53900,31500,105500
"TR","1997-01-20",1997,1,20,0,53600,31500,85100
"TR","1997-01-21",1997,1,21,0,53400,31600,85000
"TR","1997-01-22",1997,1,22,0,53200,31600,84800
"TR","1997-01-23",1997,1,23,140000,55700,31000,226700
"TR","1997-01-24",1997,1,24,34700,55800,30800,121300
"TR","1997-01-25",1997,1,25,184000,59100,30200,273300
"TR","1997-01-26",1997,1,26,261000,63400,29300,353700
"TR","1997-01-27",1997,1,27,0,60900,29300,90200
"TR","1997-01-28",1997,1,28,22000,59300,29700,111000
"TR","1997-01-29",1997,1,29,12700,57900,29900,100500
"TR","1997-01-30",1997,1,30,26800,57300,30000,114100
"TR","1997-01-31",1997,1,31,1880,56000,30200,88080
"TR","1997-02-01",1997,2,32,49700,56300,30200,136200
"TR","1997-02-02",1997,2,33,2430,55100,30300,87830
"TR","1997-02-03",1997,2,34,0,54200,30500,84700
"TR","1997-02-04",1997,2,35,0,53400,30600,84000
"TR","1997-02-05",1997,2,36,0,53000,30700,83700
"TR","1997-02-06",1997,2,37,0,52700,30800,83500
"TR","1997-02-07",1997,2,38,0,52500,30800,83300
"TR","1997-02-08",1997,2,39,0,52300,30800,83100
"TR","1997-02-09",1997,2,40,0,52100,30900,83000
"TR","1997-02-10",1997,2,41,0,51900,30900,82800
"TR","1997-02-11",1997,2,42,0,51800,30900,82700
"TR","1997-02-12",1997,2,43,24600,51800,30800,107200
"TR","1997-02-13",1997,2,44,0,51600,30800,82400
"TR","1997-02-14",1997,2,45,0,51400,30800,82200
"TR","1997-02-15",1997,2,46,0,51300,30800,82100
"TR","1997-02-16",1997,2,47,1130,51100,30800,83030
"TR","1997-02-17",1997,2,48,66300,51600,30500,148400
"TR","1997-02-18",1997,2,49,0,51400,30500,81900
"TR","1997-02-19",1997,2,50,0,51200,30600,81800
"TR","1997-02-20",1997,2,51,0,51000,30600,81600
"TR","1997-02-21",1997,2,52,0,50800,30600,81400
"TR","1997-02-22",1997,2,53,0,50600,30700,81300
"TR","1997-02-23",1997,2,54,0,50400,30600,81000
"TR","1997-02-24",1997,2,55,0,50300,30600,80900
"TR","1997-02-25",1997,2,56,0,50100,30600,80700
"TR","1997-02-26",1997,2,57,0,50000,30600,80600
"TR","1997-02-27",1997,2,58,0,49800,30600,80400
"TR","1997-02-28",1997,2,59,0,49700,30600,80300
"TR","1997-03-01",1997,3,60,22500,49600,30500,102600
"TR","1997-03-02",1997,3,61,49100,49800,30200,129100
"TR","1997-03-03",1997,3,62,0,49600,30200,79800
"TR","1997-03-04",1997,3,63,16600,49500,30200,96300
"TR","1997-03-05",1997,3,64,18100,49400,30200,97700
"TR","1997-03-06",1997,3,65,0,49200,30200,79400
"TR","1997-03-07",1997,3,66,0,49000,30300,79300
"TR","1997-03-08",1997,3,67,0,48900,30200,79100
"TR","1997-03-09",1997,3,68,0,48700,30300,79000
"TR","1997-03-10",1997,3,69,31000,48600,30200,109800
"TR","1997-03-11",1997,3,70,74900,49000,29800,153700
"TR","1997-03-12",1997,3,71,101000,49800,29300,180100
"TR","1997-03-13",1997,3,72,0,49500,29300,78800
"TR","1997-03-14",1997,3,73,0,49300,29500,78800
"TR","1997-03-15",1997,3,74,280000,51700,28500,360200
"TR","1997-03-16",1997,3,75,71200,52600,28100,151900
"TR","1997-03-17",1997,3,76,0,51400,28300,79700
"TR","1997-03-18",1997,3,77,0,50700,28600,79300
"TR","1997-03-19",1997,3,78,0,50300,28800,79100
"TR","1997-03-20",1997,3,79,0,49900,29000,78900
"TR","1997-03-21",1997,3,80,0,49600,29200,78800
"TR","1997-03-22",1997,3,81,0,49200,29300,78500
"TR","1997-03-23",1997,3,82,0,48900,29400,78300
"TR","1997-03-24",1997,3,83,33500,48800,29300,111600
"TR","1997-03-25",1997,3,84,78600,49000,29000,156600
"TR","1997-03-26",1997,3,85,134000,49700,28400,212100
"TR","1997-03-27",1997,3,86,0,49400,28500,77900
"TR","1997-03-28",1997,3,87,0,48900,28800,77700
"TR","1997-03-29",1997,3,88,155000,49200,28400,232600
"TR","1997-03-30",1997,3,89,280000,52700,27400,360100
"TR","1997-03-31",1997,3,90,4140,50900,27400,82440
"TR","1997-04-01",1997,4,91,0,50100,27800,77900
"TR","1997-04-02",1997,4,92,0,49800,28100,77900
"TR","1997-04-03",1997,4,93,0,49400,28300,77700
"TR","1997-04-04",1997,4,94,5760,56400,39400,101560
"TR","1997-04-05",1997,4,95,0,56200,40200,96400
"TR","1997-04-06",1997,4,96,89400,279000,458000,826400
"TR","1997-04-07",1997,4,97,80700,107000,48200,235900
"TR","1997-04-08",1997,4,98,25800,94500,29700,150000
"TR","1997-04-09",1997,4,99,12100,87800,27700,127600
"TR","1997-04-10",1997,4,100,0,82700,27900,110600
"TR","1997-04-11",1997,4,101,0,76600,28300,104900
"TR","1997-04-12",1997,4,102,0,71000,28700,99700
"TR","1997-04-13",1997,4,103,0,66500,29000,95500
"TR","1997-04-14",1997,4,104,0,63300,29300,92600
"TR","1997-04-15",1997,4,105,0,62300,30300,92600
"TR","1997-04-16",1997,4,106,0,62200,38400,100600
"TR","1997-04-17",1997,4,107,0,65300,41700,107000
"TR","1997-04-18",1997,4,108,0,60400,31300,91700
"TR","1997-04-19",1997,4,109,0,62600,37500,100100
"TR","1997-04-20",1997,4,110,21100,73900,52100,147100
"TR","1997-04-21",1997,4,111,16100,77300,49600,143000
"TR","1997-04-22",1997,4,112,0,72800,40800,113600
"TR","1997-04-23",1997,4,113,0,73500,42400,115900
"TR","1997-04-24",1997,4,114,0,74100,44000,118100
"TR","1997-04-25",1997,4,115,0,74900,44800,119700
"TR","1997-04-26",1997,4,116,0,76300,44500,120800
"TR","1997-04-27",1997,4,117,0,80200,50300,130500
"TR","1997-04-28",1997,4,118,45600,282000,317000,644600
"TR","1997-04-29",1997,4,119,0,211000,178000,389000
"TR","1997-04-30",1997,4,120,19800,121000,74200,215000
"TR","1997-05-01",1997,5,121,50800,112000,37300,200100
"TR","1997-05-02",1997,5,122,61900,108000,39500,209400
"TR","1997-05-03",1997,5,123,0,103000,36500,139500
"TR","1997-05-04",1997,5,124,0,99400,37200,136600
"TR","1997-05-05",1997,5,125,0,96900,37600,134500
"TR","1997-05-06",1997,5,126,151000,101000,40400,292400
"TR","1997-05-07",1997,5,127,71500,95700,39900,207100
"TR","1997-05-08",1997,5,128,66500,93000,39900,199400
"TR","1997-05-09",1997,5,129,86400,91700,40600,218700
"TR","1997-05-10",1997,5,130,9570,86900,39200,135670
"TR","1997-05-11",1997,5,131,0,81100,38500,119600
"TR","1997-05-12",1997,5,132,22200,76900,38800,137900
"TR","1997-05-13",1997,5,133,115000,78100,40200,233300
"TR","1997-05-14",1997,5,134,57000,76800,39800,173600
"TR","1997-05-15",1997,5,135,54800,75600,40100,170500
"TR","1997-05-16",1997,5,136,44800,74900,40400,160100
"TR","1997-05-17",1997,5,137,44300,73600,40500,158400
"TR","1997-05-18",1997,5,138,78000,75600,41400,195000
"TR","1997-05-19",1997,5,139,217000,86700,49300,353000
"TR","1997-05-20",1997,5,140,204000,94000,57300,355300
"TR","1997-05-21",1997,5,141,2800,82900,39000,124700
"TR","1997-05-22",1997,5,142,0,77900,38900,116800
"TR","1997-05-23",1997,5,143,0,74400,39100,113500
"TR","1997-05-24",1997,5,144,130000,77600,41000,248600
"TR","1997-05-25",1997,5,145,36100,75000,40100,151200
"TR","1997-05-26",1997,5,146,25100,72400,39700,137200
"TR","1997-05-27",1997,5,147,0,69100,39100,108200
"TR","1997-05-28",1997,5,148,0,66100,39100,105200
"TR","1997-05-29",1997,5,149,0,63200,38100,101300
"TR","1997-05-30",1997,5,150,170000,68700,39700,278400
"TR","1997-05-31",1997,5,151,333000,89400,51200,473600
"TR","1997-06-01",1997,6,152,17700,77000,38600,133300
"TR","1997-06-02",1997,6,153,0,70600,38100,108700
"TR","1997-06-03",1997,6,154,0,65200,37600,102800
"TR","1997-06-04",1997,6,155,0,61900,36800,98700
"TR","1997-06-05",1997,6,156,137000,65100,37700,239800
"TR","1997-06-06",1997,6,157,266000,76100,40100,382200
"TR","1997-06-07",1997,6,158,192000,81000,41200,314200
"TR","1997-06-08",1997,6,159,9770,74300,38200,122270
"TR","1997-06-09",1997,6,160,14100,70600,38100,122800
"TR","1997-06-10",1997,6,161,0,66500,37900,104400
"TR","1997-06-11",1997,6,162,0,63100,37400,100500
"TR","1997-06-12",1997,6,163,0,60500,37200,97700
"TR","1997-06-13",1997,6,164,54700,60500,37200,152400
"TR","1997-06-14",1997,6,165,0,58300,36800,95100
"TR","1997-06-15",1997,6,166,0,56900,36700,93600
"TR","1997-06-16",1997,6,167,139000,61000,37400,237400
"TR","1997-06-17",1997,6,168,375000,80300,41200,496500
"TR","1997-06-18",1997,6,169,66300,73800,37500,177600
"TR","1997-06-19",1997,6,170,101000,75100,38500,214600
"TR","1997-06-20",1997,6,171,0,69700,37200,106900
"TR","1997-06-21",1997,6,172,18500,66800,37400,122700
"TR","1997-06-22",1997,6,173,0,63500,37000,100500
"TR","1997-06-23",1997,6,174,0,60800,36900,97700
"TR","1997-06-24",1997,6,175,0,58400,36600,95000
"TR","1997-06-25",1997,6,176,210000,64900,37800,312700
"TR","1997-06-26",1997,6,177,156000,68300,38200,262500
"TR","1997-06-27",1997,6,178,0,63600,36700,100300
"TR","1997-06-28",1997,6,179,0,60500,36600,97100
"TR","1997-06-29",1997,6,180,11100,58100,36400,105600
"TR","1997-06-30",1997,6,181,182000,64200,38100,284300
"TR","1997-07-01",1997,7,182,289000,78000,40200,407200
"TR","1997-07-02",1997,7,183,14100,68300,36200,118600
"TR","1997-07-03",1997,7,184,217000,75900,38800,331700
"TR","1997-07-04",1997,7,185,118000,73700,37100,228800
"TR","1997-07-05",1997,7,186,131000,76500,43500,251000
"TR","1997-07-06",1997,7,187,7010,69600,35800,112410
"TR","1997-07-07",1997,7,188,10600,65500,35700,111800
"TR","1997-07-08",1997,7,189,67300,64900,36000,168200
"TR","1997-07-09",1997,7,190,221000,75800,45000,341800
"TR","1997-07-10",1997,7,191,0,67900,35400,103300
"TR","1997-07-11",1997,7,192,0,62600,35600,98200
"TR","1997-07-12",1997,7,193,0,57100,34800,91900
"TR","1997-07-13",1997,7,194,21000,54500,34200,109700
"TR","1997-07-14",1997,7,195,72900,54700,34000,161600
"TR","1997-07-15",1997,7,196,146000,57300,34800,238100
"TR","1997-07-16",1997,7,197,0,54600,33900,88500
"TR","1997-07-17",1997,7,198,75900,55100,34200,165200
"TR","1997-07-18",1997,7,199,260000,64600,36500,361100
"TR","1997-07-19",1997,7,200,0,58800,34200,93000
"TR","1997-07-20",1997,7,201,0,55400,34200,89600
"TR","1997-07-21",1997,7,202,0,53600,34000,87600
"TR","1997-07-22",1997,7,203,0,52600,33900,86500
"TR","1997-07-23",1997,7,204,0,51700,33700,85400
"TR","1997-07-24",1997,7,205,2660,51000,33600,87260
"TR","1997-07-25",1997,7,206,0,50200,33600,83800
"TR","1997-07-26",1997,7,207,0,49500,33500,83000
"TR","1997-07-27",1997,7,208,316000,56000,35000,407000
"TR","1997-07-28",1997,7,209,0,53000,33400,86400
"TR","1997-07-29",1997,7,210,0,51600,33600,85200
"TR","1997-07-30",1997,7,211,0,50300,33300,83600
"TR","1997-07-31",1997,7,212,0,49600,33300,82900
"TR","1997-08-01",1997,8,213,0,48900,33200,82100
"TR","1997-08-02",1997,8,214,141000,51000,33900,225900
"TR","1997-08-03",1997,8,215,0,48900,33600,82500
"TR","1997-08-04",1997,8,216,0,47600,33800,81400
"TR","1997-08-05",1997,8,217,57800,47900,33900,139600
"TR","1997-08-06",1997,8,218,0,47000,33800,80800
"TR","1997-08-07",1997,8,219,36400,46800,34000,117200
"TR","1997-08-08",1997,8,220,0,46100,33800,79900
"TR","1997-08-09",1997,8,221,0,45600,33900,79500
"TR","1997-08-10",1997,8,222,0,45100,33900,79000
"TR","1997-08-11",1997,8,223,9870,44800,33900,88570
"TR","1997-08-12",1997,8,224,0,44400,33800,78200
"TR","1997-08-13",1997,8,225,0,44200,33800,78000
"TR","1997-08-14",1997,8,226,25300,44300,33700,103300
"TR","1997-08-15",1997,8,227,110000,46500,33800,190300
"TR","1997-08-16",1997,8,228,851000,79200,37900,968100
"TR","1997-08-17",1997,8,229,450000,89200,67700,606900
"TR","1997-08-18",1997,8,230,193000,86600,42200,321800
"TR","1997-08-19",1997,8,231,106000,83000,37900,226900
"TR","1997-08-20",1997,8,232,0,74700,31200,105900
"TR","1997-08-21",1997,8,233,532000,104000,62900,698900
"TR","1997-08-22",1997,8,234,81400,90600,36000,208000
"TR","1997-08-23",1997,8,235,0,82800,32000,114800
"TR","1997-08-24",1997,8,236,31600,77300,32800,141700
"TR","1997-08-25",1997,8,237,49900,73800,33700,157400
"TR","1997-08-26",1997,8,238,2110,69000,33600,104710
"TR","1997-08-27",1997,8,239,0,64800,33800,98600
"TR","1997-08-28",1997,8,240,0,61800,33900,95700
"TR","1997-08-29",1997,8,241,0,58100,34100,92200
"TR","1997-08-30",1997,8,242,0,55600,33800,89400
"TR","1997-08-31",1997,8,243,164000,61000,34900,259900
"TR","1997-09-01",1997,9,244,215000,69900,36800,321700
"TR","1997-09-02",1997,9,245,47500,65500,35100,148100
"TR","1997-09-03",1997,9,246,116000,68000,36500,220500
"TR","1997-09-04",1997,9,247,0,63100,34900,98000
"TR","1997-09-05",1997,9,248,0,60400,35100,95500
"TR","1997-09-06",1997,9,249,1420,57900,35000,94320
"TR","1997-09-07",1997,9,250,0,55700,34900,90600
"TR","1997-09-08",1997,9,251,0,54700,34800,89500
"TR","1997-09-09",1997,9,252,0,53900,34700,88600
"TR","1997-09-10",1997,9,253,162000,58100,36100,256200
"TR","1997-09-11",1997,9,254,0,55600,34800,90400
"TR","1997-09-12",1997,9,255,0,54800,34900,89700
"TR","1997-09-13",1997,9,256,0,53900,34800,88700
"TR","1997-09-14",1997,9,257,13200,53200,34700,101100
"TR","1997-09-15",1997,9,258,28500,53100,34800,116400
"TR","1997-09-16",1997,9,259,6600,52300,34700,93600
"TR","1997-09-17",1997,9,260,238000,59200,36300,333500
"TR","1997-09-18",1997,9,261,137000,61000,36300,234300
"TR","1997-09-19",1997,9,262,72600,60500,35500,168600
"TR","1997-09-20",1997,9,263,85900,62100,36000,184000
"TR","1997-09-21",1997,9,264,66200,61600,35500,163300
"TR","1997-09-22",1997,9,265,0,58700,34900,93600
"TR","1997-09-23",1997,9,266,0,56900,35100,92000
"TR","1997-09-24",1997,9,267,0,55200,34900,90100
"TR","1997-09-25",1997,9,268,0,54400,34800,89200
"TR","1997-09-26",1997,9,269,0,53600,34600,88200
"TR","1997-09-27",1997,9,270,0,52900,34500,87400
"TR","1997-09-28",1997,9,271,15800,52500,34400,102700
"TR","1997-09-29",1997,9,272,30800,52700,34500,118000
"TR","1997-09-30",1997,9,273,22400,52400,34300,109100
"TR","1997-10-01",1997,10,274,30700,52500,34300,117500
"TR","1997-10-02",1997,10,275,0,51900,34100,86000
"TR","1997-10-03",1997,10,276,0,51500,34200,85700
"TR","1997-10-04",1997,10,277,0,50900,34100,85000
"TR","1997-10-05",1997,10,278,0,50200,34100,84300
"TR","1997-10-06",1997,10,279,24100,50100,34000,108200
"TR","1997-10-07",1997,10,280,185000,55100,34400,274500
"TR","1997-10-08",1997,10,281,257000,66500,36300,359800
"TR","1997-10-09",1997,10,282,120000,68500,35100,223600
"TR","1997-10-10",1997,10,283,103000,72100,42000,217100
"TR","1997-10-11",1997,10,284,0,66600,33300,99900
"TR","1997-10-12",1997,10,285,0,63000,33400,96400
"TR","1997-10-13",1997,10,286,0,60200,33500,93700
"TR","1997-10-14",1997,10,287,483000,96200,63700,642900
"TR","1997-10-15",1997,10,288,26900,81300,37400,145600
"TR","1997-10-16",1997,10,289,2280,74700,32600,109580
"TR","1997-10-17",1997,10,290,0,70300,32900,103200
"TR","1997-10-18",1997,10,291,0,66900,33200,100100
"TR","1997-10-19",1997,10,292,0,64100,33300,97400
"TR","1997-10-20",1997,10,293,64500,65500,33700,163700
"TR","1997-10-21",1997,10,294,54600,67300,34200,156100
"TR","1997-10-22",1997,10,295,8460,65300,34000,107760
"TR","1997-10-23",1997,10,296,0,62900,33900,96800
"TR","1997-10-24",1997,10,297,0,61400,34000,95400
"TR","1997-10-25",1997,10,298,0,60000,34000,94000
"TR","1997-10-26",1997,10,299,0,58900,33900,92800
"TR","1997-10-27",1997,10,300,0,58000,33900,91900
"TR","1997-10-28",1997,10,301,0,57300,33800,91100
"TR","1997-10-29",1997,10,302,0,56800,33800,90600
"TR","1997-10-30",1997,10,303,0,56000,33700,89700
"TR","1997-10-31",1997,10,304,48300,57600,33900,139800
"TR","1997-11-01",1997,11,305,47200,58900,34100,140200
"TR","1997-11-02",1997,11,306,2e+05,72800,41000,313800
"TR","1997-11-03",1997,11,307,6440,65800,34300,106540
"TR","1997-11-04",1997,11,308,0,62400,33200,95600
"TR","1997-11-05",1997,11,309,6480,60600,33400,100480
"TR","1997-11-06",1997,11,310,0,59000,33200,92200
"TR","1997-11-07",1997,11,311,0,57700,33200,90900
"TR","1997-11-08",1997,11,312,0,56800,33000,89800
"TR","1997-11-09",1997,11,313,0,56000,32900,88900
"TR","1997-11-10",1997,11,314,10000,55700,32800,98500
"TR","1997-11-11",1997,11,315,21300,55400,32500,109200
"TR","1997-11-12",1997,11,316,2160,55100,32600,89860
"TR","1997-11-13",1997,11,317,6480,55000,32500,93980
"TR","1997-11-14",1997,11,318,0,54700,32500,87200
"TR","1997-11-15",1997,11,319,16000,54600,32600,103200
"TR","1997-11-16",1997,11,320,25400,54900,32400,112700
"TR","1997-11-17",1997,11,321,8850,54900,32500,96250
"TR","1997-11-18",1997,11,322,0,54600,32600,87200
"TR","1997-11-19",1997,11,323,0,54300,32600,86900
"TR","1997-11-20",1997,11,324,0,54100,32700,86800
"TR","1997-11-21",1997,11,325,0,54000,32700,86700
"TR","1997-11-22",1997,11,326,0,53800,32700,86500
"TR","1997-11-23",1997,11,327,72300,54700,32300,159300
"TR","1997-11-24",1997,11,328,119000,57600,31800,208400
"TR","1997-11-25",1997,11,329,0,56700,31700,88400
"TR","1997-11-26",1997,11,330,0,56000,31900,87900
"TR","1997-11-27",1997,11,331,0,55100,32100,87200
"TR","1997-11-28",1997,11,332,0,54400,32300,86700
"TR","1997-11-29",1997,11,333,0,53900,32400,86300
"TR","1997-11-30",1997,11,334,0,53600,32400,86000
"TR","1997-12-01",1997,12,335,0,53500,32500,86000
"TR","1997-12-02",1997,12,336,0,53400,32500,85900
"TR","1997-12-03",1997,12,337,0,53300,32400,85700
"TR","1997-12-04",1997,12,338,36400,53400,32200,122000
"TR","1997-12-05",1997,12,339,42800,54200,31900,128900
"TR","1997-12-06",1997,12,340,119000,57100,31400,207500
"TR","1997-12-07",1997,12,341,71000,58500,31100,160600
"TR","1997-12-08",1997,12,342,0,57100,31100,88200
"TR","1997-12-09",1997,12,343,0,56000,31300,87300
"TR","1997-12-10",1997,12,344,0,55200,31400,86600
"TR","1997-12-11",1997,12,345,0,54500,31500,86000
"TR","1997-12-12",1997,12,346,0,53900,31500,85400
"TR","1997-12-13",1997,12,347,0,53400,31600,85000
"TR","1997-12-14",1997,12,348,0,53200,31600,84800
"TR","1997-12-15",1997,12,349,0,53000,31600,84600
"TR","1997-12-16",1997,12,350,0,52900,31600,84500
"TR","1997-12-17",1997,12,351,0,52800,31600,84400
"TR","1997-12-18",1997,12,352,0,52600,31600,84200
"TR","1997-12-19",1997,12,353,0,52500,31600,84100
"TR","1997-12-20",1997,12,354,0,52400,31600,84000
"TR","1997-12-21",1997,12,355,0,52300,31500,83800
"TR","1997-12-22",1997,12,356,0,52200,31500,83700
"TR","1997-12-23",1997,12,357,0,52000,31500,83500
"TR","1997-12-24",1997,12,358,0,51900,31500,83400
"TR","1997-12-25",1997,12,359,0,51800,31400,83200
"TR","1997-12-26",1997,12,360,0,51700,31400,83100
"TR","1997-12-27",1997,12,361,0,51600,31400,83000
"TR","1997-12-28",1997,12,362,0,51500,31400,82900
"TR","1997-12-29",1997,12,363,19500,51500,31200,102200
"TR","1997-12-30",1997,12,364,38800,51700,31000,121500
"TR","1997-12-31",1997,12,365,28800,51800,30900,111500
"TR","1998-01-01",1998,1,1,15400,51800,30800,98000
"TR","1998-01-02",1998,1,2,0,51700,30800,82500
"TR","1998-01-03",1998,1,3,0,51500,30900,82400
"TR","1998-01-04",1998,1,4,0,51300,30900,82200
"TR","1998-01-05",1998,1,5,0,51200,30900,82100
"TR","1998-01-06",1998,1,6,84400,51700,30600,166700
"TR","1998-01-07",1998,1,7,0,51500,30500,82000
"TR","1998-01-08",1998,1,8,0,51300,30600,81900
"TR","1998-01-09",1998,1,9,0,51200,30700,81900
"TR","1998-01-10",1998,1,10,98700,51700,30200,180600
"TR","1998-01-11",1998,1,11,4050,51600,30200,85850
"TR","1998-01-12",1998,1,12,0,51400,30300,81700
"TR","1998-01-13",1998,1,13,68900,51700,30000,150600
"TR","1998-01-14",1998,1,14,45500,52100,29800,127400
"TR","1998-01-15",1998,1,15,19800,51900,29800,101500
"TR","1998-01-16",1998,1,16,223000,56600,29000,308600
"TR","1998-01-17",1998,1,17,73200,56300,28700,158200
"TR","1998-01-18",1998,1,18,58600,56400,28700,143700
"TR","1998-01-19",1998,1,19,42600,56100,28700,127400
"TR","1998-01-20",1998,1,20,0,54500,28900,83400
"TR","1998-01-21",1998,1,21,0,53200,29100,82300
"TR","1998-01-22",1998,1,22,0,52200,29300,81500
"TR","1998-01-23",1998,1,23,0,51700,29400,81100
"TR","1998-01-24",1998,1,24,107000,53200,29000,189200
"TR","1998-01-25",1998,1,25,0,52200,29000,81200
"TR","1998-01-26",1998,1,26,22500,51700,29100,103300
"TR","1998-01-27",1998,1,27,40400,52200,29000,121600
"TR","1998-01-28",1998,1,28,10100,51600,29100,90800
"TR","1998-01-29",1998,1,29,0,51300,29200,80500
"TR","1998-01-30",1998,1,30,0,51000,29400,80400
"TR","1998-01-31",1998,1,31,0,50800,29500,80300
"TR","1998-02-01",1998,2,32,0,50500,29500,80000
"TR","1998-02-02",1998,2,33,22500,50400,29500,102400
"TR","1998-02-03",1998,2,34,108000,51100,29000,188100
"TR","1998-02-04",1998,2,35,0,50900,28900,79800
"TR","1998-02-05",1998,2,36,0,50700,29100,79800
"TR","1998-02-06",1998,2,37,0,50500,29200,79700
"TR","1998-02-07",1998,2,38,0,50300,29300,79600
"TR","1998-02-08",1998,2,39,0,50100,29300,79400
"TR","1998-02-09",1998,2,40,0,49900,29300,79200
"TR","1998-02-10",1998,2,41,0,49600,29400,79000
"TR","1998-02-11",1998,2,42,0,49400,29400,78800
"TR","1998-02-12",1998,2,43,0,49300,29400,78700
"TR","1998-02-13",1998,2,44,0,49100,29400,78500
"TR","1998-02-14",1998,2,45,0,48900,29400,78300
"TR","1998-02-15",1998,2,46,0,48700,29400,78100
"TR","1998-02-16",1998,2,47,6850,48600,29400,84850
"TR","1998-02-17",1998,2,48,1220,48400,29400,79020
"TR","1998-02-18",1998,2,49,3550,49700,29600,82850
"TR","1998-02-19",1998,2,50,0,49800,29900,79700
"TR","1998-02-20",1998,2,51,0,49900,29900,79800
"TR","1998-02-21",1998,2,52,0,49500,29600,79100
"TR","1998-02-22",1998,2,53,0,48700,29400,78100
"TR","1998-02-23",1998,2,54,0,48400,29400,77800
"TR","1998-02-24",1998,2,55,3550,51600,31900,87050
"TR","1998-02-25",1998,2,56,14900,53100,37400,105400
"TR","1998-02-26",1998,2,57,0,51800,33200,85000
"TR","1998-02-27",1998,2,58,14200,58300,44500,117000
"TR","1998-02-28",1998,2,59,32800,62900,48300,144000
"TR","1998-03-01",1998,3,60,12600,62300,37100,112000
"TR","1998-03-02",1998,3,61,22700,65000,41300,129000
"TR","1998-03-03",1998,3,62,17400,64900,43400,125700
"TR","1998-03-04",1998,3,63,21800,61000,31000,113800
"TR","1998-03-05",1998,3,64,17500,59400,30400,107300
"TR","1998-03-06",1998,3,65,14500,58000,30600,103100
"TR","1998-03-07",1998,3,66,28400,57200,30600,116200
"TR","1998-03-08",1998,3,67,54300,57700,30500,142500
"TR","1998-03-09",1998,3,68,8280,56400,30600,95280
"TR","1998-03-10",1998,3,69,28900,55800,30600,115300
"TR","1998-03-11",1998,3,70,10700,55000,30700,96400
"TR","1998-03-12",1998,3,71,0,54100,30700,84800
"TR","1998-03-13",1998,3,72,2070,53400,30800,86270
"TR","1998-03-14",1998,3,73,46700,53500,30700,130900
"TR","1998-03-15",1998,3,74,82200,55200,30400,167800
"TR","1998-03-16",1998,3,75,0,54100,30400,84500
"TR","1998-03-17",1998,3,76,0,53100,30600,83700
"TR","1998-03-18",1998,3,77,0,52600,30700,83300
"TR","1998-03-19",1998,3,78,20900,52300,30800,104000
"TR","1998-03-20",1998,3,79,85700,53500,30400,169600
"TR","1998-03-21",1998,3,80,0,52400,30500,82900
"TR","1998-03-22",1998,3,81,0,52000,30700,82700
"TR","1998-03-23",1998,3,82,0,51800,30800,82600
"TR","1998-03-24",1998,3,83,0,51500,30900,82400
"TR","1998-03-25",1998,3,84,0,51400,31000,82400
"TR","1998-03-26",1998,3,85,16800,54800,39400,111000
"TR","1998-03-27",1998,3,86,82900,59500,49600,192000
"TR","1998-03-28",1998,3,87,65500,57600,32700,155800
"TR","1998-03-29",1998,3,88,159000,65000,40000,264000
"TR","1998-03-30",1998,3,89,42500,60500,30000,133000
"TR","1998-03-31",1998,3,90,211000,71900,44500,327400
"TR","1998-04-01",1998,4,91,59200,66500,29800,155500
"TR","1998-04-02",1998,4,92,204000,74300,38100,316400
"TR","1998-04-03",1998,4,93,32700,70800,37400,140900
"TR","1998-04-04",1998,4,94,0,65300,29500,94800
"TR","1998-04-05",1998,4,95,0,62100,29800,91900
"TR","1998-04-06",1998,4,96,0,59400,29900,89300
"TR","1998-04-07",1998,4,97,60800,59700,30400,150900
"TR","1998-04-08",1998,4,98,130000,65200,37300,232500
"TR","1998-04-09",1998,4,99,1640,60300,30000,91940
"TR","1998-04-10",1998,4,100,0,57600,30000,87600
"TR","1998-04-11",1998,4,101,0,55700,30100,85800
"TR","1998-04-12",1998,4,102,0,54100,30100,84200
"TR","1998-04-13",1998,4,103,4560,53000,30000,87560
"TR","1998-04-14",1998,4,104,7160,52600,29900,89660
"TR","1998-04-15",1998,4,105,37700,53200,30100,121000
"TR","1998-04-16",1998,4,106,0,52100,29700,81800
"TR","1998-04-17",1998,4,107,0,51700,29800,81500
"TR","1998-04-18",1998,4,108,0,51400,29800,81200
"TR","1998-04-19",1998,4,109,12200,51400,29900,93500
"TR","1998-04-20",1998,4,110,52600,52100,30100,134800
"TR","1998-04-21",1998,4,111,46600,52200,30200,129000
"TR","1998-04-22",1998,4,112,0,51000,29900,80900
"TR","1998-04-23",1998,4,113,0,50400,30000,80400
"TR","1998-04-24",1998,4,114,0,50100,30100,80200
"TR","1998-04-25",1998,4,115,0,49900,30300,80200
"TR","1998-04-26",1998,4,116,0,49600,30400,80000
"TR","1998-04-27",1998,4,117,0,49400,30500,79900
"TR","1998-04-28",1998,4,118,0,49100,30600,79700
"TR","1998-04-29",1998,4,119,0,48900,30700,79600
"TR","1998-04-30",1998,4,120,0,48700,30800,79500
"TR","1998-05-01",1998,5,121,0,48400,30900,79300
"TR","1998-05-02",1998,5,122,0,48000,31100,79100
"TR","1998-05-03",1998,5,123,0,47600,31200,78800
"TR","1998-05-04",1998,5,124,0,47400,31300,78700
"TR","1998-05-05",1998,5,125,4430,47100,31400,82930
"TR","1998-05-06",1998,5,126,1400,46800,31600,79800
"TR","1998-05-07",1998,5,127,0,46400,31700,78100
"TR","1998-05-08",1998,5,128,0,46100,31900,78000
"TR","1998-05-09",1998,5,129,68200,47100,32300,147600
"TR","1998-05-10",1998,5,130,0,45900,31500,77400
"TR","1998-05-11",1998,5,131,0,44500,31200,75700
"TR","1998-05-12",1998,5,132,0,43500,31000,74500
"TR","1998-05-13",1998,5,133,97600,44700,30700,173000
"TR","1998-05-14",1998,5,134,266000,49100,31800,346900
"TR","1998-05-15",1998,5,135,0,47000,30200,77200
"TR","1998-05-16",1998,5,136,88700,47900,30600,167200
"TR","1998-05-17",1998,5,137,175000,49800,31200,256000
"TR","1998-05-18",1998,5,138,0,47800,29800,77600
"TR","1998-05-19",1998,5,139,0,46600,30000,76600
"TR","1998-05-20",1998,5,140,0,45400,29700,75100
"TR","1998-05-21",1998,5,141,0,44600,29700,74300
"TR","1998-05-22",1998,5,142,0,43900,29400,73300
"TR","1998-05-23",1998,5,143,0,43400,29400,72800
"TR","1998-05-24",1998,5,144,0,42900,29300,72200
"TR","1998-05-25",1998,5,145,0,42600,29300,71900
"TR","1998-05-26",1998,5,146,0,42200,29300,71500
"TR","1998-05-27",1998,5,147,0,41800,29300,71100
"TR","1998-05-28",1998,5,148,108000,43300,29200,180500
"TR","1998-05-29",1998,5,149,134000,45100,29200,208300
"TR","1998-05-30",1998,5,150,0,43700,28800,72500
"TR","1998-05-31",1998,5,151,244000,48100,29000,321100
"TR","1998-06-01",1998,6,152,319000,53000,29800,401800
"TR","1998-06-02",1998,6,153,179000,54900,28700,262600
"TR","1998-06-03",1998,6,154,116000,56400,28800,201200
"TR","1998-06-04",1998,6,155,4770,52900,28100,85770
"TR","1998-06-05",1998,6,156,0,50500,28300,78800
"TR","1998-06-06",1998,6,157,0,49600,28500,78100
"TR","1998-06-07",1998,6,158,0,48700,28600,77300
"TR","1998-06-08",1998,6,159,0,48000,28700,76700
"TR","1998-06-09",1998,6,160,0,47200,28700,75900
"TR","1998-06-10",1998,6,161,28700,47000,28700,104400
"TR","1998-06-11",1998,6,162,96900,48200,29200,174300
"TR","1998-06-12",1998,6,163,410000,62100,30300,502400
"TR","1998-06-13",1998,6,164,842000,103000,87800,1032800
"TR","1998-06-14",1998,6,165,8380,84100,29700,122180
"TR","1998-06-15",1998,6,166,0,79300,26300,105600
"TR","1998-06-16",1998,6,167,0,72000,26900,98900
"TR","1998-06-17",1998,6,168,0,65700,27300,93000
"TR","1998-06-18",1998,6,169,0,60600,27600,88200
"TR","1998-06-19",1998,6,170,0,56500,27800,84300
"TR","1998-06-20",1998,6,171,0,53000,28000,81000
"TR","1998-06-21",1998,6,172,9540,50600,28100,88240
"TR","1998-06-22",1998,6,173,0,49500,28300,77800
"TR","1998-06-23",1998,6,174,0,48700,28400,77100
"TR","1998-06-24",1998,6,175,92800,49800,28600,171200
"TR","1998-06-25",1998,6,176,267000,56800,29300,353100
"TR","1998-06-26",1998,6,177,219000,61600,29200,309800
"TR","1998-06-27",1998,6,178,104000,59400,28900,192300
"TR","1998-06-28",1998,6,179,155000,61500,29400,245900
"TR","1998-06-29",1998,6,180,230000,69500,30300,329800
"TR","1998-06-30",1998,6,181,155000,69300,28600,252900
"TR","1998-07-01",1998,7,182,79100,65900,28500,173500
"TR","1998-07-02",1998,7,183,0,58700,28100,86800
"TR","1998-07-03",1998,7,184,0,53600,28100,81700
"TR","1998-07-04",1998,7,185,1770,50700,28000,80470
"TR","1998-07-05",1998,7,186,885,49400,27900,78185
"TR","1998-07-06",1998,7,187,132000,51300,28100,211400
"TR","1998-07-07",1998,7,188,172000,53100,28800,253900
"TR","1998-07-08",1998,7,189,7010,50900,27900,85810
"TR","1998-07-09",1998,7,190,28700,49800,28200,106700
"TR","1998-07-10",1998,7,191,0,48300,28000,76300
"TR","1998-07-11",1998,7,192,0,47000,28100,75100
"TR","1998-07-12",1998,7,193,0,45800,28000,73800
"TR","1998-07-13",1998,7,194,0,44800,28000,72800
"TR","1998-07-14",1998,7,195,0,43900,28000,71900
"TR","1998-07-15",1998,7,196,18200,43200,28000,89400
"TR","1998-07-16",1998,7,197,4430,42400,28000,74830
"TR","1998-07-17",1998,7,198,0,41200,28200,69400
"TR","1998-07-18",1998,7,199,0,40600,28100,68700
"TR","1998-07-19",1998,7,200,0,39900,28100,68000
"TR","1998-07-20",1998,7,201,0,39100,28200,67300
"TR","1998-07-21",1998,7,202,0,38400,28300,66700
"TR","1998-07-22",1998,7,203,0,37400,28400,65800
"TR","1998-07-23",1998,7,204,0,36500,28500,65000
"TR","1998-07-24",1998,7,205,0,36200,28400,64600
"TR","1998-07-25",1998,7,206,0,35900,28300,64200
"TR","1998-07-26",1998,7,207,0,35600,28200,63800
"TR","1998-07-27",1998,7,208,77100,36700,28100,141900
"TR","1998-07-28",1998,7,209,27400,36200,28000,91600
"TR","1998-07-29",1998,7,210,0,35000,28000,63000
"TR","1998-07-30",1998,7,211,37800,34900,28100,100800
"TR","1998-07-31",1998,7,212,37200,34900,28000,100100
"TR","1998-08-01",1998,8,213,0,34200,27900,62100
"TR","1998-08-02",1998,8,214,0,33700,28300,62000
"TR","1998-08-03",1998,8,215,0,33100,28700,61800
"TR","1998-08-04",1998,8,216,0,32800,28900,61700
"TR","1998-08-05",1998,8,217,0,32600,29000,61600
"TR","1998-08-06",1998,8,218,31600,32800,29000,93400
"TR","1998-08-07",1998,8,219,29500,32900,28900,91300
"TR","1998-08-08",1998,8,220,28300,33100,28900,90300
"TR","1998-08-09",1998,8,221,110000,34900,28700,173600
"TR","1998-08-10",1998,8,222,6270,34100,28400,68770
"TR","1998-08-11",1998,8,223,0,33100,28900,62000
"TR","1998-08-12",1998,8,224,0,32400,29200,61600
"TR","1998-08-13",1998,8,225,0,32000,29200,61200
"TR","1998-08-14",1998,8,226,0,31700,29200,60900
"TR","1998-08-15",1998,8,227,10500,31500,29300,71300
"TR","1998-08-16",1998,8,228,38100,31500,29400,99000
"TR","1998-08-17",1998,8,229,145000,34000,29100,208100
"TR","1998-08-18",1998,8,230,328000,40800,28500,397300
"TR","1998-08-19",1998,8,231,0,37700,27100,64800
"TR","1998-08-20",1998,8,232,0,37100,27500,64600
"TR","1998-08-21",1998,8,233,0,36100,28000,64100
"TR","1998-08-22",1998,8,234,0,34700,28600,63300
"TR","1998-08-23",1998,8,235,112000,35900,28800,176700
"TR","1998-08-24",1998,8,236,385000,43600,28400,457000
"TR","1998-08-25",1998,8,237,6820,39700,26900,73420
"TR","1998-08-26",1998,8,238,0,38700,27500,66200
"TR","1998-08-27",1998,8,239,0,38100,27800,65900
"TR","1998-08-28",1998,8,240,0,37300,28000,65300
"TR","1998-08-29",1998,8,241,47300,37600,28100,113000
"TR","1998-08-30",1998,8,242,2270,36700,28200,67170
"TR","1998-08-31",1998,8,243,0,35900,28400,64300
"TR","1998-09-01",1998,9,244,0,35200,28600,63800
"TR","1998-09-02",1998,9,245,1420,34700,28600,64720
"TR","1998-09-03",1998,9,246,16600,34600,28600,79800
"TR","1998-09-04",1998,9,247,0,34300,28500,62800
"TR","1998-09-05",1998,9,248,0,34000,28600,62600
"TR","1998-09-06",1998,9,249,0,33600,28700,62300
"TR","1998-09-07",1998,9,250,0,33200,28800,62000
"TR","1998-09-08",1998,9,251,0,32900,28700,61600
"TR","1998-09-09",1998,9,252,0,32800,28700,61500
"TR","1998-09-10",1998,9,253,0,32600,28600,61200
"TR","1998-09-11",1998,9,254,0,32400,28600,61000
"TR","1998-09-12",1998,9,255,0,32200,28700,60900
"TR","1998-09-13",1998,9,256,3960,31800,28800,64560
"TR","1998-09-14",1998,9,257,48800,32300,28700,109800
"TR","1998-09-15",1998,9,258,20700,32200,28600,81500
"TR","1998-09-16",1998,9,259,6180,31900,28500,66580
"TR","1998-09-17",1998,9,260,0,31700,28500,60200
"TR","1998-09-18",1998,9,261,0,31500,28600,60100
"TR","1998-09-19",1998,9,262,0,31300,28600,59900
"TR","1998-09-20",1998,9,263,19800,31200,28600,79600
"TR","1998-09-21",1998,9,264,2850,31000,28600,62450
"TR","1998-09-22",1998,9,265,0,30800,28500,59300
"TR","1998-09-23",1998,9,266,0,31000,28400,59400
"TR","1998-09-24",1998,9,267,19800,31300,28200,79300
"TR","1998-09-25",1998,9,268,30400,31800,28100,90300
"TR","1998-09-26",1998,9,269,82600,33600,27700,143900
"TR","1998-09-27",1998,9,270,90700,35600,27300,153600
"TR","1998-09-28",1998,9,271,66400,36800,27000,130200
"TR","1998-09-29",1998,9,272,14500,36500,27000,78000
"TR","1998-09-30",1998,9,273,30700,36500,27200,94400
"TR","1998-10-01",1998,10,274,46200,36900,27100,110200
"TR","1998-10-02",1998,10,275,80300,38300,27000,145600
"TR","1998-10-03",1998,10,276,0,37800,26900,64700
"TR","1998-10-04",1998,10,277,0,37300,27200,64500
"TR","1998-10-05",1998,10,278,1610,36900,27300,65810
"TR","1998-10-06",1998,10,279,85300,38500,27100,150900
"TR","1998-10-07",1998,10,280,126000,41100,27000,194100
"TR","1998-10-08",1998,10,281,78900,41600,26600,147100
"TR","1998-10-09",1998,10,282,7710,41000,26300,75010
"TR","1998-10-10",1998,10,283,0,40200,26500,66700
"TR","1998-10-11",1998,10,284,0,39800,26800,66600
"TR","1998-10-12",1998,10,285,4830,39500,27000,71330
"TR","1998-10-13",1998,10,286,0,39300,26900,66200
"TR","1998-10-14",1998,10,287,1740,39300,26800,67840
"TR","1998-10-15",1998,10,288,0,39100,26800,65900
"TR","1998-10-16",1998,10,289,9780,39200,26700,75680
"TR","1998-10-17",1998,10,290,69200,40500,26600,136300
"TR","1998-10-18",1998,10,291,78500,41800,26600,146900
"TR","1998-10-19",1998,10,292,106000,43300,26900,176200
"TR","1998-10-20",1998,10,293,5620,42300,26200,74120
"TR","1998-10-21",1998,10,294,0,41500,26200,67700
"TR","1998-10-22",1998,10,295,0,41100,26300,67400
"TR","1998-10-23",1998,10,296,0,40800,26300,67100
"TR","1998-10-24",1998,10,297,0,40400,26300,66700
"TR","1998-10-25",1998,10,298,0,40200,26300,66500
"TR","1998-10-26",1998,10,299,0,40000,26300,66300
"TR","1998-10-27",1998,10,300,34500,40500,26400,101400
"TR","1998-10-28",1998,10,301,0,39800,26200,66000
"TR","1998-10-29",1998,10,302,0,39600,26100,65700
"TR","1998-10-30",1998,10,303,19300,39900,26100,85300
"TR","1998-10-31",1998,10,304,44500,40500,26000,111000
"TR","1998-11-01",1998,11,305,8260,40300,25900,74460
"TR","1998-11-02",1998,11,306,0,39600,25900,65500
"TR","1998-11-03",1998,11,307,0,39400,25800,65200
"TR","1998-11-04",1998,11,308,0,39200,25700,64900
"TR","1998-11-05",1998,11,309,0,39100,25700,64800
"TR","1998-11-06",1998,11,310,0,38900,25800,64700
"TR","1998-11-07",1998,11,311,0,38800,25800,64600
"TR","1998-11-08",1998,11,312,0,38700,25800,64500
"TR","1998-11-09",1998,11,313,6480,38600,25900,70980
"TR","1998-11-10",1998,11,314,69100,39700,25600,134400
"TR","1998-11-11",1998,11,315,189000,42100,25300,256400
"TR","1998-11-12",1998,11,316,199000,43100,24600,266700
"TR","1998-11-13",1998,11,317,0,42600,24400,67000
"TR","1998-11-14",1998,11,318,0,42300,24600,66900
"TR","1998-11-15",1998,11,319,0,42200,24800,67000
"TR","1998-11-16",1998,11,320,70100,42400,24600,137100
"TR","1998-11-17",1998,11,321,166000,43500,24000,233500
"TR","1998-11-18",1998,11,322,0,43200,24000,67200
"TR","1998-11-19",1998,11,323,54400,43900,24200,122500
"TR","1998-11-20",1998,11,324,87300,44600,24300,156200
"TR","1998-11-21",1998,11,325,10800,44100,23900,78800
"TR","1998-11-22",1998,11,326,0,43700,24000,67700
"TR","1998-11-23",1998,11,327,11200,43900,24300,79400
"TR","1998-11-24",1998,11,328,9650,45800,28000,83450
"TR","1998-11-25",1998,11,329,0,44800,27900,72700
"TR","1998-11-26",1998,11,330,0,44800,28400,73200
"TR","1998-11-27",1998,11,331,0,45300,31000,76300
"TR","1998-11-28",1998,11,332,0,44800,29600,74400
"TR","1998-11-29",1998,11,333,0,44000,24700,68700
"TR","1998-11-30",1998,11,334,0,43400,24700,68100
"TR","1998-12-01",1998,12,335,19500,43300,24600,87400
"TR","1998-12-02",1998,12,336,0,42900,24300,67200
"TR","1998-12-03",1998,12,337,0,42700,24300,67000
"TR","1998-12-04",1998,12,338,0,42500,24300,66800
"TR","1998-12-05",1998,12,339,20200,42700,24300,87200
"TR","1998-12-06",1998,12,340,29700,43000,24300,97000
"TR","1998-12-07",1998,12,341,9110,42700,24300,76110
"TR","1998-12-08",1998,12,342,0,42300,24300,66600
"TR","1998-12-09",1998,12,343,0,42100,24300,66400
"TR","1998-12-10",1998,12,344,0,41900,24300,66200
"TR","1998-12-11",1998,12,345,0,41600,24300,65900
"TR","1998-12-12",1998,12,346,0,41400,24300,65700
"TR","1998-12-13",1998,12,347,0,41200,24300,65500
"TR","1998-12-14",1998,12,348,0,41000,24300,65300
"TR","1998-12-15",1998,12,349,0,40900,24300,65200
"TR","1998-12-16",1998,12,350,0,40700,24300,65000
"TR","1998-12-17",1998,12,351,0,40500,24300,64800
"TR","1998-12-18",1998,12,352,0,40400,24200,64600
"TR","1998-12-19",1998,12,353,25300,40500,24100,89900
"TR","1998-12-20",1998,12,354,48500,40800,23900,113200
"TR","1998-12-21",1998,12,355,2420,40700,23900,67020
"TR","1998-12-22",1998,12,356,27100,40800,23800,91700
"TR","1998-12-23",1998,12,357,0,40700,23900,64600
"TR","1998-12-24",1998,12,358,0,40600,23900,64500
"TR","1998-12-25",1998,12,359,0,40500,23900,64400
"TR","1998-12-26",1998,12,360,0,40300,24000,64300
"TR","1998-12-27",1998,12,361,12500,40300,23900,76700
"TR","1998-12-28",1998,12,362,23300,40300,23800,87400
"TR","1998-12-29",1998,12,363,0,40200,23800,64000
"TR","1998-12-30",1998,12,364,57100,40600,23600,121300
"TR","1998-12-31",1998,12,365,0,40400,23600,64000
"TR","1999-01-01",1999,1,1,0,40300,23700,64000
"TR","1999-01-02",1999,1,2,0,40200,23700,63900
"TR","1999-01-03",1999,1,3,35600,40200,23600,99400
"TR","1999-01-04",1999,1,4,124000,41100,23200,188300
"TR","1999-01-05",1999,1,5,40400,41300,23000,104700
"TR","1999-01-06",1999,1,6,7500,41100,23100,71700
"TR","1999-01-07",1999,1,7,17200,41100,23100,81400
"TR","1999-01-08",1999,1,8,0,40900,23200,64100
"TR","1999-01-09",1999,1,9,0,40700,23300,64000
"TR","1999-01-10",1999,1,10,21000,40700,23300,85000
"TR","1999-01-11",1999,1,11,2370,40600,23400,66370
"TR","1999-01-12",1999,1,12,15000,40500,23400,78900
"TR","1999-01-13",1999,1,13,104000,41100,23000,168100
"TR","1999-01-14",1999,1,14,8090,41000,23000,72090
"TR","1999-01-15",1999,1,15,0,40800,23100,63900
"TR","1999-01-16",1999,1,16,13100,40700,23100,76900
"TR","1999-01-17",1999,1,17,50800,40900,23000,114700
"TR","1999-01-18",1999,1,18,16900,40700,23000,80600
"TR","1999-01-19",1999,1,19,48200,40900,22900,112000
"TR","1999-01-20",1999,1,20,21800,40800,22900,85500
"TR","1999-01-21",1999,1,21,0,40600,23000,63600
"TR","1999-01-22",1999,1,22,0,40400,23200,63600
"TR","1999-01-23",1999,1,23,0,40200,23300,63500
"TR","1999-01-24",1999,1,24,163000,41300,22700,227000
"TR","1999-01-25",1999,1,25,74800,41700,22300,138800
"TR","1999-01-26",1999,1,26,11600,41600,22400,75600
"TR","1999-01-27",1999,1,27,26300,41400,22500,90200
"TR","1999-01-28",1999,1,28,99300,42000,22300,163600
"TR","1999-01-29",1999,1,29,40800,42100,22200,105100
"TR","1999-01-30",1999,1,30,0,41800,22400,64200
"TR","1999-01-31",1999,1,31,0,41500,22600,64100
"TR","1999-02-01",1999,2,32,0,41200,22700,63900
"TR","1999-02-02",1999,2,33,9010,41000,22800,72810
"TR","1999-02-03",1999,2,34,23100,40900,22800,86800
"TR","1999-02-04",1999,2,35,0,40600,22900,63500
"TR","1999-02-05",1999,2,36,9720,40400,22900,73020
"TR","1999-02-06",1999,2,37,0,40200,23000,63200
"TR","1999-02-07",1999,2,38,0,40000,23100,63100
"TR","1999-02-08",1999,2,39,0,39800,23100,62900
"TR","1999-02-09",1999,2,40,0,39600,23200,62800
"TR","1999-02-10",1999,2,41,0,39400,23200,62600
"TR","1999-02-11",1999,2,42,0,39200,23300,62500
"TR","1999-02-12",1999,2,43,93500,39500,22900,155900
"TR","1999-02-13",1999,2,44,181000,40800,22200,244000
"TR","1999-02-14",1999,2,45,6080,40700,22100,68880
"TR","1999-02-15",1999,2,46,0,40400,22400,62800
"TR","1999-02-16",1999,2,47,0,40200,22600,62800
"TR","1999-02-17",1999,2,48,28200,40100,22600,90900
"TR","1999-02-18",1999,2,49,72500,40500,22400,135400
"TR","1999-02-19",1999,2,50,1220,40300,22400,63920
"TR","1999-02-20",1999,2,51,0,40000,22600,62600
"TR","1999-02-21",1999,2,52,0,39800,22700,62500
"TR","1999-02-22",1999,2,53,0,39600,22800,62400
"TR","1999-02-23",1999,2,54,0,39400,22900,62300
"TR","1999-02-24",1999,2,55,0,39200,22900,62100
"TR","1999-02-25",1999,2,56,13500,39100,22900,75500
"TR","1999-02-26",1999,2,57,44100,39200,22800,106100
"TR","1999-02-27",1999,2,58,0,39000,22800,61800
"TR","1999-02-28",1999,2,59,5320,38800,22900,67020
"TR","1999-03-01",1999,3,60,0,38600,23000,61600
"TR","1999-03-02",1999,3,61,8930,38400,23100,70430
"TR","1999-03-03",1999,3,62,20000,38300,23100,81400
"TR","1999-03-04",1999,3,63,8930,38100,23100,70130
"TR","1999-03-05",1999,3,64,4140,38000,23100,65240
"TR","1999-03-06",1999,3,65,13200,37900,23100,74200
"TR","1999-03-07",1999,3,66,0,37800,23100,60900
"TR","1999-03-08",1999,3,67,0,37600,23100,60700
"TR","1999-03-09",1999,3,68,0,37400,23200,60600
"TR","1999-03-10",1999,3,69,35100,37500,23100,95700
"TR","1999-03-11",1999,3,70,0,37300,23100,60400
"TR","1999-03-12",1999,3,71,0,37100,23200,60300
"TR","1999-03-13",1999,3,72,0,36900,23300,60200
"TR","1999-03-14",1999,3,73,0,36600,23400,60000
"TR","1999-03-15",1999,3,74,0,36300,23500,59800
"TR","1999-03-16",1999,3,75,0,36000,23600,59600
"TR","1999-03-17",1999,3,76,0,35800,23700,59500
"TR","1999-03-18",1999,3,77,33100,37100,23700,93900
"TR","1999-03-19",1999,3,78,57300,36900,23600,117800
"TR","1999-03-20",1999,3,79,0,37200,27800,65000
"TR","1999-03-21",1999,3,80,14500,38300,29700,82500
"TR","1999-03-22",1999,3,81,11200,37700,28900,77800
"TR","1999-03-23",1999,3,82,0,37200,23800,61000
"TR","1999-03-24",1999,3,83,0,36900,23600,60500
"TR","1999-03-25",1999,3,84,0,36800,23600,60400
"TR","1999-03-26",1999,3,85,0,36600,23700,60300
"TR","1999-03-27",1999,3,86,0,36900,23700,60600
"TR","1999-03-28",1999,3,87,0,38600,30600,69200
"TR","1999-03-29",1999,3,88,0,38700,31900,70600
"TR","1999-03-30",1999,3,89,46200,41500,33900,121600
"TR","1999-03-31",1999,3,90,0,40600,34000,74600
"TR","1999-04-01",1999,4,91,0,40800,41900,82700
"TR","1999-04-02",1999,4,92,959,41600,35900,78459
"TR","1999-04-03",1999,4,93,47100,42500,25100,114700
"TR","1999-04-04",1999,4,94,140000,45600,29400,215000
"TR","1999-04-05",1999,4,95,48500,44300,25600,118400
"TR","1999-04-06",1999,4,96,239000,50800,36100,325900
"TR","1999-04-07",1999,4,97,266000,55300,29800,351100
"TR","1999-04-08",1999,4,98,75500,59200,38900,173600
"TR","1999-04-09",1999,4,99,18300,55800,26000,100100
"TR","1999-04-10",1999,4,100,0,52000,22900,74900
"TR","1999-04-11",1999,4,101,1520,49100,23200,73820
"TR","1999-04-12",1999,4,102,1640,47000,23300,71940
"TR","1999-04-13",1999,4,103,0,46300,23400,69700
"TR","1999-04-14",1999,4,104,0,45700,23500,69200
"TR","1999-04-15",1999,4,105,0,45200,23600,68800
"TR","1999-04-16",1999,4,106,0,44700,23600,68300
"TR","1999-04-17",1999,4,107,0,44200,23600,67800
"TR","1999-04-18",1999,4,108,0,43700,23600,67300
"TR","1999-04-19",1999,4,109,4470,43400,23600,71470
"TR","1999-04-20",1999,4,110,55900,44300,23600,123800
"TR","1999-04-21",1999,4,111,33300,44000,23600,100900
"TR","1999-04-22",1999,4,112,51100,44000,23800,118900
"TR","1999-04-23",1999,4,113,959,42900,23700,67559
"TR","1999-04-24",1999,4,114,0,42200,23700,65900
"TR","1999-04-25",1999,4,115,0,41700,23900,65600
"TR","1999-04-26",1999,4,116,0,41400,24100,65500
"TR","1999-04-27",1999,4,117,0,40900,24300,65200
"TR","1999-04-28",1999,4,118,0,40700,24400,65100
"TR","1999-04-29",1999,4,119,0,40400,24500,64900
"TR","1999-04-30",1999,4,120,0,40100,24600,64700
"TR","1999-05-01",1999,5,121,0,39800,24700,64500
"TR","1999-05-02",1999,5,122,0,39400,25000,64400
"TR","1999-05-03",1999,5,123,0,38900,25300,64200
"TR","1999-05-04",1999,5,124,0,38400,25500,63900
"TR","1999-05-05",1999,5,125,0,38100,25600,63700
"TR","1999-05-06",1999,5,126,99800,40400,25800,166000
"TR","1999-05-07",1999,5,127,787000,75700,56200,918900
"TR","1999-05-08",1999,5,128,1130000,123000,110000,1363000
"TR","1999-05-09",1999,5,129,445000,114000,71000,630000
"TR","1999-05-10",1999,5,130,4580,99200,28100,131880
"TR","1999-05-11",1999,5,131,0,93600,21900,115500
"TR","1999-05-12",1999,5,132,0,89600,22800,112400
"TR","1999-05-13",1999,5,133,0,85700,23700,109400
"TR","1999-05-14",1999,5,134,0,81300,24300,105600
"TR","1999-05-15",1999,5,135,0,77000,24900,101900
"TR","1999-05-16",1999,5,136,4430,71000,25200,100630
"TR","1999-05-17",1999,5,137,33300,66100,25500,124900
"TR","1999-05-18",1999,5,138,524000,88900,33800,646700
"TR","1999-05-19",1999,5,139,353000,94800,50800,498600
"TR","1999-05-20",1999,5,140,0,83100,25600,108700
"TR","1999-05-21",1999,5,141,71900,80400,26100,178400
"TR","1999-05-22",1999,5,142,563000,107000,73800,743800
"TR","1999-05-23",1999,5,143,217000,101000,34600,352600
"TR","1999-05-24",1999,5,144,388000,111000,57200,556200
"TR","1999-05-25",1999,5,145,13800,97200,26000,137000
"TR","1999-05-26",1999,5,146,1400,91700,27000,120100
"TR","1999-05-27",1999,5,147,0,87000,27900,114900
"TR","1999-05-28",1999,5,148,0,82900,28900,111800
"TR","1999-05-29",1999,5,149,0,77200,29100,106300
"TR","1999-05-30",1999,5,150,0,70200,29300,99500
"TR","1999-05-31",1999,5,151,0,65100,29400,94500
"TR","1999-06-01",1999,6,152,0,61500,29700,91200
"TR","1999-06-02",1999,6,153,85700,62100,30500,178300
"TR","1999-06-03",1999,6,154,2380,58800,30400,91580
"TR","1999-06-04",1999,6,155,0,56700,30800,87500
"TR","1999-06-05",1999,6,156,0,54800,31200,86000
"TR","1999-06-06",1999,6,157,8840,53200,31500,93540
"TR","1999-06-07",1999,6,158,736000,91400,48600,876000
"TR","1999-06-08",1999,6,159,150000,85000,37900,272900
"TR","1999-06-09",1999,6,160,0,77300,30900,108200
"TR","1999-06-10",1999,6,161,50800,73200,31700,155700
"TR","1999-06-11",1999,6,162,86100,71400,32500,190000
"TR","1999-06-12",1999,6,163,85900,70100,32700,188700
"TR","1999-06-13",1999,6,164,184000,75600,37500,297100
"TR","1999-06-14",1999,6,165,0,68600,32100,100700
"TR","1999-06-15",1999,6,166,0,64500,32300,96800
"TR","1999-06-16",1999,6,167,0,61400,32200,93600
"TR","1999-06-17",1999,6,168,11100,59300,32200,102600
"TR","1999-06-18",1999,6,169,51000,59900,32500,143400
"TR","1999-06-19",1999,6,170,0,57400,32300,89700
"TR","1999-06-20",1999,6,171,2210,55700,32400,90310
"TR","1999-06-21",1999,6,172,8380,54200,32300,94880
"TR","1999-06-22",1999,6,173,0,52500,32300,84800
"TR","1999-06-23",1999,6,174,22100,51700,32200,106000
"TR","1999-06-24",1999,6,175,151000,56800,32700,240500
"TR","1999-06-25",1999,6,176,91600,57900,32600,182100
"TR","1999-06-26",1999,6,177,0,54800,32100,86900
"TR","1999-06-27",1999,6,178,0,52500,32300,84800
"TR","1999-06-28",1999,6,179,0,50700,32200,82900
"TR","1999-06-29",1999,6,180,28700,50200,32000,110900
"TR","1999-06-30",1999,6,181,49500,51200,32100,132800
"TR","1999-07-01",1999,7,182,201000,57800,32400,291200
"TR","1999-07-02",1999,7,183,20500,54200,31600,106300
"TR","1999-07-03",1999,7,184,112000,56100,31900,2e+05
"TR","1999-07-04",1999,7,185,146000,58200,32000,236200
"TR","1999-07-05",1999,7,186,157000,60500,32200,249700
"TR","1999-07-06",1999,7,187,65000,57500,31400,153900
"TR","1999-07-07",1999,7,188,189000,61900,32500,283400
"TR","1999-07-08",1999,7,189,0,56500,30700,87200
"TR","1999-07-09",1999,7,190,462000,77300,33300,572600
"TR","1999-07-10",1999,7,191,575000,100000,60900,735900
"TR","1999-07-11",1999,7,192,0,84600,28000,112600
"TR","1999-07-12",1999,7,193,0,78500,28800,107300
"TR","1999-07-13",1999,7,194,0,71300,29200,100500
"TR","1999-07-14",1999,7,195,23800,66000,29300,119100
"TR","1999-07-15",1999,7,196,7010,61200,29300,97510
"TR","1999-07-16",1999,7,197,0,56800,29400,86200
"TR","1999-07-17",1999,7,198,9810,53700,29500,93010
"TR","1999-07-18",1999,7,199,25100,51900,29600,106600
"TR","1999-07-19",1999,7,200,63100,52000,29600,144700
"TR","1999-07-20",1999,7,201,14800,50300,29500,94600
"TR","1999-07-21",1999,7,202,0,49200,29600,78800
"TR","1999-07-22",1999,7,203,31800,48800,29700,110300
"TR","1999-07-23",1999,7,204,74300,49600,29800,153700
"TR","1999-07-24",1999,7,205,43700,48900,29700,122300
"TR","1999-07-25",1999,7,206,0,47500,29600,77100
"TR","1999-07-26",1999,7,207,126000,49300,29800,205100
"TR","1999-07-27",1999,7,208,257000,53600,30600,341200
"TR","1999-07-28",1999,7,209,10600,49400,29200,89200
"TR","1999-07-29",1999,7,210,23800,48500,29500,101800
"TR","1999-07-30",1999,7,211,83900,49100,29900,162900
"TR","1999-07-31",1999,7,212,78500,49200,29800,157500
"TR","1999-08-01",1999,8,213,209000,52100,30700,291800
"TR","1999-08-02",1999,8,214,0,48000,29700,77700
"TR","1999-08-03",1999,8,215,114000,49200,30100,193300
"TR","1999-08-04",1999,8,216,154000,52100,30800,236900
"TR","1999-08-05",1999,8,217,92500,53100,30600,176200
"TR","1999-08-06",1999,8,218,96000,54100,31000,181100
"TR","1999-08-07",1999,8,219,62900,53200,30800,146900
"TR","1999-08-08",1999,8,220,40100,51600,30700,122400
"TR","1999-08-09",1999,8,221,22700,49600,30700,103000
"TR","1999-08-10",1999,8,222,48500,49500,30800,128800
"TR","1999-08-11",1999,8,223,58300,49800,31000,139100
"TR","1999-08-12",1999,8,224,2110,48200,30700,81010
"TR","1999-08-13",1999,8,225,321000,60200,32100,413300
"TR","1999-08-14",1999,8,226,510000,85500,40300,635800
"TR","1999-08-15",1999,8,227,0,70800,28100,98900
"TR","1999-08-16",1999,8,228,69600,67300,29100,166000
"TR","1999-08-17",1999,8,229,139000,70200,33900,243100
"TR","1999-08-18",1999,8,230,0,63100,29200,92300
"TR","1999-08-19",1999,8,231,14800,59300,29500,103600
"TR","1999-08-20",1999,8,232,33200,57300,29800,120300
"TR","1999-08-21",1999,8,233,0,53900,29800,83700
"TR","1999-08-22",1999,8,234,5330,51400,30000,86730
"TR","1999-08-23",1999,8,235,8430,49300,30000,87730
"TR","1999-08-24",1999,8,236,66200,50200,30400,146800
"TR","1999-08-25",1999,8,237,11800,48900,30100,90800
"TR","1999-08-26",1999,8,238,0,47900,30100,78000
"TR","1999-08-27",1999,8,239,0,47200,30200,77400
"TR","1999-08-28",1999,8,240,0,46300,30300,76600
"TR","1999-08-29",1999,8,241,0,45100,30400,75500
"TR","1999-08-30",1999,8,242,0,44200,30300,74500
"TR","1999-08-31",1999,8,243,0,43700,30200,73900
"TR","1999-09-01",1999,9,244,0,43400,30200,73600
"TR","1999-09-02",1999,9,245,0,42900,30300,73200
"TR","1999-09-03",1999,9,246,3960,42400,30500,76860
"TR","1999-09-04",1999,9,247,2640,41800,30600,75040
"TR","1999-09-05",1999,9,248,9650,41400,30600,81650
"TR","1999-09-06",1999,9,249,10800,41000,30700,82500
"TR","1999-09-07",1999,9,250,39200,41500,30600,111300
"TR","1999-09-08",1999,9,251,18500,41300,30500,90300
"TR","1999-09-09",1999,9,252,34300,41500,30500,106300
"TR","1999-09-10",1999,9,253,15800,41300,30400,87500
"TR","1999-09-11",1999,9,254,36000,41700,30300,108000
"TR","1999-09-12",1999,9,255,69600,42800,30200,142600
"TR","1999-09-13",1999,9,256,130000,44900,30300,205200
"TR","1999-09-14",1999,9,257,2260,43700,29800,75760
"TR","1999-09-15",1999,9,258,5350,43100,30000,78450
"TR","1999-09-16",1999,9,259,10700,42800,30000,83500
"TR","1999-09-17",1999,9,260,0,42400,30100,72500
"TR","1999-09-18",1999,9,261,0,42100,30100,72200
"TR","1999-09-19",1999,9,262,129000,44500,30300,203800
"TR","1999-09-20",1999,9,263,47500,44300,29900,121700
"TR","1999-09-21",1999,9,264,111000,45600,30200,186800
"TR","1999-09-22",1999,9,265,3760,44500,29700,77960
"TR","1999-09-23",1999,9,266,0,43900,29800,73700
"TR","1999-09-24",1999,9,267,0,43400,30000,73400
"TR","1999-09-25",1999,9,268,0,42900,29900,72800
"TR","1999-09-26",1999,9,269,0,42500,29900,72400
"TR","1999-09-27",1999,9,270,22400,42400,29800,94600
"TR","1999-09-28",1999,9,271,58700,43300,29800,131800
"TR","1999-09-29",1999,9,272,8340,43300,29700,81340
"TR","1999-09-30",1999,9,273,0,42800,29600,72400
"TR","1999-10-01",1999,10,274,0,42500,29700,72200
"TR","1999-10-02",1999,10,275,0,42200,29700,71900
"TR","1999-10-03",1999,10,276,0,41900,29600,71500
"TR","1999-10-04",1999,10,277,0,41700,29500,71200
"TR","1999-10-05",1999,10,278,0,41600,29400,71000
"TR","1999-10-06",1999,10,279,0,41400,29300,70700
"TR","1999-10-07",1999,10,280,10600,41500,29400,81500
"TR","1999-10-08",1999,10,281,1e+05,44000,29400,173400
"TR","1999-10-09",1999,10,282,207000,48500,30400,285900
"TR","1999-10-10",1999,10,283,50900,47200,28800,126900
"TR","1999-10-11",1999,10,284,0,46300,28500,74800
"TR","1999-10-12",1999,10,285,0,45400,28700,74100
"TR","1999-10-13",1999,10,286,1610,44900,28800,75310
"TR","1999-10-14",1999,10,287,0,44500,28800,73300
"TR","1999-10-15",1999,10,288,33500,45200,28700,107400
"TR","1999-10-16",1999,10,289,85800,46800,28900,161500
"TR","1999-10-17",1999,10,290,13900,46300,28700,88900
"TR","1999-10-18",1999,10,291,3050,45500,28600,77150
"TR","1999-10-19",1999,10,292,29300,45700,28600,103600
"TR","1999-10-20",1999,10,293,49900,46300,28600,124800
"TR","1999-10-21",1999,10,294,8570,46100,28500,83170
"TR","1999-10-22",1999,10,295,0,45400,28500,73900
"TR","1999-10-23",1999,10,296,2750,45000,28600,76350
"TR","1999-10-24",1999,10,297,0,44600,28400,73000
"TR","1999-10-25",1999,10,298,0,44300,28300,72600
"TR","1999-10-26",1999,10,299,0,44200,28300,72500
"TR","1999-10-27",1999,10,300,0,44100,28300,72400
"TR","1999-10-28",1999,10,301,0,44000,28200,72200
"TR","1999-10-29",1999,10,302,0,43800,28200,72000
"TR","1999-10-30",1999,10,303,72400,45600,28100,146100
"TR","1999-10-31",1999,10,304,111000,47600,28400,187000
"TR","1999-11-01",1999,11,305,22300,46500,27900,96700
"TR","1999-11-02",1999,11,306,0,45400,27800,73200
"TR","1999-11-03",1999,11,307,0,44500,27700,72200
"TR","1999-11-04",1999,11,308,0,44200,27600,71800
"TR","1999-11-05",1999,11,309,0,44100,27500,71600
"TR","1999-11-06",1999,11,310,0,44000,27400,71400
"TR","1999-11-07",1999,11,311,0,43900,27400,71300
"TR","1999-11-08",1999,11,312,0,43700,27300,71000
"TR","1999-11-09",1999,11,313,0,43500,27300,70800
"TR","1999-11-10",1999,11,314,0,43200,27200,70400
"TR","1999-11-11",1999,11,315,0,43000,27400,70400
"TR","1999-11-12",1999,11,316,0,42800,27400,70200
"TR","1999-11-13",1999,11,317,0,42700,27500,70200
"TR","1999-11-14",1999,11,318,0,42500,27500,70000
"TR","1999-11-15",1999,11,319,0,42300,27600,69900
"TR","1999-11-16",1999,11,320,0,42200,27600,69800
"TR","1999-11-17",1999,11,321,0,42100,27600,69700
"TR","1999-11-18",1999,11,322,0,42000,27600,69600
"TR","1999-11-19",1999,11,323,0,41800,27600,69400
"TR","1999-11-20",1999,11,324,5270,41800,27700,74770
"TR","1999-11-21",1999,11,325,706,41600,27700,70006
"TR","1999-11-22",1999,11,326,6710,41600,27700,76010
"TR","1999-11-23",1999,11,327,0,41400,27700,69100
"TR","1999-11-24",1999,11,328,174000,46600,28100,248700
"TR","1999-11-25",1999,11,329,394000,47700,26100,467800
"TR","1999-11-26",1999,11,330,0,46200,25400,71600
"TR","1999-11-27",1999,11,331,12000,46900,26000,84900
"TR","1999-11-28",1999,11,332,9750,46200,26100,82050
"TR","1999-11-29",1999,11,333,0,45700,26100,71800
"TR","1999-11-30",1999,11,334,0,45400,26200,71600
"TR","1999-12-01",1999,12,335,0,45100,26300,71400
"TR","1999-12-02",1999,12,336,0,44900,26300,71200
"TR","1999-12-03",1999,12,337,0,44700,26300,71000
"TR","1999-12-04",1999,12,338,0,44600,26200,70800
"TR","1999-12-05",1999,12,339,0,44600,26200,70800
"TR","1999-12-06",1999,12,340,0,44300,26200,70500
"TR","1999-12-07",1999,12,341,0,44000,26200,70200
"TR","1999-12-08",1999,12,342,0,43800,26200,70000
"TR","1999-12-09",1999,12,343,0,43700,26200,69900
"TR","1999-12-10",1999,12,344,0,43500,26200,69700
"TR","1999-12-11",1999,12,345,0,43300,26100,69400
"TR","1999-12-12",1999,12,346,0,43100,26100,69200
"TR","1999-12-13",1999,12,347,4760,43000,26100,73860
"TR","1999-12-14",1999,12,348,0,42900,26000,68900
"TR","1999-12-15",1999,12,349,0,42800,26000,68800
"TR","1999-12-16",1999,12,350,57700,43000,25800,126500
"TR","1999-12-17",1999,12,351,37900,43200,25500,106600
"TR","1999-12-18",1999,12,352,0,43100,25500,68600
"TR","1999-12-19",1999,12,353,0,42900,25600,68500
"TR","1999-12-20",1999,12,354,13500,42900,25600,82000
"TR","1999-12-21",1999,12,355,53700,43100,25300,122100
"TR","1999-12-22",1999,12,356,0,42900,25300,68200
"TR","1999-12-23",1999,12,357,0,42800,25400,68200
"TR","1999-12-24",1999,12,358,0,42600,25400,68000
"TR","1999-12-25",1999,12,359,0,42500,25400,67900
"TR","1999-12-26",1999,12,360,0,42400,25500,67900
"TR","1999-12-27",1999,12,361,0,42200,25500,67700
"TR","1999-12-28",1999,12,362,0,42100,25500,67600
"TR","1999-12-29",1999,12,363,35400,42200,25300,102900
"TR","1999-12-30",1999,12,364,17100,42200,25200,84500
"TR","1999-12-31",1999,12,365,0,42100,25200,67300
"TR","2000-01-01",2000,1,1,6060,42000,25200,73260
"TR","2000-01-02",2000,1,2,20600,41900,25200,87700
"TR","2000-01-03",2000,1,3,150000,43000,24600,217600
"TR","2000-01-04",2000,1,4,17900,42900,24500,85300
"TR","2000-01-05",2000,1,5,8090,42800,24600,75490
"TR","2000-01-06",2000,1,6,11300,42700,24600,78600
"TR","2000-01-07",2000,1,7,81400,43100,24400,148900
"TR","2000-01-08",2000,1,8,2020,42900,24400,69320
"TR","2000-01-09",2000,1,9,0,42700,24500,67200
"TR","2000-01-10",2000,1,10,128000,43200,24100,195300
"TR","2000-01-11",2000,1,11,29400,43200,24000,96600
"TR","2000-01-12",2000,1,12,4050,43000,24100,71150
"TR","2000-01-13",2000,1,13,0,42700,24300,67000
"TR","2000-01-14",2000,1,14,0,42500,24400,66900
"TR","2000-01-15",2000,1,15,0,42300,24500,66800
"TR","2000-01-16",2000,1,16,5580,42100,24500,72180
"TR","2000-01-17",2000,1,17,0,41900,24600,66500
"TR","2000-01-18",2000,1,18,18800,41800,24500,85100
"TR","2000-01-19",2000,1,19,37900,42000,24400,104300
"TR","2000-01-20",2000,1,20,28100,41900,24300,94300
"TR","2000-01-21",2000,1,21,10100,41800,24300,76200
"TR","2000-01-22",2000,1,22,0,41600,24400,66000
"TR","2000-01-23",2000,1,23,9380,41500,24400,75280
"TR","2000-01-24",2000,1,24,35300,41600,24300,101200
"TR","2000-01-25",2000,1,25,5630,41500,24300,71430
"TR","2000-01-26",2000,1,26,0,41300,24400,65700
"TR","2000-01-27",2000,1,27,0,41100,24400,65500
"TR","2000-01-28",2000,1,28,0,41000,24500,65500
"TR","2000-01-29",2000,1,29,0,40800,24500,65300
"TR","2000-01-30",2000,1,30,0,40600,24500,65100
"TR","2000-01-31",2000,1,31,0,40500,24600,65100
"TR","2000-02-01",2000,2,32,5630,40300,24600,70530
"TR","2000-02-02",2000,2,33,7290,40200,24600,72090
"TR","2000-02-03",2000,2,34,5630,40100,24500,70230
"TR","2000-02-04",2000,2,35,43200,40300,24400,107900
"TR","2000-02-05",2000,2,36,12100,40300,24300,76700
"TR","2000-02-06",2000,2,37,0,40100,24400,64500
"TR","2000-02-07",2000,2,38,0,40000,24400,64400
"TR","2000-02-08",2000,2,39,0,39900,24500,64400
"TR","2000-02-09",2000,2,40,0,39700,24500,64200
"TR","2000-02-10",2000,2,41,21400,39700,24400,85500
"TR","2000-02-11",2000,2,42,40100,39900,24200,104200
"TR","2000-02-12",2000,2,43,22800,39900,24100,86800
"TR","2000-02-13",2000,2,44,6760,39800,24200,70760
"TR","2000-02-14",2000,2,45,18300,39800,24200,82300
"TR","2000-02-15",2000,2,46,0,39700,24200,63900
"TR","2000-02-16",2000,2,47,50700,39800,24000,114500
"TR","2000-02-17",2000,2,48,101000,40500,23700,165200
"TR","2000-02-18",2000,2,49,0,40300,23700,64000
"TR","2000-02-19",2000,2,50,8330,40200,23800,72330
"TR","2000-02-20",2000,2,51,0,40000,23900,63900
"TR","2000-02-21",2000,2,52,0,39800,24000,63800
"TR","2000-02-22",2000,2,53,0,39600,24100,63700
"TR","2000-02-23",2000,2,54,0,39400,24100,63500
"TR","2000-02-24",2000,2,55,32700,39400,24000,96100
"TR","2000-02-25",2000,2,56,103000,43400,24200,170600
"TR","2000-02-26",2000,2,57,19500,48200,27800,95500
"TR","2000-02-27",2000,2,58,29700,53400,45300,128400
"TR","2000-02-28",2000,2,59,0,49300,30800,80100
"TR","2000-02-29",2000,2,60,0,47400,24900,72300
"TR","2000-03-01",2000,3,61,0,48000,27900,75900
"TR","2000-03-02",2000,3,62,0,47800,29800,77600
"TR","2000-03-03",2000,3,63,0,46500,26900,73400
"TR","2000-03-04",2000,3,64,0,45700,26500,72200
"TR","2000-03-05",2000,3,65,0,46400,32100,78500
"TR","2000-03-06",2000,3,66,0,47100,36600,83700
"TR","2000-03-07",2000,3,67,0,46400,34800,81200
"TR","2000-03-08",2000,3,68,0,45600,25100,70700
"TR","2000-03-09",2000,3,69,54800,46000,24900,125700
"TR","2000-03-10",2000,3,70,214000,51300,25200,290500
"TR","2000-03-11",2000,3,71,2230,47500,24300,74030
"TR","2000-03-12",2000,3,72,0,46400,24500,70900
"TR","2000-03-13",2000,3,73,0,45900,24600,70500
"TR","2000-03-14",2000,3,74,0,45400,24700,70100
"TR","2000-03-15",2000,3,75,84800,45400,24200,154400
"TR","2000-03-16",2000,3,76,85900,45800,24000,155700
"TR","2000-03-17",2000,3,77,5230,45600,24000,74830
"TR","2000-03-18",2000,3,78,0,45300,24200,69500
"TR","2000-03-19",2000,3,79,0,44900,24400,69300
"TR","2000-03-20",2000,3,80,19800,44900,24500,89200
"TR","2000-03-21",2000,3,81,0,44800,24700,69500
"TR","2000-03-22",2000,3,82,1310,45600,25900,72810
"TR","2000-03-23",2000,3,83,1410,44000,25000,70410
"TR","2000-03-24",2000,3,84,0,43000,24800,67800
"TR","2000-03-25",2000,3,85,11200,42500,24600,78300
"TR","2000-03-26",2000,3,86,14300,42400,24400,81100
"TR","2000-03-27",2000,3,87,48000,42900,24400,115300
"TR","2000-03-28",2000,3,88,170000,46100,25000,241100
"TR","2000-03-29",2000,3,89,32000,44400,24300,100700
"TR","2000-03-30",2000,3,90,0,43300,24100,67400
"TR","2000-03-31",2000,3,91,0,42700,24300,67000
"TR","2000-04-01",2000,4,92,0,42000,24400,66400
"TR","2000-04-02",2000,4,93,0,41700,24000,65700
"TR","2000-04-03",2000,4,94,16700,41800,24000,82500
"TR","2000-04-04",2000,4,95,52000,42600,24100,118700
"TR","2000-04-05",2000,4,96,26900,42300,24000,93200
"TR","2000-04-06",2000,4,97,6700,41800,24000,72500
"TR","2000-04-07",2000,4,98,33400,42000,24200,99600
"TR","2000-04-08",2000,4,99,0,41400,24000,65400
"TR","2000-04-09",2000,4,100,0,41100,24100,65200
"TR","2000-04-10",2000,4,101,2410,40900,24200,67510
"TR","2000-04-11",2000,4,102,22300,41200,24200,87700
"TR","2000-04-12",2000,4,103,33000,41000,24200,98200
"TR","2000-04-13",2000,4,104,39200,41700,24300,105200
"TR","2000-04-14",2000,4,105,108000,43500,24800,176300
"TR","2000-04-15",2000,4,106,9530,42400,24100,76030
"TR","2000-04-16",2000,4,107,46900,42600,24200,113700
"TR","2000-04-17",2000,4,108,271000,43800,23200,338000
"TR","2000-04-18",2000,4,109,71100,44000,22900,138000
"TR","2000-04-19",2000,4,110,33000,45200,23100,101300
"TR","2000-04-20",2000,4,111,6080,47200,30400,83680
"TR","2000-04-21",2000,4,112,159000,54300,40700,254000
"TR","2000-04-22",2000,4,113,213000,59300,28200,300500
"TR","2000-04-23",2000,4,114,0,57700,33300,91000
"TR","2000-04-24",2000,4,115,0,54800,32500,87300
"TR","2000-04-25",2000,4,116,0,50700,23400,74100
"TR","2000-04-26",2000,4,117,0,48400,23400,71800
"TR","2000-04-27",2000,4,118,0,47100,23500,70600
"TR","2000-04-28",2000,4,119,0,46400,23500,69900
"TR","2000-04-29",2000,4,120,11200,46000,23500,80700
"TR","2000-04-30",2000,4,121,18600,45700,23500,87800
"TR","2000-05-01",2000,5,122,25800,45700,23500,95000
"TR","2000-05-02",2000,5,123,16000,44800,23700,84500
"TR","2000-05-03",2000,5,124,0,44000,23500,67500
"TR","2000-05-04",2000,5,125,0,43400,23900,67300
"TR","2000-05-05",2000,5,126,0,42800,24300,67100
"TR","2000-05-06",2000,5,127,0,42300,24600,66900
"TR","2000-05-07",2000,5,128,0,41800,24800,66600
"TR","2000-05-08",2000,5,129,57700,42600,25000,125300
"TR","2000-05-09",2000,5,130,125000,43700,25700,194400
"TR","2000-05-10",2000,5,131,12400,41600,24700,78700
"TR","2000-05-11",2000,5,132,66500,42200,24700,133400
"TR","2000-05-12",2000,5,133,86800,43000,24800,154600
"TR","2000-05-13",2000,5,134,175000,45800,27000,247800
"TR","2000-05-14",2000,5,135,11100,43900,24100,79100
"TR","2000-05-15",2000,5,136,29500,43500,24300,97300
"TR","2000-05-16",2000,5,137,0,42500,24200,66700
"TR","2000-05-17",2000,5,138,20900,42000,24500,87400
"TR","2000-05-18",2000,5,139,0,41000,24200,65200
"TR","2000-05-19",2000,5,140,19100,40700,24200,84000
"TR","2000-05-20",2000,5,141,0,40200,24100,64300
"TR","2000-05-21",2000,5,142,0,39700,24300,64000
"TR","2000-05-22",2000,5,143,15500,39200,24100,78800
"TR","2000-05-23",2000,5,144,23000,39000,24100,86100
"TR","2000-05-24",2000,5,145,40700,39100,24100,103900
"TR","2000-05-25",2000,5,146,24400,38800,24000,87200
"TR","2000-05-26",2000,5,147,47800,38900,24100,110800
"TR","2000-05-27",2000,5,148,0,38100,23900,62000
"TR","2000-05-28",2000,5,149,109000,39800,24200,173000
"TR","2000-05-29",2000,5,150,127000,41200,24400,192600
"TR","2000-05-30",2000,5,151,4430,40100,23900,68430
"TR","2000-05-31",2000,5,152,0,39200,23900,63100
"TR","2000-06-01",2000,6,153,4780,38500,24000,67280
"TR","2000-06-02",2000,6,154,119000,40100,24300,183400
"TR","2000-06-03",2000,6,155,199000,42900,25000,266900
"TR","2000-06-04",2000,6,156,6630,41100,23800,71530
"TR","2000-06-05",2000,6,157,31800,40700,24200,96700
"TR","2000-06-06",2000,6,158,15700,40000,24200,79900
"TR","2000-06-07",2000,6,159,0,39200,24200,63400
"TR","2000-06-08",2000,6,160,17700,38700,24300,80700
"TR","2000-06-09",2000,6,161,47600,38700,24400,110700
"TR","2000-06-10",2000,6,162,0,37500,24500,62000
"TR","2000-06-11",2000,6,163,22100,36600,24700,83400
"TR","2000-06-12",2000,6,164,9360,36000,24600,69960
"TR","2000-06-13",2000,6,165,0,35400,24500,59900
"TR","2000-06-14",2000,6,166,13300,35100,24500,72900
"TR","2000-06-15",2000,6,167,99500,36300,24500,160300
"TR","2000-06-16",2000,6,168,276000,40800,24500,341300
"TR","2000-06-17",2000,6,169,158000,41200,23800,223000
"TR","2000-06-18",2000,6,170,33200,40200,23500,96900
"TR","2000-06-19",2000,6,171,133000,42100,23900,199000
"TR","2000-06-20",2000,6,172,357000,49700,25300,432000
"TR","2000-06-21",2000,6,173,371000,58800,40600,470400
"TR","2000-06-22",2000,6,174,772000,98700,78600,949300
"TR","2000-06-23",2000,6,175,113000,85000,30900,228900
"TR","2000-06-24",2000,6,176,81900,81000,22600,185500
"TR","2000-06-25",2000,6,177,84400,78300,23600,186300
"TR","2000-06-26",2000,6,178,113000,74900,23500,211400
"TR","2000-06-27",2000,6,179,256000,82900,40000,378900
"TR","2000-06-28",2000,6,180,0,71500,21900,93400
"TR","2000-06-29",2000,6,181,70700,67600,22400,160700
"TR","2000-06-30",2000,6,182,44800,63600,22900,131300
"TR","2000-07-01",2000,7,183,0,58200,23000,81200
"TR","2000-07-02",2000,7,184,112000,57400,23500,192900
"TR","2000-07-03",2000,7,185,109000,57800,23800,190600
"TR","2000-07-04",2000,7,186,48100,54700,23700,126500
"TR","2000-07-05",2000,7,187,0,50100,23500,73600
"TR","2000-07-06",2000,7,188,0,47800,23800,71600
"TR","2000-07-07",2000,7,189,18600,46700,23800,89100
"TR","2000-07-08",2000,7,190,378000,58200,24900,461100
"TR","2000-07-09",2000,7,191,519000,88900,52000,659900
"TR","2000-07-10",2000,7,192,569000,106000,72700,747700
"TR","2000-07-11",2000,7,193,0,88000,23000,111000
"TR","2000-07-12",2000,7,194,0,81200,22300,103500
"TR","2000-07-13",2000,7,195,0,72200,22900,95100
"TR","2000-07-14",2000,7,196,34000,66400,23500,123900
"TR","2000-07-15",2000,7,197,13300,60900,23800,98000
"TR","2000-07-16",2000,7,198,0,55900,24100,80000
"TR","2000-07-17",2000,7,199,0,52000,24500,76500
"TR","2000-07-18",2000,7,200,0,49500,24800,74300
"TR","2000-07-19",2000,7,201,0,48400,25000,73400
"TR","2000-07-20",2000,7,202,14000,47700,25200,86900
"TR","2000-07-21",2000,7,203,39300,47400,25600,112300
"TR","2000-07-22",2000,7,204,18100,46500,25600,90200
"TR","2000-07-23",2000,7,205,0,45600,25800,71400
"TR","2000-07-24",2000,7,206,0,45000,26000,71000
"TR","2000-07-25",2000,7,207,0,44000,26300,70300
"TR","2000-07-26",2000,7,208,42000,43800,26300,112100
"TR","2000-07-27",2000,7,209,175000,46400,26700,248100
"TR","2000-07-28",2000,7,210,55600,45800,26200,127600
"TR","2000-07-29",2000,7,211,75600,46200,26500,148300
"TR","2000-07-30",2000,7,212,47000,45700,26500,119200
"TR","2000-07-31",2000,7,213,0,44300,26500,70800
"TR","2000-08-01",2000,8,214,25200,43700,26600,95500
"TR","2000-08-02",2000,8,215,130000,45400,27100,202500
"TR","2000-08-03",2000,8,216,0,43800,26900,70700
"TR","2000-08-04",2000,8,217,0,42900,27300,70200
"TR","2000-08-05",2000,8,218,0,42100,27500,69600
"TR","2000-08-06",2000,8,219,0,41400,27600,69000
"TR","2000-08-07",2000,8,220,18800,41000,27700,87500
"TR","2000-08-08",2000,8,221,29900,40800,27900,98600
"TR","2000-08-09",2000,8,222,226000,45000,28200,299200
"TR","2000-08-10",2000,8,223,188000,46800,28200,263000
"TR","2000-08-11",2000,8,224,0,44200,27800,72000
"TR","2000-08-12",2000,8,225,0,42800,28000,70800
"TR","2000-08-13",2000,8,226,10500,41900,28100,80500
"TR","2000-08-14",2000,8,227,48000,42000,28300,118300
"TR","2000-08-15",2000,8,228,316000,49700,28800,394500
"TR","2000-08-16",2000,8,229,688000,76600,53500,818100
"TR","2000-08-17",2000,8,230,80100,65600,27000,172700
"TR","2000-08-18",2000,8,231,140000,68100,33200,241300
"TR","2000-08-19",2000,8,232,24500,62200,26000,112700
"TR","2000-08-20",2000,8,233,0,57600,26100,83700
"TR","2000-08-21",2000,8,234,0,54200,26500,80700
"TR","2000-08-22",2000,8,235,6320,51200,26800,84320
"TR","2000-08-23",2000,8,236,1330,49100,26900,77330
"TR","2000-08-24",2000,8,237,0,47800,27200,75000
"TR","2000-08-25",2000,8,238,0,46400,27400,73800
"TR","2000-08-26",2000,8,239,101000,47400,27400,175800
"TR","2000-08-27",2000,8,240,22800,46600,27100,96500
"TR","2000-08-28",2000,8,241,0,45500,27100,72600
"TR","2000-08-29",2000,8,242,0,44800,27300,72100
"TR","2000-08-30",2000,8,243,0,44000,27300,71300
"TR","2000-08-31",2000,8,244,10500,43400,27400,81300
"TR","2000-09-01",2000,9,245,13100,42800,27500,83400
"TR","2000-09-02",2000,9,246,3960,42000,27500,73460
"TR","2000-09-03",2000,9,247,212000,46000,28000,286000
"TR","2000-09-04",2000,9,248,182000,48500,28100,258600
"TR","2000-09-05",2000,9,249,0,46200,27400,73600
"TR","2000-09-06",2000,9,250,0,45300,27700,73000
"TR","2000-09-07",2000,9,251,0,44400,27800,72200
"TR","2000-09-08",2000,9,252,0,43700,27800,71500
"TR","2000-09-09",2000,9,253,2850,43100,27800,73750
"TR","2000-09-10",2000,9,254,35600,43100,27800,106500
"TR","2000-09-11",2000,9,255,34800,43000,27900,105700
"TR","2000-09-12",2000,9,256,66600,43600,28000,138200
"TR","2000-09-13",2000,9,257,61200,44000,27900,133100
"TR","2000-09-14",2000,9,258,0,43000,27600,70600
"TR","2000-09-15",2000,9,259,17300,42600,27700,87600
"TR","2000-09-16",2000,9,260,20300,42500,27700,90500
"TR","2000-09-17",2000,9,261,0,41900,27600,69500
"TR","2000-09-18",2000,9,262,0,41600,27600,69200
"TR","2000-09-19",2000,9,263,0,41000,27700,68700
"TR","2000-09-20",2000,9,264,51300,41500,27700,120500
"TR","2000-09-21",2000,9,265,46700,41700,27700,116100
"TR","2000-09-22",2000,9,266,8540,41200,27400,77140
"TR","2000-09-23",2000,9,267,63500,42600,27400,133500
"TR","2000-09-24",2000,9,268,47800,43400,27300,118500
"TR","2000-09-25",2000,9,269,5690,43200,27200,76090
"TR","2000-09-26",2000,9,270,0,42600,27200,69800
"TR","2000-09-27",2000,9,271,0,42200,27400,69600
"TR","2000-09-28",2000,9,272,0,41600,27300,68900
"TR","2000-09-29",2000,9,273,0,41100,27300,68400
"TR","2000-09-30",2000,9,274,0,40600,27300,67900
"TR","2000-10-01",2000,10,275,834,40100,27200,68134
"TR","2000-10-02",2000,10,276,0,39700,27300,67000
"TR","2000-10-03",2000,10,277,0,39300,27200,66500
"TR","2000-10-04",2000,10,278,0,39000,27100,66100
"TR","2000-10-05",2000,10,279,8050,39000,27000,74050
"TR","2000-10-06",2000,10,280,10600,39100,27000,76700
"TR","2000-10-07",2000,10,281,222000,40800,26200,289000
"TR","2000-10-08",2000,10,282,95900,41900,25700,163500
"TR","2000-10-09",2000,10,283,0,43400,26500,69900
"TR","2000-10-10",2000,10,284,0,44000,27100,71100
"TR","2000-10-11",2000,10,285,0,42800,26800,69600
"TR","2000-10-12",2000,10,286,0,42100,26900,69000
"TR","2000-10-13",2000,10,287,99000,44200,26900,170100
"TR","2000-10-14",2000,10,288,47000,44700,26500,118200
"TR","2000-10-15",2000,10,289,77600,45600,26700,149900
"TR","2000-10-16",2000,10,290,0,44700,26000,70700
"TR","2000-10-17",2000,10,291,1740,44000,26100,71840
"TR","2000-10-18",2000,10,292,0,43600,26200,69800
"TR","2000-10-19",2000,10,293,0,43100,26200,69300
"TR","2000-10-20",2000,10,294,0,42900,26200,69100
"TR","2000-10-21",2000,10,295,0,42600,26200,68800
"TR","2000-10-22",2000,10,296,0,42400,26100,68500
"TR","2000-10-23",2000,10,297,73900,44200,26000,144100
"TR","2000-10-24",2000,10,298,46800,44400,26200,117400
"TR","2000-10-25",2000,10,299,3470,43400,26000,72870
"TR","2000-10-26",2000,10,300,0,42600,26000,68600
"TR","2000-10-27",2000,10,301,15200,42400,26100,83700
"TR","2000-10-28",2000,10,302,8680,42200,26000,76880
"TR","2000-10-29",2000,10,303,0,42000,25800,67800
"TR","2000-10-30",2000,10,304,0,41900,25900,67800
"TR","2000-10-31",2000,10,305,0,41800,25800,67600
"TR","2000-11-01",2000,11,306,16100,42000,25800,83900
"TR","2000-11-02",2000,11,307,25700,42000,25800,93500
"TR","2000-11-03",2000,11,308,33300,42000,26100,101400
"TR","2000-11-04",2000,11,309,0,41400,25700,67100
"TR","2000-11-05",2000,11,310,0,41200,25700,66900
"TR","2000-11-06",2000,11,311,8950,41200,25800,75950
"TR","2000-11-07",2000,11,312,74700,42900,25900,143500
"TR","2000-11-08",2000,11,313,123000,45100,26300,194400
"TR","2000-11-09",2000,11,314,14400,43800,25300,83500
"TR","2000-11-10",2000,11,315,4010,42900,25200,72110
"TR","2000-11-11",2000,11,316,0,42400,25200,67600
"TR","2000-11-12",2000,11,317,22000,42600,25200,89800
"TR","2000-11-13",2000,11,318,60400,43500,25100,129000
"TR","2000-11-14",2000,11,319,132000,44100,24500,200600
"TR","2000-11-15",2000,11,320,173000,45200,23800,242000
"TR","2000-11-16",2000,11,321,28000,45100,23800,96900
"TR","2000-11-17",2000,11,322,59400,45300,23700,128400
"TR","2000-11-18",2000,11,323,22200,45100,23800,91100
"TR","2000-11-19",2000,11,324,5270,44900,23900,74070
"TR","2000-11-20",2000,11,325,60600,45000,23700,129300
"TR","2000-11-21",2000,11,326,51500,45100,23600,120200
"TR","2000-11-22",2000,11,327,21800,45000,23600,90400
"TR","2000-11-23",2000,11,328,2160,44800,23700,70660
"TR","2000-11-24",2000,11,329,0,44500,23800,68300
"TR","2000-11-25",2000,11,330,0,44200,23900,68100
"TR","2000-11-26",2000,11,331,0,43900,24000,67900
"TR","2000-11-27",2000,11,332,0,43600,24100,67700
"TR","2000-11-28",2000,11,333,0,43400,24200,67600
"TR","2000-11-29",2000,11,334,8640,43200,24200,76040
"TR","2000-11-30",2000,11,335,2160,42900,24300,69360
"TR","2000-12-01",2000,12,336,0,42700,24300,67000
"TR","2000-12-02",2000,12,337,0,42500,24300,66800
"TR","2000-12-03",2000,12,338,0,42400,24200,66600
"TR","2000-12-04",2000,12,339,0,42200,24200,66400
"TR","2000-12-05",2000,12,340,4500,42100,24100,70700
"TR","2000-12-06",2000,12,341,1420,42000,24100,67520
"TR","2000-12-07",2000,12,342,0,41800,24100,65900
"TR","2000-12-08",2000,12,343,21700,41900,23900,87500
"TR","2000-12-09",2000,12,344,27900,42000,23800,93700
"TR","2000-12-10",2000,12,345,2250,41900,23800,67950
"TR","2000-12-11",2000,12,346,20400,41900,23700,86000
"TR","2000-12-12",2000,12,347,0,41800,23700,65500
"TR","2000-12-13",2000,12,348,0,41600,23700,65300
"TR","2000-12-14",2000,12,349,13500,41600,23700,78800
"TR","2000-12-15",2000,12,350,20400,41600,23600,85600
"TR","2000-12-16",2000,12,351,31500,41600,23500,96600
"TR","2000-12-17",2000,12,352,23700,41700,23400,88800
"TR","2000-12-18",2000,12,353,33500,41800,23300,98600
"TR","2000-12-19",2000,12,354,14600,41700,23300,79600
"TR","2000-12-20",2000,12,355,18200,41700,23300,83200
"TR","2000-12-21",2000,12,356,15700,41600,23200,80500
"TR","2000-12-22",2000,12,357,40800,41800,23100,105700
"TR","2000-12-23",2000,12,358,7270,41600,23100,71970
"TR","2000-12-24",2000,12,359,2250,41500,23200,66950
"TR","2000-12-25",2000,12,360,6060,41400,23200,70660
"TR","2000-12-26",2000,12,361,11200,41300,23200,75700
"TR","2000-12-27",2000,12,362,0,41100,23300,64400
"TR","2000-12-28",2000,12,363,1210,41000,23300,65510
"TR","2000-12-29",2000,12,364,5620,40800,23300,69720
"TR","2000-12-30",2000,12,365,7270,40700,23300,71270
"TR","2000-12-31",2000,12,366,16900,40700,23200,80800
"TR","2001-01-01",2001,1,1,7870,40600,23200,71670
"TR","2001-01-02",2001,1,2,0,40500,23200,63700
"TR","2001-01-03",2001,1,3,0,40400,23300,63700
"TR","2001-01-04",2001,1,4,6070,40300,23300,69670
"TR","2001-01-05",2001,1,5,3750,40100,23300,67150
"TR","2001-01-06",2001,1,6,18900,40100,23300,82300
"TR","2001-01-07",2001,1,7,12100,40000,23200,75300
"TR","2001-01-08",2001,1,8,36300,40100,23100,99500
"TR","2001-01-09",2001,1,9,6070,40000,23100,69170
"TR","2001-01-10",2001,1,10,0,39900,23100,63000
"TR","2001-01-11",2001,1,11,0,39700,23200,62900
"TR","2001-01-12",2001,1,12,0,39600,23200,62800
"TR","2001-01-13",2001,1,13,0,39400,23300,62700
"TR","2001-01-14",2001,1,14,0,39200,23300,62500
"TR","2001-01-15",2001,1,15,69400,39500,23000,131900
"TR","2001-01-16",2001,1,16,102000,40200,22600,164800
"TR","2001-01-17",2001,1,17,29900,40300,22500,92700
"TR","2001-01-18",2001,1,18,0,40100,22600,62700
"TR","2001-01-19",2001,1,19,13100,40000,22700,75800
"TR","2001-01-20",2001,1,20,0,39800,22700,62500
"TR","2001-01-21",2001,1,21,0,39700,22800,62500
"TR","2001-01-22",2001,1,22,0,39500,22900,62400
"TR","2001-01-23",2001,1,23,0,39400,22900,62300
"TR","2001-01-24",2001,1,24,39500,39400,22800,101700
"TR","2001-01-25",2001,1,25,17200,39400,22700,79300
"TR","2001-01-26",2001,1,26,0,39200,22800,62000
"TR","2001-01-27",2001,1,27,30000,39200,22700,91900
"TR","2001-01-28",2001,1,28,51300,39500,22500,113300
"TR","2001-01-29",2001,1,29,0,39300,22500,61800
"TR","2001-01-30",2001,1,30,50700,39400,22400,112500
"TR","2001-01-31",2001,1,31,105000,40100,22100,167200
"TR","2001-02-01",2001,2,32,13400,39900,22000,75300
"TR","2001-02-02",2001,2,33,8060,39800,22200,70060
"TR","2001-02-03",2001,2,34,1220,39600,22300,63120
"TR","2001-02-04",2001,2,35,0,39400,22400,61800
"TR","2001-02-05",2001,2,36,19500,39400,22400,81300
"TR","2001-02-06",2001,2,37,0,39200,22400,61600
"TR","2001-02-07",2001,2,38,0,39000,22500,61500
"TR","2001-02-08",2001,2,39,29300,39000,22400,90700
"TR","2001-02-09",2001,2,40,90700,39400,22100,152200
"TR","2001-02-10",2001,2,41,65700,39800,21800,127300
"TR","2001-02-11",2001,2,42,3650,39600,21900,65150
"TR","2001-02-12",2001,2,43,7890,39500,22000,69390
"TR","2001-02-13",2001,2,44,0,39300,22100,61400
"TR","2001-02-14",2001,2,45,21400,39200,22100,82700
"TR","2001-02-15",2001,2,46,0,39000,22200,61200
"TR","2001-02-16",2001,2,47,0,38900,22300,61200
"TR","2001-02-17",2001,2,48,0,38700,22300,61000
"TR","2001-02-18",2001,2,49,0,38500,22400,60900
"TR","2001-02-19",2001,2,50,0,38300,22400,60700
"TR","2001-02-20",2001,2,51,0,38200,22500,60700
"TR","2001-02-21",2001,2,52,0,38000,22500,60500
"TR","2001-02-22",2001,2,53,6760,37900,22500,67160
"TR","2001-02-23",2001,2,54,6080,37800,22500,66380
"TR","2001-02-24",2001,2,55,37600,37900,22300,97800
"TR","2001-02-25",2001,2,56,32800,38000,22200,93000
"TR","2001-02-26",2001,2,57,45800,38200,22000,106000
"TR","2001-02-27",2001,2,58,24100,38300,22000,84400
"TR","2001-02-28",2001,2,59,0,38100,22100,60200
"TR","2001-03-01",2001,3,60,0,38000,22200,60200
"TR","2001-03-02",2001,3,61,0,37800,22200,60000
"TR","2001-03-03",2001,3,62,0,37500,22300,59800
"TR","2001-03-04",2001,3,63,0,37200,22500,59700
"TR","2001-03-05",2001,3,64,0,37000,22500,59500
"TR","2001-03-06",2001,3,65,0,36800,22500,59300
"TR","2001-03-07",2001,3,66,0,36700,22500,59200
"TR","2001-03-08",2001,3,67,16600,36600,22500,75700
"TR","2001-03-09",2001,3,68,21500,36600,22400,80500
"TR","2001-03-10",2001,3,69,6700,36400,22400,65500
"TR","2001-03-11",2001,3,70,12400,36300,22400,71100
"TR","2001-03-12",2001,3,71,27600,36400,22300,86300
"TR","2001-03-13",2001,3,72,98100,36900,21900,156900
"TR","2001-03-14",2001,3,73,161000,38200,21300,220500
"TR","2001-03-15",2001,3,74,0,38000,21300,59300
"TR","2001-03-16",2001,3,75,0,37600,21600,59200
"TR","2001-03-17",2001,3,76,0,37400,21800,59200
"TR","2001-03-18",2001,3,77,0,37000,22000,59000
"TR","2001-03-19",2001,3,78,0,36700,22200,58900
"TR","2001-03-20",2001,3,79,0,36300,22300,58600
"TR","2001-03-21",2001,3,80,0,36000,22400,58400
"TR","2001-03-22",2001,3,81,15600,35800,22400,73800
"TR","2001-03-23",2001,3,82,0,35600,22500,58100
"TR","2001-03-24",2001,3,83,2230,35400,22600,60230
"TR","2001-03-25",2001,3,84,41400,35500,22400,99300
"TR","2001-03-26",2001,3,85,10500,35400,22200,68100
"TR","2001-03-27",2001,3,86,0,35300,22300,57600
"TR","2001-03-28",2001,3,87,0,35100,22300,57400
"TR","2001-03-29",2001,3,88,0,34900,22400,57300
"TR","2001-03-30",2001,3,89,0,34700,22500,57200
"TR","2001-03-31",2001,3,90,0,34400,22600,57000
"TR","2001-04-01",2001,4,91,16600,34300,22600,73500
"TR","2001-04-02",2001,4,92,98700,35600,22100,156400
"TR","2001-04-03",2001,4,93,0,35500,22000,57500
"TR","2001-04-04",2001,4,94,54300,36900,21900,113100
"TR","2001-04-05",2001,4,95,0,37400,22300,59700
"TR","2001-04-06",2001,4,96,48600,41700,23400,113700
"TR","2001-04-07",2001,4,97,144000,67900,75900,287800
"TR","2001-04-08",2001,4,98,165000,66900,71500,303400
"TR","2001-04-09",2001,4,99,116000,67100,49700,232800
"TR","2001-04-10",2001,4,100,0,63000,34800,97800
"TR","2001-04-11",2001,4,101,30400,65000,41500,136900
"TR","2001-04-12",2001,4,102,198000,76600,46000,320600
"TR","2001-04-13",2001,4,103,264000,85700,44000,393700
"TR","2001-04-14",2001,4,104,113000,81300,31300,225600
"TR","2001-04-15",2001,4,105,34800,73200,23600,131600
"TR","2001-04-16",2001,4,106,60300,68700,23300,152300
"TR","2001-04-17",2001,4,107,96000,68900,27500,192400
"TR","2001-04-18",2001,4,108,9640,63600,23400,96640
"TR","2001-04-19",2001,4,109,0,59700,23500,83200
"TR","2001-04-20",2001,4,110,12200,57000,23800,93000
"TR","2001-04-21",2001,4,111,48700,56100,24200,129000
"TR","2001-04-22",2001,4,112,113000,59200,27600,199800
"TR","2001-04-23",2001,4,113,340000,81200,43900,465100
"TR","2001-04-24",2001,4,114,156000,78300,33900,268200
"TR","2001-04-25",2001,4,115,163000,81600,35400,280000
"TR","2001-04-26",2001,4,116,0,71700,23100,94800
"TR","2001-04-27",2001,4,117,0,66000,23600,89600
"TR","2001-04-28",2001,4,118,0,61500,23900,85400
"TR","2001-04-29",2001,4,119,0,58200,24200,82400
"TR","2001-04-30",2001,4,120,0,55500,24400,79900
"TR","2001-05-01",2001,5,121,13700,53600,24600,91900
"TR","2001-05-02",2001,5,122,210000,62600,27400,3e+05
"TR","2001-05-03",2001,5,123,104000,62400,30500,196900
"TR","2001-05-04",2001,5,124,35400,59300,25400,120100
"TR","2001-05-05",2001,5,125,141000,66700,30600,238300
"TR","2001-05-06",2001,5,126,4430,60700,25200,90330
"TR","2001-05-07",2001,5,127,69100,60100,25800,155000
"TR","2001-05-08",2001,5,128,84200,60700,27400,172300
"TR","2001-05-09",2001,5,129,84500,62000,29000,175500
"TR","2001-05-10",2001,5,130,162000,66200,31100,259300
"TR","2001-05-11",2001,5,131,345000,85200,50900,481100
"TR","2001-05-12",2001,5,132,0,70000,24300,94300
"TR","2001-05-13",2001,5,133,4430,64400,24600,93430
"TR","2001-05-14",2001,5,134,0,60200,25000,85200
"TR","2001-05-15",2001,5,135,4200,56700,25300,86200
"TR","2001-05-16",2001,5,136,26600,54400,25500,106500
"TR","2001-05-17",2001,5,137,39700,52800,26000,118500
"TR","2001-05-18",2001,5,138,0,49400,25800,75200
"TR","2001-05-19",2001,5,139,0,48300,26000,74300
"TR","2001-05-20",2001,5,140,0,47200,26200,73400
"TR","2001-05-21",2001,5,141,22200,46700,26200,95100
"TR","2001-05-22",2001,5,142,144000,48900,26300,219200
"TR","2001-05-23",2001,5,143,332000,60200,26900,419100
"TR","2001-05-24",2001,5,144,140000,60600,26500,227100
"TR","2001-05-25",2001,5,145,201000,67300,27200,295500
"TR","2001-05-26",2001,5,146,162000,71400,31200,264600
"TR","2001-05-27",2001,5,147,169000,75000,33900,277900
"TR","2001-05-28",2001,5,148,98800,73600,30400,202800
"TR","2001-05-29",2001,5,149,1400,66700,25600,93700
"TR","2001-05-30",2001,5,150,0,62200,26000,88200
"TR","2001-05-31",2001,5,151,0,58300,26300,84600
"TR","2001-06-01",2001,6,152,31000,55500,26300,112800
"TR","2001-06-02",2001,6,153,102000,57100,26900,186000
"TR","2001-06-03",2001,6,154,15200,54900,26500,96600
"TR","2001-06-04",2001,6,155,0,52600,26700,79300
"TR","2001-06-05",2001,6,156,0,50900,26900,77800
"TR","2001-06-06",2001,6,157,0,49800,27100,76900
"TR","2001-06-07",2001,6,158,0,49000,27200,76200
"TR","2001-06-08",2001,6,159,0,48300,27200,75500
"TR","2001-06-09",2001,6,160,12400,47800,27300,87500
"TR","2001-06-10",2001,6,161,152000,50200,27800,230000
"TR","2001-06-11",2001,6,162,106000,50800,27800,184600
"TR","2001-06-12",2001,6,163,330000,64100,29600,423700
"TR","2001-06-13",2001,6,164,139000,64100,27800,230900
"TR","2001-06-14",2001,6,165,33300,59200,27000,119500
"TR","2001-06-15",2001,6,166,8610,55300,27200,91110
"TR","2001-06-16",2001,6,167,4190,52300,27200,83690
"TR","2001-06-17",2001,6,168,39900,51300,27400,118600
"TR","2001-06-18",2001,6,169,61200,51400,27500,140100
"TR","2001-06-19",2001,6,170,914000,106000,79400,1099400
"TR","2001-06-20",2001,6,171,194000,93000,35100,322100
"TR","2001-06-21",2001,6,172,99400,88500,30600,218500
"TR","2001-06-22",2001,6,173,33300,83100,26000,142400
"TR","2001-06-23",2001,6,174,0,75300,26200,101500
"TR","2001-06-24",2001,6,175,0,69600,26700,96300
"TR","2001-06-25",2001,6,176,0,64500,27000,91500
"TR","2001-06-26",2001,6,177,0,59800,27400,87200
"TR","2001-06-27",2001,6,178,0,55900,27500,83400
"TR","2001-06-28",2001,6,179,208000,60800,28100,296900
"TR","2001-06-29",2001,6,180,6980,56400,27400,90780
"TR","2001-06-30",2001,6,181,87100,56500,27900,171500
"TR","2001-07-01",2001,7,182,9770,53000,27900,90670
"TR","2001-07-02",2001,7,183,0,50000,27900,77900
"TR","2001-07-03",2001,7,184,46200,49700,27700,123600
"TR","2001-07-04",2001,7,185,69300,50100,27700,147100
"TR","2001-07-05",2001,7,186,20500,49200,27500,97200
"TR","2001-07-06",2001,7,187,0,47900,27600,75500
"TR","2001-07-07",2001,7,188,0,47000,27700,74700
"TR","2001-07-08",2001,7,189,0,46200,27700,73900
"TR","2001-07-09",2001,7,190,0,45300,27800,73100
"TR","2001-07-10",2001,7,191,0,44100,28000,72100
"TR","2001-07-11",2001,7,192,0,42900,28100,71000
"TR","2001-07-12",2001,7,193,0,42200,28000,70200
"TR","2001-07-13",2001,7,194,0,41500,28000,69500
"TR","2001-07-14",2001,7,195,0,40500,28200,68700
"TR","2001-07-15",2001,7,196,0,39700,28200,67900
"TR","2001-07-16",2001,7,197,0,38900,28300,67200
"TR","2001-07-17",2001,7,198,53200,39400,28200,120800
"TR","2001-07-18",2001,7,199,19500,38900,28000,86400
"TR","2001-07-19",2001,7,200,134000,40800,27900,202700
"TR","2001-07-20",2001,7,201,114000,41900,27300,183200
"TR","2001-07-21",2001,7,202,173000,44200,27200,244400
"TR","2001-07-22",2001,7,203,6200,42500,26700,75400
"TR","2001-07-23",2001,7,204,0,41200,27000,68200
"TR","2001-07-24",2001,7,205,18100,40500,27200,85800
"TR","2001-07-25",2001,7,206,0,39700,27300,67000
"TR","2001-07-26",2001,7,207,0,39100,27400,66500
"TR","2001-07-27",2001,7,208,0,38600,27400,66000
"TR","2001-07-28",2001,7,209,177000,41600,27300,245900
"TR","2001-07-29",2001,7,210,142000,43200,26900,212100
"TR","2001-07-30",2001,7,211,20900,42100,26500,89500
"TR","2001-07-31",2001,7,212,40600,41900,26700,109200
"TR","2001-08-01",2001,8,213,257000,46800,26900,330700
"TR","2001-08-02",2001,8,214,0,43100,26200,69300
"TR","2001-08-03",2001,8,215,398000,51000,27700,476700
"TR","2001-08-04",2001,8,216,0,46700,26000,72700
"TR","2001-08-05",2001,8,217,0,45600,26700,72300
"TR","2001-08-06",2001,8,218,0,44400,27300,71700
"TR","2001-08-07",2001,8,219,0,43300,27700,71000
"TR","2001-08-08",2001,8,220,22700,42600,27900,93200
"TR","2001-08-09",2001,8,221,0,41700,28000,69700
"TR","2001-08-10",2001,8,222,0,40900,28100,69000
"TR","2001-08-11",2001,8,223,0,40300,28100,68400
"TR","2001-08-12",2001,8,224,0,39800,28100,67900
"TR","2001-08-13",2001,8,225,63200,40400,28100,131700
"TR","2001-08-14",2001,8,226,207000,43600,28700,279300
"TR","2001-08-15",2001,8,227,4220,42000,27700,73920
"TR","2001-08-16",2001,8,228,14800,41400,27900,84100
"TR","2001-08-17",2001,8,229,80900,42300,28100,151300
"TR","2001-08-18",2001,8,230,29200,41900,27900,99000
"TR","2001-08-19",2001,8,231,0,41000,27900,68900
"TR","2001-08-20",2001,8,232,107000,41900,28500,177400
"TR","2001-08-21",2001,8,233,0,40400,28200,68600
"TR","2001-08-22",2001,8,234,0,39600,28300,67900
"TR","2001-08-23",2001,8,235,0,38800,28300,67100
"TR","2001-08-24",2001,8,236,0,38100,28200,66300
"TR","2001-08-25",2001,8,237,0,37600,28200,65800
"TR","2001-08-26",2001,8,238,0,37200,28200,65400
"TR","2001-08-27",2001,8,239,17400,36900,28100,82400
"TR","2001-08-28",2001,8,240,68200,37400,28400,134000
"TR","2001-08-29",2001,8,241,0,36200,28200,64400
"TR","2001-08-30",2001,8,242,42200,36300,28100,106600
"TR","2001-08-31",2001,8,243,36400,36400,28100,100900
"TR","2001-09-01",2001,9,244,0,35600,28000,63600
"TR","2001-09-02",2001,9,245,0,35200,28000,63200
"TR","2001-09-03",2001,9,246,0,34900,28100,63000
"TR","2001-09-04",2001,9,247,0,34500,28100,62600
"TR","2001-09-05",2001,9,248,0,34200,28200,62400
"TR","2001-09-06",2001,9,249,0,33900,28200,62100
"TR","2001-09-07",2001,9,250,79200,34900,28100,142200
"TR","2001-09-08",2001,9,251,456000,45100,29000,530100
"TR","2001-09-09",2001,9,252,216000,45300,27700,289000
"TR","2001-09-10",2001,9,253,53500,43800,26700,124000
"TR","2001-09-11",2001,9,254,71000,44700,26900,142600
"TR","2001-09-12",2001,9,255,0,43600,26800,70400
"TR","2001-09-13",2001,9,256,2850,43000,27100,72950
"TR","2001-09-14",2001,9,257,0,42400,27200,69600
"TR","2001-09-15",2001,9,258,0,41900,27200,69100
"TR","2001-09-16",2001,9,259,0,41400,27200,68600
"TR","2001-09-17",2001,9,260,13200,41000,27200,81400
"TR","2001-09-18",2001,9,261,2850,40400,27200,70450
"TR","2001-09-19",2001,9,262,0,39900,27100,67000
"TR","2001-09-20",2001,9,263,4270,39500,27200,70970
"TR","2001-09-21",2001,9,264,2850,39100,27100,69050
"TR","2001-09-22",2001,9,265,0,38700,27100,65800
"TR","2001-09-23",2001,9,266,85800,39900,27100,152800
"TR","2001-09-24",2001,9,267,203000,43800,27600,274400
"TR","2001-09-25",2001,9,268,29300,42900,26900,99100
"TR","2001-09-26",2001,9,269,0,42100,26700,68800
"TR","2001-09-27",2001,9,270,0,41500,26900,68400
"TR","2001-09-28",2001,9,271,0,40900,26900,67800
"TR","2001-09-29",2001,9,272,0,40400,26900,67300
"TR","2001-09-30",2001,9,273,0,40000,26800,66800
"TR","2001-10-01",2001,10,274,0,39500,26700,66200
"TR","2001-10-02",2001,10,275,0,39200,26800,66000
"TR","2001-10-03",2001,10,276,0,38800,26800,65600
"TR","2001-10-04",2001,10,277,171000,42000,27000,240000
"TR","2001-10-05",2001,10,278,8050,41400,26400,75850
"TR","2001-10-06",2001,10,279,0,40700,26400,67100
"TR","2001-10-07",2001,10,280,29800,40900,26400,97100
"TR","2001-10-08",2001,10,281,0,40400,26200,66600
"TR","2001-10-09",2001,10,282,0,40100,26300,66400
"TR","2001-10-10",2001,10,283,18800,40100,26300,85200
"TR","2001-10-11",2001,10,284,253000,46100,27500,326600
"TR","2001-10-12",2001,10,285,44600,44400,25800,114800
"TR","2001-10-13",2001,10,286,0,43600,25600,69200
"TR","2001-10-14",2001,10,287,0,42800,25700,68500
"TR","2001-10-15",2001,10,288,207000,47500,26700,281200
"TR","2001-10-16",2001,10,289,28200,45900,25300,99400
"TR","2001-10-17",2001,10,290,7610,45100,25200,77910
"TR","2001-10-18",2001,10,291,9130,44700,25200,79030
"TR","2001-10-19",2001,10,292,0,44200,25300,69500
"TR","2001-10-20",2001,10,293,13900,44000,25400,83300
"TR","2001-10-21",2001,10,294,3470,43600,25400,72470
"TR","2001-10-22",2001,10,295,6440,43400,25400,75240
"TR","2001-10-23",2001,10,296,0,43100,25300,68400
"TR","2001-10-24",2001,10,297,46600,43700,25500,115800
"TR","2001-10-25",2001,10,298,39500,44000,25300,108800
"TR","2001-10-26",2001,10,299,54400,44600,25300,124300
"TR","2001-10-27",2001,10,300,325000,47100,24300,396400
"TR","2001-10-28",2001,10,301,25300,46500,23700,95500
"TR","2001-10-29",2001,10,302,0,46000,24000,70000
"TR","2001-10-30",2001,10,303,0,47300,26300,73600
"TR","2001-10-31",2001,10,304,0,47100,28500,75600
"TR","2001-11-01",2001,11,305,78400,51500,34500,164400
"TR","2001-11-02",2001,11,306,0,48300,29900,78200
"TR","2001-11-03",2001,11,307,0,46600,24500,71100
"TR","2001-11-04",2001,11,308,0,45800,24400,70200
"TR","2001-11-05",2001,11,309,0,45400,24400,69800
"TR","2001-11-06",2001,11,310,0,45000,24300,69300
"TR","2001-11-07",2001,11,311,0,44600,24200,68800
"TR","2001-11-08",2001,11,312,0,44200,24200,68400
"TR","2001-11-09",2001,11,313,51100,45100,24100,120300
"TR","2001-11-10",2001,11,314,2160,44600,24000,70760
"TR","2001-11-11",2001,11,315,0,43800,24000,67800
"TR","2001-11-12",2001,11,316,0,43200,24000,67200
"TR","2001-11-13",2001,11,317,0,42900,24000,66900
"TR","2001-11-14",2001,11,318,34200,43400,24300,101900
"TR","2001-11-15",2001,11,319,0,42600,24100,66700
"TR","2001-11-16",2001,11,320,3530,42300,24300,70130
"TR","2001-11-17",2001,11,321,0,42100,24500,66600
"TR","2001-11-18",2001,11,322,0,41800,24600,66400
"TR","2001-11-19",2001,11,323,0,41600,24700,66300
"TR","2001-11-20",2001,11,324,91800,43500,25000,160300
"TR","2001-11-21",2001,11,325,0,42700,24600,67300
"TR","2001-11-22",2001,11,326,0,42100,24600,66700
"TR","2001-11-23",2001,11,327,0,41600,24600,66200
"TR","2001-11-24",2001,11,328,0,41100,24500,65600
"TR","2001-11-25",2001,11,329,111000,43400,24700,179100
"TR","2001-11-26",2001,11,330,163000,47300,31500,241800
"TR","2001-11-27",2001,11,331,25400,45500,26100,97000
"TR","2001-11-28",2001,11,332,259000,47700,22600,329300
"TR","2001-11-29",2001,11,333,137000,49600,22100,208700
"TR","2001-11-30",2001,11,334,0,47800,22300,70100
"TR","2001-12-01",2001,12,335,0,46400,22600,69000
"TR","2001-12-02",2001,12,336,43600,46400,22600,112600
"TR","2001-12-03",2001,12,337,0,46100,22700,68800
"TR","2001-12-04",2001,12,338,0,45700,22900,68600
"TR","2001-12-05",2001,12,339,61700,46100,22800,130600
"TR","2001-12-06",2001,12,340,236000,54700,33100,323800
"TR","2001-12-07",2001,12,341,174000,57800,30900,262700
"TR","2001-12-08",2001,12,342,0,54400,22600,77000
"TR","2001-12-09",2001,12,343,0,51900,22100,74000
"TR","2001-12-10",2001,12,344,0,50000,22200,72200
"TR","2001-12-11",2001,12,345,0,48500,22400,70900
"TR","2001-12-12",2001,12,346,0,47300,22600,69900
"TR","2001-12-13",2001,12,347,0,46900,22700,69600
"TR","2001-12-14",2001,12,348,0,46500,22800,69300
"TR","2001-12-15",2001,12,349,0,46200,22900,69100
"TR","2001-12-16",2001,12,350,0,45800,23000,68800
"TR","2001-12-17",2001,12,351,4500,45500,23100,73100
"TR","2001-12-18",2001,12,352,6480,45300,23100,74880
"TR","2001-12-19",2001,12,353,0,45000,23100,68100
"TR","2001-12-20",2001,12,354,0,44800,23200,68000
"TR","2001-12-21",2001,12,355,1210,44500,23200,68910
"TR","2001-12-22",2001,12,356,0,44300,23300,67600
"TR","2001-12-23",2001,12,357,22500,44200,23200,89900
"TR","2001-12-24",2001,12,358,30700,44100,23100,97900
"TR","2001-12-25",2001,12,359,55400,44400,22900,122700
"TR","2001-12-26",2001,12,360,11700,44300,22900,78900
"TR","2001-12-27",2001,12,361,6920,44100,22900,73920
"TR","2001-12-28",2001,12,362,2420,43900,23000,69320
"TR","2001-12-29",2001,12,363,4580,43700,23100,71380
"TR","2001-12-30",2001,12,364,0,43500,23100,66600
"TR","2001-12-31",2001,12,365,0,43300,23200,66500
"TR","2002-01-01",2002,1,1,0,43100,23200,66300
"TR","2002-01-02",2002,1,2,0,42900,23200,66100
"TR","2002-01-03",2002,1,3,0,42700,23300,66000
"TR","2002-01-04",2002,1,4,0,42600,23300,65900
"TR","2002-01-05",2002,1,5,0,42400,23300,65700
"TR","2002-01-06",2002,1,6,3750,42200,23300,69250
"TR","2002-01-07",2002,1,7,7500,42100,23300,72900
"TR","2002-01-08",2002,1,8,10100,42000,23300,75400
"TR","2002-01-09",2002,1,9,0,41800,23300,65100
"TR","2002-01-10",2002,1,10,0,41600,23300,64900
"TR","2002-01-11",2002,1,11,0,41400,23400,64800
"TR","2002-01-12",2002,1,12,15700,41400,23400,80500
"TR","2002-01-13",2002,1,13,14200,41300,23300,78800
"TR","2002-01-14",2002,1,14,7500,41200,23300,72000
"TR","2002-01-15",2002,1,15,28300,41200,23200,92700
"TR","2002-01-16",2002,1,16,24900,41300,23100,89300
"TR","2002-01-17",2002,1,17,5630,41200,23100,69930
"TR","2002-01-18",2002,1,18,6070,41100,23100,70270
"TR","2002-01-19",2002,1,19,0,41000,23100,64100
"TR","2002-01-20",2002,1,20,0,40800,23200,64000
"TR","2002-01-21",2002,1,21,16900,40800,23100,80800
"TR","2002-01-22",2002,1,22,0,40700,23100,63800
"TR","2002-01-23",2002,1,23,0,40500,23200,63700
"TR","2002-01-24",2002,1,24,0,40400,23200,63600
"TR","2002-01-25",2002,1,25,0,40200,23200,63400
"TR","2002-01-26",2002,1,26,0,40100,23300,63400
"TR","2002-01-27",2002,1,27,0,39900,23300,63200
"TR","2002-01-28",2002,1,28,0,39700,23300,63000
"TR","2002-01-29",2002,1,29,0,39600,23300,62900
"TR","2002-01-30",2002,1,30,3750,39500,23300,66550
"TR","2002-01-31",2002,1,31,2020,39400,23300,64720
"TR","2002-02-01",2002,2,32,56300,39600,23000,118900
"TR","2002-02-02",2002,2,33,86100,40200,22600,148900
"TR","2002-02-03",2002,2,34,3380,40200,22600,66180
"TR","2002-02-04",2002,2,35,6850,40100,22700,69650
"TR","2002-02-05",2002,2,36,0,40000,22700,62700
"TR","2002-02-06",2002,2,37,0,39800,22800,62600
"TR","2002-02-07",2002,2,38,0,39700,22900,62600
"TR","2002-02-08",2002,2,39,0,39600,22900,62500
"TR","2002-02-09",2002,2,40,0,39400,22900,62300
"TR","2002-02-10",2002,2,41,4510,39300,22900,66710
"TR","2002-02-11",2002,2,42,1220,39200,22900,63320
"TR","2002-02-12",2002,2,43,0,39100,22900,62000
"TR","2002-02-13",2002,2,44,2250,39000,22900,64150
"TR","2002-02-14",2002,2,45,0,38900,22900,61800
"TR","2002-02-15",2002,2,46,0,38800,22900,61700
"TR","2002-02-16",2002,2,47,3380,38700,22900,64980
"TR","2002-02-17",2002,2,48,12500,38700,22900,74100
"TR","2002-02-18",2002,2,49,29700,38900,22700,91300
"TR","2002-02-19",2002,2,50,15800,38800,22700,77300
"TR","2002-02-20",2002,2,51,72300,39200,22400,133900
"TR","2002-02-21",2002,2,52,137000,40200,21900,199100
"TR","2002-02-22",2002,2,53,45800,40400,21700,107900
"TR","2002-02-23",2002,2,54,0,40300,21800,62100
"TR","2002-02-24",2002,2,55,3380,40100,22000,65480
"TR","2002-02-25",2002,2,56,22700,40000,22000,84700
"TR","2002-02-26",2002,2,57,21000,40000,22000,83000
"TR","2002-02-27",2002,2,58,18800,39900,22000,80700
"TR","2002-02-28",2002,2,59,3650,39800,22100,65550
"TR","2002-03-01",2002,3,60,0,39600,22100,61700
"TR","2002-03-02",2002,3,61,0,39400,22200,61600
"TR","2002-03-03",2002,3,62,0,39300,22200,61500
"TR","2002-03-04",2002,3,63,4460,39100,22300,65860
"TR","2002-03-05",2002,3,64,20700,39100,22200,82000
"TR","2002-03-06",2002,3,65,0,39000,22200,61200
"TR","2002-03-07",2002,3,66,0,38800,22300,61100
"TR","2002-03-08",2002,3,67,124000,39300,21800,185100
"TR","2002-03-09",2002,3,68,379000,41700,20500,441200
"TR","2002-03-10",2002,3,69,228000,43200,19700,290900
"TR","2002-03-11",2002,3,70,85800,43700,19600,149100
"TR","2002-03-12",2002,3,71,8930,43400,19900,72230
"TR","2002-03-13",2002,3,72,10300,42900,20200,73400
"TR","2002-03-14",2002,3,73,0,42400,20600,63000
"TR","2002-03-15",2002,3,74,120000,42600,20400,183000
"TR","2002-03-16",2002,3,75,375000,46700,19300,441000
"TR","2002-03-17",2002,3,76,0,44800,19300,64100
"TR","2002-03-18",2002,3,77,10300,44200,19700,74200
"TR","2002-03-19",2002,3,78,0,43700,20100,63800
"TR","2002-03-20",2002,3,79,8280,43100,20400,71780
"TR","2002-03-21",2002,3,80,57500,42900,20500,120900
"TR","2002-03-22",2002,3,81,72300,43100,20300,135700
"TR","2002-03-23",2002,3,82,0,42700,20500,63200
"TR","2002-03-24",2002,3,83,0,42300,20700,63000
"TR","2002-03-25",2002,3,84,0,41900,20900,62800
"TR","2002-03-26",2002,3,85,0,41600,21000,62600
"TR","2002-03-27",2002,3,86,0,41200,21200,62400
"TR","2002-03-28",2002,3,87,0,40700,21400,62100
"TR","2002-03-29",2002,3,88,22800,40400,21500,84700
"TR","2002-03-30",2002,3,89,44600,40300,21400,106300
"TR","2002-03-31",2002,3,90,32800,40100,21400,94300
"TR","2002-04-01",2002,4,91,0,39800,21500,61300
"TR","2002-04-02",2002,4,92,0,39500,21600,61100
"TR","2002-04-03",2002,4,93,31800,39400,21600,92800
"TR","2002-04-04",2002,4,94,136000,40300,21000,197300
"TR","2002-04-05",2002,4,95,4820,40100,21000,65920
"TR","2002-04-06",2002,4,96,0,39800,21200,61000
"TR","2002-04-07",2002,4,97,0,39500,21400,60900
"TR","2002-04-08",2002,4,98,45400,39500,21300,106200
"TR","2002-04-09",2002,4,99,37000,39500,21300,97800
"TR","2002-04-10",2002,4,100,82700,41400,21100,145200
"TR","2002-04-11",2002,4,101,252000,61800,20600,334400
"TR","2002-04-12",2002,4,102,483000,228000,599000,1310000
"TR","2002-04-13",2002,4,103,337000,114000,34500,485500
"TR","2002-04-14",2002,4,104,0,105000,27600,132600
"TR","2002-04-15",2002,4,105,26700,127000,101000,254700
"TR","2002-04-16",2002,4,106,57400,304000,483000,844400
"TR","2002-04-17",2002,4,107,0,135000,68200,203200
"TR","2002-04-18",2002,4,108,41400,439000,239000,719400
"TR","2002-04-19",2002,4,109,226000,145000,130000,501000
"TR","2002-04-20",2002,4,110,161000,135000,49500,345500
"TR","2002-04-21",2002,4,111,0,124000,21100,145100
"TR","2002-04-22",2002,4,112,55900,119000,22100,197000
"TR","2002-04-23",2002,4,113,97100,116000,29900,243000
"TR","2002-04-24",2002,4,114,7600,110000,23900,141500
"TR","2002-04-25",2002,4,115,90900,109000,28100,228000
"TR","2002-04-26",2002,4,116,59800,106000,28700,194500
"TR","2002-04-27",2002,4,117,2410,101000,26000,129410
"TR","2002-04-28",2002,4,118,22300,97800,26700,146800
"TR","2002-04-29",2002,4,119,148000,99200,33300,280500
"TR","2002-04-30",2002,4,120,53600,96600,32400,182600
"TR","2002-05-01",2002,5,121,49300,94200,30700,174200
"TR","2002-05-02",2002,5,122,0,90500,27900,118400
"TR","2002-05-03",2002,5,123,0,87000,28400,115400
"TR","2002-05-04",2002,5,124,9170,83600,28500,121270
"TR","2002-05-05",2002,5,125,44300,81500,29100,154900
"TR","2002-05-06",2002,5,126,169000,83500,30800,283300
"TR","2002-05-07",2002,5,127,201000,87300,42400,330700
"TR","2002-05-08",2002,5,128,262000,94300,43000,399300
"TR","2002-05-09",2002,5,129,584000,121000,52200,757200
"TR","2002-05-10",2002,5,130,250000,109000,44900,403900
"TR","2002-05-11",2002,5,131,0,98100,41200,139300
"TR","2002-05-12",2002,5,132,33300,93300,38500,165100
"TR","2002-05-13",2002,5,133,117000,94100,38100,249200
"TR","2002-05-14",2002,5,134,20800,88700,30900,140400
"TR","2002-05-15",2002,5,135,0,84800,31000,115800
"TR","2002-05-16",2002,5,136,2220,79600,31600,113420
"TR","2002-05-17",2002,5,137,10400,74700,31700,116800
"TR","2002-05-18",2002,5,138,0,70500,31700,102200
"TR","2002-05-19",2002,5,139,0,67300,32000,99300
"TR","2002-05-20",2002,5,140,0,64600,32200,96800
"TR","2002-05-21",2002,5,141,0,62400,32300,94700
"TR","2002-05-22",2002,5,142,0,60200,32600,92800
"TR","2002-05-23",2002,5,143,0,57500,32600,90100
"TR","2002-05-24",2002,5,144,0,55100,32500,87600
"TR","2002-05-25",2002,5,145,0,53200,32400,85600
"TR","2002-05-26",2002,5,146,0,52500,32100,84600
"TR","2002-05-27",2002,5,147,0,52300,32200,84500
"TR","2002-05-28",2002,5,148,33300,52300,32400,118000
"TR","2002-05-29",2002,5,149,0,51700,32400,84100
"TR","2002-05-30",2002,5,150,37700,51700,32400,121800
"TR","2002-05-31",2002,5,151,140000,54700,33200,227900
"TR","2002-06-01",2002,6,152,7000,52100,32600,91700
"TR","2002-06-02",2002,6,153,0,50600,32700,83300
"TR","2002-06-03",2002,6,154,0,49900,32700,82600
"TR","2002-06-04",2002,6,155,13800,49600,32600,96000
"TR","2002-06-05",2002,6,156,74300,50800,32700,157800
"TR","2002-06-06",2002,6,157,117000,52900,33000,202900
"TR","2002-06-07",2002,6,158,24300,52100,32700,109100
"TR","2002-06-08",2002,6,159,225000,59800,33600,318400
"TR","2002-06-09",2002,6,160,21700,55600,32600,109900
"TR","2002-06-10",2002,6,161,0,52900,32700,85600
"TR","2002-06-11",2002,6,162,252000,61400,33700,347100
"TR","2002-06-12",2002,6,163,240000,67700,34300,342000
"TR","2002-06-13",2002,6,164,0,61500,32100,93600
"TR","2002-06-14",2002,6,165,327000,73900,34100,435000
"TR","2002-06-15",2002,6,166,250000,80500,33900,364400
"TR","2002-06-16",2002,6,167,119000,78100,32100,229200
"TR","2002-06-17",2002,6,168,24500,72500,31300,128300
"TR","2002-06-18",2002,6,169,11900,67800,31600,111300
"TR","2002-06-19",2002,6,170,0,63500,31700,95200
"TR","2002-06-20",2002,6,171,61900,62300,32000,156200
"TR","2002-06-21",2002,6,172,98300,63200,32700,194200
"TR","2002-06-22",2002,6,173,33300,60600,32200,126100
"TR","2002-06-23",2002,6,174,43400,59100,32300,134800
"TR","2002-06-24",2002,6,175,72900,58900,32400,164200
"TR","2002-06-25",2002,6,176,60800,58000,32400,151200
"TR","2002-06-26",2002,6,177,59700,57100,32200,149000
"TR","2002-06-27",2002,6,178,191000,64100,33800,288900
"TR","2002-06-28",2002,6,179,0,59300,31900,91200
"TR","2002-06-29",2002,6,180,0,56000,32000,88000
"TR","2002-06-30",2002,6,181,0,53200,31900,85100
"TR","2002-07-01",2002,7,182,0,50900,31700,82600
"TR","2002-07-02",2002,7,183,0,49600,31500,81100
"TR","2002-07-03",2002,7,184,0,48400,31200,79600
"TR","2002-07-04",2002,7,185,885,47500,31100,79485
"TR","2002-07-05",2002,7,186,0,46400,31000,77400
"TR","2002-07-06",2002,7,187,0,45600,30800,76400
"TR","2002-07-07",2002,7,188,0,45000,30800,75800
"TR","2002-07-08",2002,7,189,84100,45800,30600,160500
"TR","2002-07-09",2002,7,190,133000,46900,30600,210500
"TR","2002-07-10",2002,7,191,258000,51400,30800,340200
"TR","2002-07-11",2002,7,192,0,48700,29700,78400
"TR","2002-07-12",2002,7,193,0,47600,29900,77500
"TR","2002-07-13",2002,7,194,0,46200,30100,76300
"TR","2002-07-14",2002,7,195,0,44900,30100,75000
"TR","2002-07-15",2002,7,196,0,44000,30000,74000
"TR","2002-07-16",2002,7,197,0,43300,30000,73300
"TR","2002-07-17",2002,7,198,0,42700,30000,72700
"TR","2002-07-18",2002,7,199,78500,43400,29900,151800
"TR","2002-07-19",2002,7,200,131000,44700,30000,205700
"TR","2002-07-20",2002,7,201,0,42800,29300,72100
"TR","2002-07-21",2002,7,202,217000,46400,29500,292900
"TR","2002-07-22",2002,7,203,445000,56200,30100,531300
"TR","2002-07-23",2002,7,204,180000,54300,29100,263400
"TR","2002-07-24",2002,7,205,0,49600,28100,77700
"TR","2002-07-25",2002,7,206,16800,48200,28400,93400
"TR","2002-07-26",2002,7,207,27000,47700,28500,103200
"TR","2002-07-27",2002,7,208,79500,48200,28900,156600
"TR","2002-07-28",2002,7,209,25200,47300,28700,101200
"TR","2002-07-29",2002,7,210,119000,48600,29100,196700
"TR","2002-07-30",2002,7,211,57000,47900,28800,133700
"TR","2002-07-31",2002,7,212,21000,46800,28600,96400
"TR","2002-08-01",2002,8,213,58900,46800,28700,134400
"TR","2002-08-02",2002,8,214,292000,52600,29800,374400
"TR","2002-08-03",2002,8,215,107000,51100,29300,187400
"TR","2002-08-04",2002,8,216,92800,51200,29100,173100
"TR","2002-08-05",2002,8,217,228000,59600,30600,318200
"TR","2002-08-06",2002,8,218,0,53700,28400,82100
"TR","2002-08-07",2002,8,219,0,50200,28900,79100
"TR","2002-08-08",2002,8,220,0,48500,29000,77500
"TR","2002-08-09",2002,8,221,0,47500,29100,76600
"TR","2002-08-10",2002,8,222,0,46500,29200,75700
"TR","2002-08-11",2002,8,223,0,45600,29200,74800
"TR","2002-08-12",2002,8,224,6320,44800,29200,80320
"TR","2002-08-13",2002,8,225,92600,45500,29600,167700
"TR","2002-08-14",2002,8,226,108000,46500,29700,184200
"TR","2002-08-15",2002,8,227,62400,46500,29600,138500
"TR","2002-08-16",2002,8,228,59000,46700,29500,135200
"TR","2002-08-17",2002,8,229,244000,52000,30400,326400
"TR","2002-08-18",2002,8,230,264000,58100,33200,355300
"TR","2002-08-19",2002,8,231,0,52000,28200,80200
"TR","2002-08-20",2002,8,232,0,49300,28600,77900
"TR","2002-08-21",2002,8,233,259000,59200,31200,349400
"TR","2002-08-22",2002,8,234,469000,86700,63400,619100
"TR","2002-08-23",2002,8,235,163000,81300,40500,284800
"TR","2002-08-24",2002,8,236,0,71100,27200,98300
"TR","2002-08-25",2002,8,237,0,64500,27400,91900
"TR","2002-08-26",2002,8,238,0,59000,27700,86700
"TR","2002-08-27",2002,8,239,0,54700,27900,82600
"TR","2002-08-28",2002,8,240,0,50900,28100,79000
"TR","2002-08-29",2002,8,241,0,49100,28100,77200
"TR","2002-08-30",2002,8,242,0,48100,28200,76300
"TR","2002-08-31",2002,8,243,0,47300,28300,75600
"TR","2002-09-01",2002,9,244,0,46500,28400,74900
"TR","2002-09-02",2002,9,245,88400,47500,28600,164500
"TR","2002-09-03",2002,9,246,248000,52100,29700,329800
"TR","2002-09-04",2002,9,247,21800,49700,28800,100300
"TR","2002-09-05",2002,9,248,9240,48500,28900,86640
"TR","2002-09-06",2002,9,249,223000,54000,30100,307100
"TR","2002-09-07",2002,9,250,308000,68400,38400,414800
"TR","2002-09-08",2002,9,251,21300,59500,28000,108800
"TR","2002-09-09",2002,9,252,0,54600,28300,82900
"TR","2002-09-10",2002,9,253,55400,53200,28800,137400
"TR","2002-09-11",2002,9,254,30000,51100,28800,109900
"TR","2002-09-12",2002,9,255,9970,49500,28800,88270
"TR","2002-09-13",2002,9,256,0,48500,28800,77300
"TR","2002-09-14",2002,9,257,13200,47900,28900,90000
"TR","2002-09-15",2002,9,258,0,47000,28800,75800
"TR","2002-09-16",2002,9,259,84000,48200,29200,161400
"TR","2002-09-17",2002,9,260,0,47200,28800,76000
"TR","2002-09-18",2002,9,261,0,46500,29000,75500
"TR","2002-09-19",2002,9,262,160000,49700,29400,239100
"TR","2002-09-20",2002,9,263,115000,50300,29300,194600
"TR","2002-09-21",2002,9,264,128000,51700,29500,209200
"TR","2002-09-22",2002,9,265,101000,52200,29400,182600
"TR","2002-09-23",2002,9,266,2640,50000,28500,81140
"TR","2002-09-24",2002,9,267,46700,50300,28800,125800
"TR","2002-09-25",2002,9,268,14200,49500,28700,92400
"TR","2002-09-26",2002,9,269,125000,53600,29100,207700
"TR","2002-09-27",2002,9,270,188000,65700,40600,294300
"TR","2002-09-28",2002,9,271,85500,65900,36200,187600
"TR","2002-09-29",2002,9,272,5280,61000,28500,94780
"TR","2002-09-30",2002,9,273,23100,58000,28000,109100
"TR","2002-10-01",2002,10,274,77000,60100,31200,168300
"TR","2002-10-02",2002,10,275,177000,71300,44300,292600
"TR","2002-10-03",2002,10,276,7120,64400,29400,100920
"TR","2002-10-04",2002,10,277,145000,68800,31900,245700
"TR","2002-10-05",2002,10,278,356000,92300,55600,503900
"TR","2002-10-06",2002,10,279,340000,101000,55300,496300
"TR","2002-10-07",2002,10,280,455000,109000,65600,629600
"TR","2002-10-08",2002,10,281,127000,104000,39300,270300
"TR","2002-10-09",2002,10,282,59000,102000,33600,194600
"TR","2002-10-10",2002,10,283,25100,96100,31000,152200
"TR","2002-10-11",2002,10,284,0,89700,28600,118300
"TR","2002-10-12",2002,10,285,3220,85500,29500,118220
"TR","2002-10-13",2002,10,286,42300,82400,30400,155100
"TR","2002-10-14",2002,10,287,104000,83700,32900,220600
"TR","2002-10-15",2002,10,288,0,78100,31600,109700
"TR","2002-10-16",2002,10,289,0,73800,31900,105700
"TR","2002-10-17",2002,10,290,0,70500,32100,102600
"TR","2002-10-18",2002,10,291,0,67900,32300,100200
"TR","2002-10-19",2002,10,292,74100,68500,32700,175300
"TR","2002-10-20",2002,10,293,165000,71800,32500,269300
"TR","2002-10-21",2002,10,294,31700,72700,36400,140800
"TR","2002-10-22",2002,10,295,69700,71200,33300,174200
"TR","2002-10-23",2002,10,296,190000,74200,32000,296200
"TR","2002-10-24",2002,10,297,16000,71400,32100,119500
"TR","2002-10-25",2002,10,298,0,68900,32600,101500
"TR","2002-10-26",2002,10,299,16100,67600,33200,116900
"TR","2002-10-27",2002,10,300,66900,69000,35500,171400
"TR","2002-10-28",2002,10,301,13700,67700,33600,115000
"TR","2002-10-29",2002,10,302,0,67000,34500,101500
"TR","2002-10-30",2002,10,303,0,66800,36600,103400
"TR","2002-10-31",2002,10,304,0,66000,36600,102600
"TR","2002-11-01",2002,11,305,4570,64800,34300,103670
"TR","2002-11-02",2002,11,306,0,63100,34100,97200
"TR","2002-11-03",2002,11,307,0,62200,34200,96400
"TR","2002-11-04",2002,11,308,0,61600,34300,95900
"TR","2002-11-05",2002,11,309,0,61500,34400,95900
"TR","2002-11-06",2002,11,310,0,60700,34400,95100
"TR","2002-11-07",2002,11,311,13000,60000,34300,107300
"TR","2002-11-08",2002,11,312,2160,60400,36300,98860
"TR","2002-11-09",2002,11,313,0,61200,40800,102000
"TR","2002-11-10",2002,11,314,30200,61400,39700,131300
"TR","2002-11-11",2002,11,315,79100,65400,39000,183500
"TR","2002-11-12",2002,11,316,0,63100,34500,97600
"TR","2002-11-13",2002,11,317,0,61500,33700,95200
"TR","2002-11-14",2002,11,318,6010,60400,33500,99910
"TR","2002-11-15",2002,11,319,6480,59600,33300,99380
"TR","2002-11-16",2002,11,320,4010,58900,33200,96110
"TR","2002-11-17",2002,11,321,4690,58600,33100,96390
"TR","2002-11-18",2002,11,322,0,58100,33000,91100
"TR","2002-11-19",2002,11,323,0,57700,33000,90700
"TR","2002-11-20",2002,11,324,0,57100,32900,90000
"TR","2002-11-21",2002,11,325,10000,56900,32800,99700
"TR","2002-11-22",2002,11,326,10200,56300,32500,99000
"TR","2002-11-23",2002,11,327,28400,56500,32400,117300
"TR","2002-11-24",2002,11,328,0,56200,32400,88600
"TR","2002-11-25",2002,11,329,6010,56000,32400,94410
"TR","2002-11-26",2002,11,330,2160,55800,32400,90360
"TR","2002-11-27",2002,11,331,0,55600,32300,87900
"TR","2002-11-28",2002,11,332,0,55400,32300,87700
"TR","2002-11-29",2002,11,333,0,55200,32300,87500
"TR","2002-11-30",2002,11,334,30000,55500,32200,117700
"TR","2002-12-01",2002,12,335,33600,55900,32000,121500
"TR","2002-12-02",2002,12,336,22100,56400,31900,110400
"TR","2002-12-03",2002,12,337,6680,56200,31900,94780
"TR","2002-12-04",2002,12,338,0,55900,31900,87800
"TR","2002-12-05",2002,12,339,0,55600,31900,87500
"TR","2002-12-06",2002,12,340,0,55300,31900,87200
"TR","2002-12-07",2002,12,341,0,55100,31900,87000
"TR","2002-12-08",2002,12,342,1120,54900,31900,87920
"TR","2002-12-09",2002,12,343,0,54700,31900,86600
"TR","2002-12-10",2002,12,344,0,54500,31900,86400
"TR","2002-12-11",2002,12,345,0,54300,31800,86100
"TR","2002-12-12",2002,12,346,0,54100,31800,85900
"TR","2002-12-13",2002,12,347,0,54000,31800,85800
"TR","2002-12-14",2002,12,348,0,53800,31800,85600
"TR","2002-12-15",2002,12,349,0,53600,31700,85300
"TR","2002-12-16",2002,12,350,0,53500,31700,85200
"TR","2002-12-17",2002,12,351,1120,53400,31700,86220
"TR","2002-12-18",2002,12,352,21700,53700,31500,106900
"TR","2002-12-19",2002,12,353,133000,56700,30900,220600
"TR","2002-12-20",2002,12,354,32300,57800,31400,121500
"TR","2002-12-21",2002,12,355,2420,56700,30800,89920
"TR","2002-12-22",2002,12,356,0,55700,30900,86600
"TR","2002-12-23",2002,12,357,0,55100,31000,86100
"TR","2002-12-24",2002,12,358,0,54600,31000,85600
"TR","2002-12-25",2002,12,359,0,54200,31000,85200
"TR","2002-12-26",2002,12,360,0,53800,31000,84800
"TR","2002-12-27",2002,12,361,0,53500,31000,84500
"TR","2002-12-28",2002,12,362,0,53300,31000,84300
"TR","2002-12-29",2002,12,363,0,53000,31000,84000
"TR","2002-12-30",2002,12,364,0,52800,30900,83700
"TR","2002-12-31",2002,12,365,0,52600,30900,83500
"TR","2003-01-01",2003,1,1,0,52400,30900,83300
"TR","2003-01-02",2003,1,2,0,52300,30900,83200
"TR","2003-01-03",2003,1,3,0,52100,30800,82900
"TR","2003-01-04",2003,1,4,0,51900,30800,82700
"TR","2003-01-05",2003,1,5,18800,52100,30700,101600
"TR","2003-01-06",2003,1,6,31600,52700,30500,114800
"TR","2003-01-07",2003,1,7,10700,52600,30400,93700
"TR","2003-01-08",2003,1,8,0,52200,30500,82700
"TR","2003-01-09",2003,1,9,9380,53200,30900,93480
"TR","2003-01-10",2003,1,10,0,52300,30500,82800
"TR","2003-01-11",2003,1,11,2020,51800,30500,84320
"TR","2003-01-12",2003,1,12,0,51600,30400,82000
"TR","2003-01-13",2003,1,13,0,51400,30400,81800
"TR","2003-01-14",2003,1,14,0,51300,30300,81600
"TR","2003-01-15",2003,1,15,0,51200,30300,81500
"TR","2003-01-16",2003,1,16,0,51200,30300,81500
"TR","2003-01-17",2003,1,17,5630,51100,30200,86930
"TR","2003-01-18",2003,1,18,5630,51000,30100,86730
"TR","2003-01-19",2003,1,19,19300,51100,30000,100400
"TR","2003-01-20",2003,1,20,0,51000,30000,81000
"TR","2003-01-21",2003,1,21,0,50900,30000,80900
"TR","2003-01-22",2003,1,22,0,50800,29900,80700
"TR","2003-01-23",2003,1,23,0,50700,29900,80600
"TR","2003-01-24",2003,1,24,0,50600,29900,80500
"TR","2003-01-25",2003,1,25,0,50400,29900,80300
"TR","2003-01-26",2003,1,26,15200,50400,29800,95400
"TR","2003-01-27",2003,1,27,28100,50600,29600,108300
"TR","2003-01-28",2003,1,28,9380,50500,29500,89380
"TR","2003-01-29",2003,1,29,28500,50600,29400,108500
"TR","2003-01-30",2003,1,30,4740,50500,29400,84640
"TR","2003-01-31",2003,1,31,0,50400,29400,79800
"TR","2003-02-01",2003,2,32,0,50200,29400,79600
"TR","2003-02-02",2003,2,33,0,50000,29400,79400
"TR","2003-02-03",2003,2,34,37200,50100,29300,116600
"TR","2003-02-04",2003,2,35,109000,51700,28800,189500
"TR","2003-02-05",2003,2,36,44200,52200,28500,124900
"TR","2003-02-06",2003,2,37,0,51400,28600,80000
"TR","2003-02-07",2003,2,38,0,50700,28700,79400
"TR","2003-02-08",2003,2,39,13500,50400,28700,92600
"TR","2003-02-09",2003,2,40,4980,50200,28700,83880
"TR","2003-02-10",2003,2,41,2430,50000,28800,81230
"TR","2003-02-11",2003,2,42,2430,49900,28800,81130
"TR","2003-02-12",2003,2,43,22500,49800,28700,101000
"TR","2003-02-13",2003,2,44,0,49700,28700,78400
"TR","2003-02-14",2003,2,45,0,49500,28700,78200
"TR","2003-02-15",2003,2,46,0,49400,28700,78100
"TR","2003-02-16",2003,2,47,0,49200,28700,77900
"TR","2003-02-17",2003,2,48,0,49000,28700,77700
"TR","2003-02-18",2003,2,49,0,48900,28700,77600
"TR","2003-02-19",2003,2,50,0,48700,28700,77400
"TR","2003-02-20",2003,2,51,0,48600,28700,77300
"TR","2003-02-21",2003,2,52,71200,49100,28400,148700
"TR","2003-02-22",2003,2,53,0,48900,28300,77200
"TR","2003-02-23",2003,2,54,0,48800,28400,77200
"TR","2003-02-24",2003,2,55,0,48600,28400,77000
"TR","2003-02-25",2003,2,56,0,48500,28400,76900
"TR","2003-02-26",2003,2,57,0,48300,28400,76700
"TR","2003-02-27",2003,2,58,0,48200,28400,76600
"TR","2003-02-28",2003,2,59,0,48000,28400,76400
"TR","2003-03-01",2003,3,60,0,47900,28400,76300
"TR","2003-03-02",2003,3,61,10300,47700,28400,86400
"TR","2003-03-03",2003,3,62,0,47500,28400,75900
"TR","2003-03-04",2003,3,63,103000,47900,27900,178800
"TR","2003-03-05",2003,3,64,43200,48100,27600,118900
"TR","2003-03-06",2003,3,65,0,48000,27700,75700
"TR","2003-03-07",2003,3,66,14500,47900,27700,90100
"TR","2003-03-08",2003,3,67,14600,47800,27700,90100
"TR","2003-03-09",2003,3,68,96900,48400,27300,172600
"TR","2003-03-10",2003,3,69,20500,48400,27200,96100
"TR","2003-03-11",2003,3,70,6210,48200,27300,81710
"TR","2003-03-12",2003,3,71,10100,48100,27400,85600
"TR","2003-03-13",2003,3,72,3920,47900,27500,79320
"TR","2003-03-14",2003,3,73,0,47600,27600,75200
"TR","2003-03-15",2003,3,74,0,47300,27700,75000
"TR","2003-03-16",2003,3,75,0,46900,27900,74800
"TR","2003-03-17",2003,3,76,0,49000,28800,77800
"TR","2003-03-18",2003,3,77,0,52200,38200,90400
"TR","2003-03-19",2003,3,78,0,51700,36900,88600
"TR","2003-03-20",2003,3,79,0,52200,35800,88000
"TR","2003-03-21",2003,3,80,81600,55600,38900,176100
"TR","2003-03-22",2003,3,81,131000,59800,33600,224400
"TR","2003-03-23",2003,3,82,28700,57500,29400,115600
"TR","2003-03-24",2003,3,83,0,54300,27600,81900
"TR","2003-03-25",2003,3,84,0,51200,27800,79000
"TR","2003-03-26",2003,3,85,0,49600,27300,76900
"TR","2003-03-27",2003,3,86,0,49000,27100,76100
"TR","2003-03-28",2003,3,87,130000,50700,27100,207800
"TR","2003-03-29",2003,3,88,316000,57400,25700,399100
"TR","2003-03-30",2003,3,89,53300,56200,25500,135000
"TR","2003-03-31",2003,3,90,0,53800,25900,79700
"TR","2003-04-01",2003,4,91,0,51900,26300,78200
"TR","2003-04-02",2003,4,92,71900,54700,26800,153400
"TR","2003-04-03",2003,4,93,6700,57000,30700,94400
"TR","2003-04-04",2003,4,94,51400,54100,27300,132800
"TR","2003-04-05",2003,4,95,99700,55200,26900,181800
"TR","2003-04-06",2003,4,96,111000,56600,26600,194200
"TR","2003-04-07",2003,4,97,0,54700,26700,81400
"TR","2003-04-08",2003,4,98,0,53100,27000,80100
"TR","2003-04-09",2003,4,99,0,51700,27200,78900
"TR","2003-04-10",2003,4,100,0,50900,27400,78300
"TR","2003-04-11",2003,4,101,0,54600,35400,90000
"TR","2003-04-12",2003,4,102,0,55600,40600,96200
"TR","2003-04-13",2003,4,103,0,53800,31300,85100
"TR","2003-04-14",2003,4,104,0,51500,27700,79200
"TR","2003-04-15",2003,4,105,11800,50700,27700,90200
"TR","2003-04-16",2003,4,106,0,49700,27400,77100
"TR","2003-04-17",2003,4,107,333000,68100,43100,444200
"TR","2003-04-18",2003,4,108,357000,68400,25600,451000
"TR","2003-04-19",2003,4,109,299000,72200,24600,395800
"TR","2003-04-20",2003,4,110,147000,78100,25100,250200
"TR","2003-04-21",2003,4,111,224000,213000,324000,761000
"TR","2003-04-22",2003,4,112,132000,104000,39900,275900
"TR","2003-04-23",2003,4,113,14500,97600,35300,147400
"TR","2003-04-24",2003,4,114,0,93200,35900,129100
"TR","2003-04-25",2003,4,115,0,89000,39600,128600
"TR","2003-04-26",2003,4,116,0,83000,26800,109800
"TR","2003-04-27",2003,4,117,0,78200,27000,105200
"TR","2003-04-28",2003,4,118,1640,72800,27300,101740
"TR","2003-04-29",2003,4,119,0,68300,27500,95800
"TR","2003-04-30",2003,4,120,0,64800,27700,92500
"TR","2003-05-01",2003,5,121,0,61900,28000,89900
"TR","2003-05-02",2003,5,122,0,59100,28300,87400
"TR","2003-05-03",2003,5,123,0,56700,28300,85000
"TR","2003-05-04",2003,5,124,0,54900,28700,83600
"TR","2003-05-05",2003,5,125,0,53300,29100,82400
"TR","2003-05-06",2003,5,126,79800,55700,29700,165200
"TR","2003-05-07",2003,5,127,159000,62100,30900,252000
"TR","2003-05-08",2003,5,128,45600,59900,29900,135400
"TR","2003-05-09",2003,5,129,179000,66800,37800,283600
"TR","2003-05-10",2003,5,130,177000,71400,39900,288300
"TR","2003-05-11",2003,5,131,568000,108000,64300,740300
"TR","2003-05-12",2003,5,132,1020000,152000,109000,1281000
"TR","2003-05-13",2003,5,133,493000,139000,81300,713300
"TR","2003-05-14",2003,5,134,0,117000,32200,149200
"TR","2003-05-15",2003,5,135,0,110000,28300,138300
"TR","2003-05-16",2003,5,136,0,103000,29300,132300
"TR","2003-05-17",2003,5,137,0,98600,30100,128700
"TR","2003-05-18",2003,5,138,0,94800,30600,125400
"TR","2003-05-19",2003,5,139,0,90800,31200,122000
"TR","2003-05-20",2003,5,140,2e+05,93000,33200,326200
"TR","2003-05-21",2003,5,141,229000,96600,36000,361600
"TR","2003-05-22",2003,5,142,0,89800,34200,124000
"TR","2003-05-23",2003,5,143,0,86400,35000,121400
"TR","2003-05-24",2003,5,144,0,80200,34900,115100
"TR","2003-05-25",2003,5,145,0,74900,35000,109900
"TR","2003-05-26",2003,5,146,0,70000,34700,104700
"TR","2003-05-27",2003,5,147,0,65800,34600,100400
"TR","2003-05-28",2003,5,148,48800,64100,34700,147600
"TR","2003-05-29",2003,5,149,3790,61300,34300,99390
"TR","2003-05-30",2003,5,150,56400,62200,34700,153300
"TR","2003-05-31",2003,5,151,53400,61900,35200,150500
"TR","2003-06-01",2003,6,152,21600,60600,34900,117100
"TR","2003-06-02",2003,6,153,0,59100,35000,94100
"TR","2003-06-03",2003,6,154,0,57300,35600,92900
"TR","2003-06-04",2003,6,155,0,55300,35500,90800
"TR","2003-06-05",2003,6,156,0,54300,35500,89800
"TR","2003-06-06",2003,6,157,0,53700,35500,89200
"TR","2003-06-07",2003,6,158,128000,56700,35800,220500
"TR","2003-06-08",2003,6,159,221000,65100,37100,323200
"TR","2003-06-09",2003,6,160,4770,61400,35600,101770
"TR","2003-06-10",2003,6,161,248000,70700,37700,356400
"TR","2003-06-11",2003,6,162,223000,76400,37900,337300
"TR","2003-06-12",2003,6,163,167000,80000,37000,284000
"TR","2003-06-13",2003,6,164,0,73400,35100,108500
"TR","2003-06-14",2003,6,165,0,69100,35400,104500
"TR","2003-06-15",2003,6,166,0,65200,35600,100800
"TR","2003-06-16",2003,6,167,0,61700,35400,97100
"TR","2003-06-17",2003,6,168,0,58900,35300,94200
"TR","2003-06-18",2003,6,169,0,56800,35000,91800
"TR","2003-06-19",2003,6,170,0,55200,35000,90200
"TR","2003-06-20",2003,6,171,0,53700,35100,88800
"TR","2003-06-21",2003,6,172,0,52900,35000,87900
"TR","2003-06-22",2003,6,173,0,52100,35100,87200
"TR","2003-06-23",2003,6,174,57500,52600,35000,145100
"TR","2003-06-24",2003,6,175,22100,52100,34700,108900
"TR","2003-06-25",2003,6,176,314000,62200,35400,411600
"TR","2003-06-26",2003,6,177,96700,61800,34700,193200
"TR","2003-06-27",2003,6,178,4770,58600,34400,97770
"TR","2003-06-28",2003,6,179,16700,57100,34500,108300
"TR","2003-06-29",2003,6,180,50800,57400,34600,142800
"TR","2003-06-30",2003,6,181,27600,56500,34500,118600
"TR","2003-07-01",2003,7,182,0,54600,34400,89000
"TR","2003-07-02",2003,7,183,0,52600,34500,87100
"TR","2003-07-03",2003,7,184,77100,52800,34200,164100
"TR","2003-07-04",2003,7,185,67800,52500,34000,154300
"TR","2003-07-05",2003,7,186,0,51000,33500,84500
"TR","2003-07-06",2003,7,187,0,49900,33600,83500
"TR","2003-07-07",2003,7,188,0,48800,33300,82100
"TR","2003-07-08",2003,7,189,0,47800,33200,81000
"TR","2003-07-09",2003,7,190,0,47000,33100,80100
"TR","2003-07-10",2003,7,191,16800,46600,33000,96400
"TR","2003-07-11",2003,7,192,111000,48400,32800,192200
"TR","2003-07-12",2003,7,193,99800,49400,32500,181700
"TR","2003-07-13",2003,7,194,0,48300,32100,80400
"TR","2003-07-14",2003,7,195,0,47600,32300,79900
"TR","2003-07-15",2003,7,196,29400,47200,32300,108900
"TR","2003-07-16",2003,7,197,16800,46600,32200,95600
"TR","2003-07-17",2003,7,198,36400,46700,32100,115200
"TR","2003-07-18",2003,7,199,48600,46500,32300,127400
"TR","2003-07-19",2003,7,200,0,45000,32000,77000
"TR","2003-07-20",2003,7,201,36400,44700,32000,113100
"TR","2003-07-21",2003,7,202,130000,46200,32100,208300
"TR","2003-07-22",2003,7,203,120000,47000,31700,198700
"TR","2003-07-23",2003,7,204,8410,46000,31200,85610
"TR","2003-07-24",2003,7,205,6050,45400,31300,82750
"TR","2003-07-25",2003,7,206,0,44800,31400,76200
"TR","2003-07-26",2003,7,207,2800,44200,31400,78400
"TR","2003-07-27",2003,7,208,18500,43500,31500,93500
"TR","2003-07-28",2003,7,209,6050,42600,31500,80150
"TR","2003-07-29",2003,7,210,0,42100,31300,73400
"TR","2003-07-30",2003,7,211,149000,44700,31200,224900
"TR","2003-07-31",2003,7,212,49600,44200,30800,124600
"TR","2003-08-01",2003,8,213,157000,46100,31000,234100
"TR","2003-08-02",2003,8,214,24800,45100,30500,100400
"TR","2003-08-03",2003,8,215,37900,45000,30900,113800
"TR","2003-08-04",2003,8,216,124000,46500,31300,201800
"TR","2003-08-05",2003,8,217,12100,45400,31000,88500
"TR","2003-08-06",2003,8,218,0,44400,31300,75700
"TR","2003-08-07",2003,8,219,0,43700,31500,75200
"TR","2003-08-08",2003,8,220,29600,43400,31600,104600
"TR","2003-08-09",2003,8,221,4550,42800,31600,78950
"TR","2003-08-10",2003,8,222,0,42300,31600,73900
"TR","2003-08-11",2003,8,223,0,41400,32000,73400
"TR","2003-08-12",2003,8,224,0,40400,32100,72500
"TR","2003-08-13",2003,8,225,0,39600,32200,71800
"TR","2003-08-14",2003,8,226,0,38800,32400,71200
"TR","2003-08-15",2003,8,227,0,38000,32500,70500
"TR","2003-08-16",2003,8,228,0,37600,32300,69900
"TR","2003-08-17",2003,8,229,0,37200,32200,69400
"TR","2003-08-18",2003,8,230,0,36800,32300,69100
"TR","2003-08-19",2003,8,231,0,36500,32200,68700
"TR","2003-08-20",2003,8,232,8430,36300,32100,76830
"TR","2003-08-21",2003,8,233,12600,36100,32100,80800
"TR","2003-08-22",2003,8,234,177000,39400,32100,248500
"TR","2003-08-23",2003,8,235,0,38100,31500,69600
"TR","2003-08-24",2003,8,236,71700,38800,31500,142000
"TR","2003-08-25",2003,8,237,182000,42000,31600,255600
"TR","2003-08-26",2003,8,238,21100,40900,31100,93100
"TR","2003-08-27",2003,8,239,13600,39600,31500,84700
"TR","2003-08-28",2003,8,240,0,38200,31700,69900
"TR","2003-08-29",2003,8,241,48500,38300,31700,118500
"TR","2003-08-30",2003,8,242,51600,38700,31500,121800
"TR","2003-08-31",2003,8,243,0,38200,31200,69400
"TR","2003-09-01",2003,9,244,0,37800,31300,69100
"TR","2003-09-02",2003,9,245,0,37300,31400,68700
"TR","2003-09-03",2003,9,246,0,37000,31400,68400
"TR","2003-09-04",2003,9,247,0,36600,31400,68000
"TR","2003-09-05",2003,9,248,1670,36400,31300,69370
"TR","2003-09-06",2003,9,249,0,36300,31300,67600
"TR","2003-09-07",2003,9,250,0,36000,31300,67300
"TR","2003-09-08",2003,9,251,0,35700,31300,67000
"TR","2003-09-09",2003,9,252,0,35300,31400,66700
"TR","2003-09-10",2003,9,253,0,35000,31400,66400
"TR","2003-09-11",2003,9,254,0,34600,31400,66000
"TR","2003-09-12",2003,9,255,0,34300,31400,65700
"TR","2003-09-13",2003,9,256,51500,34900,31200,117600
"TR","2003-09-14",2003,9,257,195000,38700,31300,265000
"TR","2003-09-15",2003,9,258,94000,39700,30700,164400
"TR","2003-09-16",2003,9,259,14600,39300,30400,84300
"TR","2003-09-17",2003,9,260,0,38800,30400,69200
"TR","2003-09-18",2003,9,261,0,38400,30600,69000
"TR","2003-09-19",2003,9,262,52800,38900,30600,122300
"TR","2003-09-20",2003,9,263,57700,39400,30500,127600
"TR","2003-09-21",2003,9,264,0,38800,30200,69000
"TR","2003-09-22",2003,9,265,33000,39100,30200,102300
"TR","2003-09-23",2003,9,266,65400,40000,30300,135700
"TR","2003-09-24",2003,9,267,36300,40100,30000,106400
"TR","2003-09-25",2003,9,268,28800,40200,29900,98900
"TR","2003-09-26",2003,9,269,24000,40200,29800,94000
"TR","2003-09-27",2003,9,270,45000,40700,29900,115600
"TR","2003-09-28",2003,9,271,92700,42400,29800,164900
"TR","2003-09-29",2003,9,272,51900,43100,29400,124400
"TR","2003-09-30",2003,9,273,25600,43100,29500,98200
"TR","2003-10-01",2003,10,274,32100,43100,29600,104800
"TR","2003-10-02",2003,10,275,37200,43500,29600,110300
"TR","2003-10-03",2003,10,276,31700,43800,29600,105100
"TR","2003-10-04",2003,10,277,19800,43600,29500,92900
"TR","2003-10-05",2003,10,278,4570,43100,29400,77070
"TR","2003-10-06",2003,10,279,0,42800,29300,72100
"TR","2003-10-07",2003,10,280,0,42400,29400,71800
"TR","2003-10-08",2003,10,281,0,42100,29400,71500
"TR","2003-10-09",2003,10,282,0,42000,29400,71400
"TR","2003-10-10",2003,10,283,0,41800,29400,71200
"TR","2003-10-11",2003,10,284,0,41600,29300,70900
"TR","2003-10-12",2003,10,285,82100,43500,29000,154600
"TR","2003-10-13",2003,10,286,120000,45600,29300,194900
"TR","2003-10-14",2003,10,287,0,44300,28900,73200
"TR","2003-10-15",2003,10,288,0,43400,29000,72400
"TR","2003-10-16",2003,10,289,0,43000,28900,71900
"TR","2003-10-17",2003,10,290,0,42700,28800,71500
"TR","2003-10-18",2003,10,291,0,42600,28700,71300
"TR","2003-10-19",2003,10,292,0,42600,28600,71200
"TR","2003-10-20",2003,10,293,0,42400,28600,71000
"TR","2003-10-21",2003,10,294,0,42200,28600,70800
"TR","2003-10-22",2003,10,295,0,42100,28500,70600
"TR","2003-10-23",2003,10,296,19300,42400,28600,90300
"TR","2003-10-24",2003,10,297,40600,42900,28500,112000
"TR","2003-10-25",2003,10,298,36600,43400,28500,108500
"TR","2003-10-26",2003,10,299,12700,43100,28300,84100
"TR","2003-10-27",2003,10,300,16000,42800,28300,87100
"TR","2003-10-28",2003,10,301,131000,43300,27600,201900
"TR","2003-10-29",2003,10,302,185000,44700,26900,256600
"TR","2003-10-30",2003,10,303,24200,46500,27500,98200
"TR","2003-10-31",2003,10,304,65000,49200,27700,141900
"TR","2003-11-01",2003,11,305,73600,48900,27400,149900
"TR","2003-11-02",2003,11,306,9380,48900,27600,85880
"TR","2003-11-03",2003,11,307,0,47700,26900,74600
"TR","2003-11-04",2003,11,308,40100,48100,27100,115300
"TR","2003-11-05",2003,11,309,164000,50000,26300,240300
"TR","2003-11-06",2003,11,310,39300,49800,26000,115100
"TR","2003-11-07",2003,11,311,0,48400,26200,74600
"TR","2003-11-08",2003,11,312,0,47900,26300,74200
"TR","2003-11-09",2003,11,313,0,47600,26400,74000
"TR","2003-11-10",2003,11,314,0,47300,26500,73800
"TR","2003-11-11",2003,11,315,2160,47300,26600,76060
"TR","2003-11-12",2003,11,316,9010,48300,27400,84710
"TR","2003-11-13",2003,11,317,10000,47600,28800,86400
"TR","2003-11-14",2003,11,318,9380,46600,26700,82680
"TR","2003-11-15",2003,11,319,0,46200,26700,72900
"TR","2003-11-16",2003,11,320,12300,46000,26700,85000
"TR","2003-11-17",2003,11,321,53900,46600,26500,127000
"TR","2003-11-18",2003,11,322,147000,51600,32700,231300
"TR","2003-11-19",2003,11,323,329000,62400,36300,427700
"TR","2003-11-20",2003,11,324,6480,61700,36900,105080
"TR","2003-11-21",2003,11,325,0,57100,32000,89100
"TR","2003-11-22",2003,11,326,0,54200,25400,79600
"TR","2003-11-23",2003,11,327,28000,52400,25400,105800
"TR","2003-11-24",2003,11,328,98300,53400,25100,176800
"TR","2003-11-25",2003,11,329,95700,54200,24800,174700
"TR","2003-11-26",2003,11,330,9910,52600,24900,87410
"TR","2003-11-27",2003,11,331,12000,51000,25100,88100
"TR","2003-11-28",2003,11,332,12500,49700,25300,87500
"TR","2003-11-29",2003,11,333,4320,48700,25400,78420
"TR","2003-11-30",2003,11,334,3790,48300,25600,77690
"TR","2003-12-01",2003,12,335,0,48000,25700,73700
"TR","2003-12-02",2003,12,336,0,47700,25800,73500
"TR","2003-12-03",2003,12,337,0,47400,25800,73200
"TR","2003-12-04",2003,12,338,0,47100,25800,72900
"TR","2003-12-05",2003,12,339,0,46900,25900,72800
"TR","2003-12-06",2003,12,340,0,46600,25900,72500
"TR","2003-12-07",2003,12,341,0,46400,25900,72300
"TR","2003-12-08",2003,12,342,0,46200,25900,72100
"TR","2003-12-09",2003,12,343,38600,46200,25800,110600
"TR","2003-12-10",2003,12,344,91800,46600,25400,163800
"TR","2003-12-11",2003,12,345,79800,47000,25100,151900
"TR","2003-12-12",2003,12,346,44000,47100,25000,116100
"TR","2003-12-13",2003,12,347,1210,46900,25100,73210
"TR","2003-12-14",2003,12,348,0,46600,25200,71800
"TR","2003-12-15",2003,12,349,0,46400,25400,71800
"TR","2003-12-16",2003,12,350,11200,46200,25400,82800
"TR","2003-12-17",2003,12,351,52100,46400,25200,123700
"TR","2003-12-18",2003,12,352,9310,46200,25200,80710
"TR","2003-12-19",2003,12,353,3370,46000,25300,74670
"TR","2003-12-20",2003,12,354,0,45800,25400,71200
"TR","2003-12-21",2003,12,355,0,45600,25500,71100
"TR","2003-12-22",2003,12,356,0,45300,25500,70800
"TR","2003-12-23",2003,12,357,4500,45200,25600,75300
"TR","2003-12-24",2003,12,358,10700,45000,25500,81200
"TR","2003-12-25",2003,12,359,5470,44900,25500,75870
"TR","2003-12-26",2003,12,360,0,44700,25600,70300
"TR","2003-12-27",2003,12,361,0,44500,25600,70100
"TR","2003-12-28",2003,12,362,11600,44400,25600,81600
"TR","2003-12-29",2003,12,363,13400,44600,25600,83600
"TR","2003-12-30",2003,12,364,3370,44700,25800,73870
"TR","2003-12-31",2003,12,365,6060,44400,25600,76060
"TR","2004-01-01",2004,1,1,0,44100,25600,69700
"TR","2004-01-02",2004,1,2,3750,44000,25600,73350
"TR","2004-01-03",2004,1,3,19400,43900,25600,88900
"TR","2004-01-04",2004,1,4,20200,43900,25500,89600
"TR","2004-01-05",2004,1,5,9380,43800,25500,78680
"TR","2004-01-06",2004,1,6,4050,43700,25500,73250
"TR","2004-01-07",2004,1,7,0,43600,25500,69100
"TR","2004-01-08",2004,1,8,0,43400,25500,68900
"TR","2004-01-09",2004,1,9,0,43300,25500,68800
"TR","2004-01-10",2004,1,10,1880,43200,25500,70580
"TR","2004-01-11",2004,1,11,7500,43100,25500,76100
"TR","2004-01-12",2004,1,12,27800,43200,25400,96400
"TR","2004-01-13",2004,1,13,17800,43100,25300,86200
"TR","2004-01-14",2004,1,14,93900,43500,25000,162400
"TR","2004-01-15",2004,1,15,185000,44900,24300,254200
"TR","2004-01-16",2004,1,16,18900,44800,24200,87900
"TR","2004-01-17",2004,1,17,39500,44900,24300,108700
"TR","2004-01-18",2004,1,18,9970,44700,24400,79070
"TR","2004-01-19",2004,1,19,0,44500,24500,69000
"TR","2004-01-20",2004,1,20,0,44300,24700,69000
"TR","2004-01-21",2004,1,21,9380,44100,24700,78180
"TR","2004-01-22",2004,1,22,17800,44000,24700,86500
"TR","2004-01-23",2004,1,23,32300,44100,24600,101000
"TR","2004-01-24",2004,1,24,9380,43900,24700,77980
"TR","2004-01-25",2004,1,25,10100,43800,24700,78600
"TR","2004-01-26",2004,1,26,0,43600,24800,68400
"TR","2004-01-27",2004,1,27,11300,43500,24800,79600
"TR","2004-01-28",2004,1,28,32800,43500,24700,101000
"TR","2004-01-29",2004,1,29,4390,43400,24700,72490
"TR","2004-01-30",2004,1,30,0,43200,24800,68000
"TR","2004-01-31",2004,1,31,0,43000,24800,67800
"TR","2004-02-01",2004,2,32,5630,42900,24900,73430
"TR","2004-02-02",2004,2,33,19200,42800,24800,86800
"TR","2004-02-03",2004,2,34,55300,43000,24600,122900
"TR","2004-02-04",2004,2,35,71400,43400,24300,139100
"TR","2004-02-05",2004,2,36,0,43200,24300,67500
"TR","2004-02-06",2004,2,37,10100,43100,24400,77600
"TR","2004-02-07",2004,2,38,10900,43000,24500,78400
"TR","2004-02-08",2004,2,39,0,42800,24600,67400
"TR","2004-02-09",2004,2,40,2250,42600,24600,69450
"TR","2004-02-10",2004,2,41,30800,42700,24600,98100
"TR","2004-02-11",2004,2,42,5480,42500,24600,72580
"TR","2004-02-12",2004,2,43,10100,42400,24600,77100
"TR","2004-02-13",2004,2,44,17900,42400,24500,84800
"TR","2004-02-14",2004,2,45,0,42200,24600,66800
"TR","2004-02-15",2004,2,46,0,42000,24700,66700
"TR","2004-02-16",2004,2,47,0,41900,24700,66600
"TR","2004-02-17",2004,2,48,0,41700,24700,66400
"TR","2004-02-18",2004,2,49,0,41600,24700,66300
"TR","2004-02-19",2004,2,50,0,41400,24800,66200
"TR","2004-02-20",2004,2,51,46200,41500,24600,112300
"TR","2004-02-21",2004,2,52,95800,42100,24200,162100
"TR","2004-02-22",2004,2,53,41600,42300,24000,107900
"TR","2004-02-23",2004,2,54,40600,42300,23900,106800
"TR","2004-02-24",2004,2,55,83100,42800,23700,149600
"TR","2004-02-25",2004,2,56,0,42600,23800,66400
"TR","2004-02-26",2004,2,57,0,42400,24000,66400
"TR","2004-02-27",2004,2,58,0,42100,24100,66200
"TR","2004-02-28",2004,2,59,0,41900,24200,66100
"TR","2004-02-29",2004,2,60,0,41700,24300,66000
"TR","2004-03-01",2004,3,61,3380,41500,24400,69280
"TR","2004-03-02",2004,3,62,8940,41400,24400,74740
"TR","2004-03-03",2004,3,63,118000,42800,24000,184800
"TR","2004-03-04",2004,3,64,27400,43000,24000,94400
"TR","2004-03-05",2004,3,65,51600,43500,25000,120100
"TR","2004-03-06",2004,3,66,146000,44000,24600,214600
"TR","2004-03-07",2004,3,67,143000,44500,23000,210500
"TR","2004-03-08",2004,3,68,123000,45100,22600,190700
"TR","2004-03-09",2004,3,69,20100,44800,22800,87700
"TR","2004-03-10",2004,3,70,0,44500,23100,67600
"TR","2004-03-11",2004,3,71,45500,44200,23200,112900
"TR","2004-03-12",2004,3,72,87100,44600,23000,154700
"TR","2004-03-13",2004,3,73,35000,44500,23000,102500
"TR","2004-03-14",2004,3,74,66200,44500,22900,133600
"TR","2004-03-15",2004,3,75,233000,46000,22200,301200
"TR","2004-03-16",2004,3,76,13400,45700,22200,81300
"TR","2004-03-17",2004,3,77,8280,45300,22600,76180
"TR","2004-03-18",2004,3,78,11200,44900,22800,78900
"TR","2004-03-19",2004,3,79,4460,44400,23100,71960
"TR","2004-03-20",2004,3,80,0,43900,23300,67200
"TR","2004-03-21",2004,3,81,6210,43500,23500,73210
"TR","2004-03-22",2004,3,82,2230,43100,23600,68930
"TR","2004-03-23",2004,3,83,0,42700,23700,66400
"TR","2004-03-24",2004,3,84,0,42400,23800,66200
"TR","2004-03-25",2004,3,85,0,42000,24000,66000
"TR","2004-03-26",2004,3,86,17900,41600,24000,83500
"TR","2004-03-27",2004,3,87,168000,43000,23400,234400
"TR","2004-03-28",2004,3,88,11500,45800,23700,81000
"TR","2004-03-29",2004,3,89,73900,49000,38400,161300
"TR","2004-03-30",2004,3,90,99700,50600,38300,188600
"TR","2004-03-31",2004,3,91,0,48200,26900,75100
"TR","2004-04-01",2004,4,92,0,47100,24500,71600
"TR","2004-04-02",2004,4,93,0,47100,25100,72200
"TR","2004-04-03",2004,4,94,0,48500,29800,78300
"TR","2004-04-04",2004,4,95,0,48700,31000,79700
"TR","2004-04-05",2004,4,96,0,47700,27000,74700
"TR","2004-04-06",2004,4,97,0,48500,29300,77800
"TR","2004-04-07",2004,4,98,8190,55400,44800,108390
"TR","2004-04-08",2004,4,99,34900,71500,72300,178700
"TR","2004-04-09",2004,4,100,70500,68300,52700,191500
"TR","2004-04-10",2004,4,101,29200,65600,34500,129300
"TR","2004-04-11",2004,4,102,4470,63500,35000,102970
"TR","2004-04-12",2004,4,103,12100,59500,28400,1e+05
"TR","2004-04-13",2004,4,104,0,56100,27100,83200
"TR","2004-04-14",2004,4,105,0,54500,29100,83600
"TR","2004-04-15",2004,4,106,0,55500,36700,92200
"TR","2004-04-16",2004,4,107,0,56800,39700,96500
"TR","2004-04-17",2004,4,108,0,57900,44600,102500
"TR","2004-04-18",2004,4,109,90500,61800,46100,198400
"TR","2004-04-19",2004,4,110,389000,84300,49800,523100
"TR","2004-04-20",2004,4,111,366000,94000,57800,517800
"TR","2004-04-21",2004,4,112,28900,83100,26600,138600
"TR","2004-04-22",2004,4,113,111000,82600,33500,227100
"TR","2004-04-23",2004,4,114,47900,77800,29800,155500
"TR","2004-04-24",2004,4,115,0,71000,27600,98600
"TR","2004-04-25",2004,4,116,72900,69500,28600,171000
"TR","2004-04-26",2004,4,117,112000,72200,34900,219100
"TR","2004-04-27",2004,4,118,63900,70500,31600,166000
"TR","2004-04-28",2004,4,119,41800,67800,30200,139800
"TR","2004-04-29",2004,4,120,41000,66100,31000,138100
"TR","2004-04-30",2004,4,121,34900,63300,29300,127500
"TR","2004-05-01",2004,5,122,117000,67400,35800,220200
"TR","2004-05-02",2004,5,123,0,62500,29100,91600
"TR","2004-05-03",2004,5,124,0,59600,29400,89000
"TR","2004-05-04",2004,5,125,0,57400,29500,86900
"TR","2004-05-05",2004,5,126,0,55300,29600,84900
"TR","2004-05-06",2004,5,127,0,53600,29600,83200
"TR","2004-05-07",2004,5,128,0,52400,29400,81800
"TR","2004-05-08",2004,5,129,0,51200,29400,80600
"TR","2004-05-09",2004,5,130,14400,50700,29300,94400
"TR","2004-05-10",2004,5,131,22200,50300,29300,101800
"TR","2004-05-11",2004,5,132,124000,53800,30300,208100
"TR","2004-05-12",2004,5,133,0,50300,29500,79800
"TR","2004-05-13",2004,5,134,0,48600,29500,78100
"TR","2004-05-14",2004,5,135,402000,64600,34300,500900
"TR","2004-05-15",2004,5,136,139000,66200,37900,243100
"TR","2004-05-16",2004,5,137,60300,65000,32200,157500
"TR","2004-05-17",2004,5,138,17700,61100,29200,108000
"TR","2004-05-18",2004,5,139,0,57300,29200,86500
"TR","2004-05-19",2004,5,140,7180,54400,29300,90880
"TR","2004-05-20",2004,5,141,42100,52700,29200,124000
"TR","2004-05-21",2004,5,142,27400,51100,29100,107600
"TR","2004-05-22",2004,5,143,35500,50200,28800,114500
"TR","2004-05-23",2004,5,144,82000,51800,29000,162800
"TR","2004-05-24",2004,5,145,189000,58000,29800,276800
"TR","2004-05-25",2004,5,146,267000,72100,37900,377000
"TR","2004-05-26",2004,5,147,0,63200,28200,91400
"TR","2004-05-27",2004,5,148,0,59500,28500,88000
"TR","2004-05-28",2004,5,149,177000,65500,33500,276000
"TR","2004-05-29",2004,5,150,0,59900,28400,88300
"TR","2004-05-30",2004,5,151,0,56900,28700,85600
"TR","2004-05-31",2004,5,152,41300,55900,28800,126000
"TR","2004-06-01",2004,6,153,6e+05,95600,66200,761800
"TR","2004-06-02",2004,6,154,30200,78400,29100,137700
"TR","2004-06-03",2004,6,155,26200,71900,27800,125900
"TR","2004-06-04",2004,6,156,0,66300,28000,94300
"TR","2004-06-05",2004,6,157,0,62100,28500,90600
"TR","2004-06-06",2004,6,158,0,58200,28500,86700
"TR","2004-06-07",2004,6,159,232000,65700,30300,328000
"TR","2004-06-08",2004,6,160,0,60200,29000,89200
"TR","2004-06-09",2004,6,161,0,56400,29200,85600
"TR","2004-06-10",2004,6,162,153000,59700,30000,242700
"TR","2004-06-11",2004,6,163,44700,57600,29400,131700
"TR","2004-06-12",2004,6,164,0,54400,29200,83600
"TR","2004-06-13",2004,6,165,170000,59800,30600,260400
"TR","2004-06-14",2004,6,166,16200,56300,29600,102100
"TR","2004-06-15",2004,6,167,154000,60600,30900,245500
"TR","2004-06-16",2004,6,168,4770,56400,29500,90670
"TR","2004-06-17",2004,6,169,0,53200,29400,82600
"TR","2004-06-18",2004,6,170,0,50700,29500,80200
"TR","2004-06-19",2004,6,171,0,49200,29400,78600
"TR","2004-06-20",2004,6,172,0,48300,29500,77800
"TR","2004-06-21",2004,6,173,0,47400,29300,76700
"TR","2004-06-22",2004,6,174,0,46900,29300,76200
"TR","2004-06-23",2004,6,175,8610,46400,29200,84210
"TR","2004-06-24",2004,6,176,127000,48400,29500,204900
"TR","2004-06-25",2004,6,177,120000,50000,29300,199300
"TR","2004-06-26",2004,6,178,4420,48800,28900,82120
"TR","2004-06-27",2004,6,179,75700,49600,29400,154700
"TR","2004-06-28",2004,6,180,0,48400,29100,77500
"TR","2004-06-29",2004,6,181,0,47700,29200,76900
"TR","2004-06-30",2004,6,182,0,46900,29300,76200
"TR","2004-07-01",2004,7,183,0,46100,29300,75400
"TR","2004-07-02",2004,7,184,63300,45900,29400,138600
"TR","2004-07-03",2004,7,185,0,44000,28900,72900
"TR","2004-07-04",2004,7,186,0,43200,28800,72000
"TR","2004-07-05",2004,7,187,22100,42700,28700,93500
"TR","2004-07-06",2004,7,188,74800,43500,28700,147000
"TR","2004-07-07",2004,7,189,2800,42600,28300,73700
"TR","2004-07-08",2004,7,190,107000,44000,28500,179500
"TR","2004-07-09",2004,7,191,4570,43100,28100,75770
"TR","2004-07-10",2004,7,192,0,42400,28200,70600
"TR","2004-07-11",2004,7,193,0,41700,28300,70000
"TR","2004-07-12",2004,7,194,0,40900,28300,69200
"TR","2004-07-13",2004,7,195,10800,40300,28300,79400
"TR","2004-07-14",2004,7,196,8410,39700,28200,76310
"TR","2004-07-15",2004,7,197,82700,40600,28300,151600
"TR","2004-07-16",2004,7,198,0,39600,27900,67500
"TR","2004-07-17",2004,7,199,35500,39600,28000,103100
"TR","2004-07-18",2004,7,200,0,38700,27900,66600
"TR","2004-07-19",2004,7,201,0,37900,28000,65900
"TR","2004-07-20",2004,7,202,0,37300,28000,65300
"TR","2004-07-21",2004,7,203,22100,37100,27900,87100
"TR","2004-07-22",2004,7,204,0,36500,27900,64400
"TR","2004-07-23",2004,7,205,91400,37500,27900,156800
"TR","2004-07-24",2004,7,206,0,36700,27500,64200
"TR","2004-07-25",2004,7,207,0,36200,27600,63800
"TR","2004-07-26",2004,7,208,0,35600,27700,63300
"TR","2004-07-27",2004,7,209,0,35200,27700,62900
"TR","2004-07-28",2004,7,210,0,34700,27700,62400
"TR","2004-07-29",2004,7,211,0,34200,27700,61900
"TR","2004-07-30",2004,7,212,95300,35600,27600,158500
"TR","2004-07-31",2004,7,213,22700,35000,27300,85000
"TR","2004-08-01",2004,8,214,234000,39000,27300,300300
"TR","2004-08-02",2004,8,215,0,37400,26500,63900
"TR","2004-08-03",2004,8,216,0,36700,27100,63800
"TR","2004-08-04",2004,8,217,234000,40700,27500,302200
"TR","2004-08-05",2004,8,218,23200,39500,26900,89600
"TR","2004-08-06",2004,8,219,0,38300,27300,65600
"TR","2004-08-07",2004,8,220,0,37400,27600,65000
"TR","2004-08-08",2004,8,221,0,36400,28000,64400
"TR","2004-08-09",2004,8,222,1330,35800,28000,65130
"TR","2004-08-10",2004,8,223,224000,39300,28300,291600
"TR","2004-08-11",2004,8,224,219000,42700,27800,289500
"TR","2004-08-12",2004,8,225,143000,43300,27300,213600
"TR","2004-08-13",2004,8,226,159000,44900,27200,231100
"TR","2004-08-14",2004,8,227,0,43100,26400,69500
"TR","2004-08-15",2004,8,228,2270,42400,26900,71570
"TR","2004-08-16",2004,8,229,0,41200,27400,68600
"TR","2004-08-17",2004,8,230,27300,40500,27500,95300
"TR","2004-08-18",2004,8,231,114000,42400,27700,184100
"TR","2004-08-19",2004,8,232,0,41100,27400,68500
"TR","2004-08-20",2004,8,233,35300,40600,27800,103700
"TR","2004-08-21",2004,8,234,0,39500,27500,67000
"TR","2004-08-22",2004,8,235,0,39100,27600,66700
"TR","2004-08-23",2004,8,236,6490,38700,27600,72790
"TR","2004-08-24",2004,8,237,11400,38000,27700,77100
"TR","2004-08-25",2004,8,238,4550,37300,27600,69450
"TR","2004-08-26",2004,8,239,75000,38300,27700,141000
"TR","2004-08-27",2004,8,240,0,37300,27500,64800
"TR","2004-08-28",2004,8,241,18400,36900,27500,82800
"TR","2004-08-29",2004,8,242,0,36300,27500,63800
"TR","2004-08-30",2004,8,243,0,36100,27500,63600
"TR","2004-08-31",2004,8,244,28100,36200,27400,91700
"TR","2004-09-01",2004,9,245,0,35600,27400,63000
"TR","2004-09-02",2004,9,246,1320,35200,27500,64020
"TR","2004-09-03",2004,9,247,0,34700,27600,62300
"TR","2004-09-04",2004,9,248,0,34200,27800,62000
"TR","2004-09-05",2004,9,249,0,33700,27800,61500
"TR","2004-09-06",2004,9,250,0,33200,27900,61100
"TR","2004-09-07",2004,9,251,191000,36200,28100,255300
"TR","2004-09-08",2004,9,252,0,35100,27300,62400
"TR","2004-09-09",2004,9,253,0,34800,27400,62200
"TR","2004-09-10",2004,9,254,0,34500,27500,62000
"TR","2004-09-11",2004,9,255,0,34100,27600,61700
"TR","2004-09-12",2004,9,256,0,33600,27600,61200
"TR","2004-09-13",2004,9,257,0,33200,27700,60900
"TR","2004-09-14",2004,9,258,0,32900,27700,60600
"TR","2004-09-15",2004,9,259,0,32500,27800,60300
"TR","2004-09-16",2004,9,260,256000,36900,28100,321000
"TR","2004-09-17",2004,9,261,305000,42400,28000,375400
"TR","2004-09-18",2004,9,262,0,39000,26300,65300
"TR","2004-09-19",2004,9,263,0,38400,26600,65000
"TR","2004-09-20",2004,9,264,0,37800,26800,64600
"TR","2004-09-21",2004,9,265,0,37100,26900,64000
"TR","2004-09-22",2004,9,266,0,36500,27100,63600
"TR","2004-09-23",2004,9,267,0,35900,27100,63000
"TR","2004-09-24",2004,9,268,0,35400,27100,62500
"TR","2004-09-25",2004,9,269,64700,36500,26900,128100
"TR","2004-09-26",2004,9,270,6600,36300,26700,69600
"TR","2004-09-27",2004,9,271,0,35900,26700,62600
"TR","2004-09-28",2004,9,272,0,35500,26800,62300
"TR","2004-09-29",2004,9,273,5280,35200,26800,67280
"TR","2004-09-30",2004,9,274,0,34900,26700,61600
"TR","2004-10-01",2004,10,275,0,34700,26700,61400
"TR","2004-10-02",2004,10,276,8050,34500,26700,69250
"TR","2004-10-03",2004,10,277,361000,42500,27700,431200
"TR","2004-10-04",2004,10,278,0,39500,25800,65300
"TR","2004-10-05",2004,10,279,1740,38900,26100,66740
"TR","2004-10-06",2004,10,280,0,38400,26200,64600
"TR","2004-10-07",2004,10,281,0,38100,26300,64400
"TR","2004-10-08",2004,10,282,0,37800,26400,64200
"TR","2004-10-09",2004,10,283,53400,39000,26300,118700
"TR","2004-10-10",2004,10,284,16100,38900,26200,81200
"TR","2004-10-11",2004,10,285,0,38300,26100,64400
"TR","2004-10-12",2004,10,286,0,37900,26200,64100
"TR","2004-10-13",2004,10,287,0,37800,26200,64000
"TR","2004-10-14",2004,10,288,0,37600,26100,63700
"TR","2004-10-15",2004,10,289,3220,37600,26000,66820
"TR","2004-10-16",2004,10,290,0,37400,25900,63300
"TR","2004-10-17",2004,10,291,75600,39000,26100,140700
"TR","2004-10-18",2004,10,292,0,38600,25800,64400
"TR","2004-10-19",2004,10,293,0,38100,25800,63900
"TR","2004-10-20",2004,10,294,0,37800,25800,63600
"TR","2004-10-21",2004,10,295,0,37500,25800,63300
"TR","2004-10-22",2004,10,296,0,37200,25800,63000
"TR","2004-10-23",2004,10,297,0,37100,25900,63000
"TR","2004-10-24",2004,10,298,381000,47400,28000,456400
"TR","2004-10-25",2004,10,299,108000,45400,25400,178800
"TR","2004-10-26",2004,10,300,1740,44000,24500,70240
"TR","2004-10-27",2004,10,301,0,43200,24700,67900
"TR","2004-10-28",2004,10,302,8180,42900,24800,75880
"TR","2004-10-29",2004,10,303,0,42400,24800,67200
"TR","2004-10-30",2004,10,304,439000,62100,45500,546600
"TR","2004-10-31",2004,10,305,284000,71500,46500,402000
"TR","2004-11-01",2004,11,306,87700,68200,32600,188500
"TR","2004-11-02",2004,11,307,0,62400,23000,85400
"TR","2004-11-03",2004,11,308,0,57500,22900,80400
"TR","2004-11-04",2004,11,309,1900,53700,23000,78600
"TR","2004-11-05",2004,11,310,0,50800,23100,73900
"TR","2004-11-06",2004,11,311,0,48700,23200,71900
"TR","2004-11-07",2004,11,312,0,47100,23300,70400
"TR","2004-11-08",2004,11,313,0,46300,23400,69700
"TR","2004-11-09",2004,11,314,0,45800,23400,69200
"TR","2004-11-10",2004,11,315,0,45500,23400,68900
"TR","2004-11-11",2004,11,316,7550,45200,23400,76150
"TR","2004-11-12",2004,11,317,39700,45700,23500,108900
"TR","2004-11-13",2004,11,318,0,44800,23300,68100
"TR","2004-11-14",2004,11,319,0,44200,23500,67700
"TR","2004-11-15",2004,11,320,0,43700,23700,67400
"TR","2004-11-16",2004,11,321,0,43500,23800,67300
"TR","2004-11-17",2004,11,322,0,43200,24000,67200
"TR","2004-11-18",2004,11,323,8060,43100,24200,75360
"TR","2004-11-19",2004,11,324,1060,42800,24300,68160
"TR","2004-11-20",2004,11,325,0,42500,24400,66900
"TR","2004-11-21",2004,11,326,103000,44800,24700,172500
"TR","2004-11-22",2004,11,327,1260,43700,24300,69260
"TR","2004-11-23",2004,11,328,0,42900,24300,67200
"TR","2004-11-24",2004,11,329,0,42400,24300,66700
"TR","2004-11-25",2004,11,330,0,42000,24200,66200
"TR","2004-11-26",2004,11,331,0,41800,24200,66000
"TR","2004-11-27",2004,11,332,0,41600,24100,65700
"TR","2004-11-28",2004,11,333,175000,42900,23500,241400
"TR","2004-11-29",2004,11,334,182000,44100,22700,248800
"TR","2004-11-30",2004,11,335,0,43900,22700,66600
"TR","2004-12-01",2004,12,336,0,43700,23000,66700
"TR","2004-12-02",2004,12,337,0,43500,23200,66700
"TR","2004-12-03",2004,12,338,0,43300,23300,66600
"TR","2004-12-04",2004,12,339,41600,43400,23200,108200
"TR","2004-12-05",2004,12,340,22600,43300,23100,89000
"TR","2004-12-06",2004,12,341,0,43100,23200,66300
"TR","2004-12-07",2004,12,342,36100,43100,23200,102400
"TR","2004-12-08",2004,12,343,2420,42900,23200,68520
"TR","2004-12-09",2004,12,344,5620,42800,23300,71720
"TR","2004-12-10",2004,12,345,1210,42600,23300,67110
"TR","2004-12-11",2004,12,346,71200,43200,23300,137700
"TR","2004-12-12",2004,12,347,9610,43000,23100,75710
"TR","2004-12-13",2004,12,348,85300,43300,22900,151500
"TR","2004-12-14",2004,12,349,29700,43300,22800,95800
"TR","2004-12-15",2004,12,350,14000,43200,22800,80000
"TR","2004-12-16",2004,12,351,0,42900,22900,65800
"TR","2004-12-17",2004,12,352,0,42700,23000,65700
"TR","2004-12-18",2004,12,353,2420,42500,23100,68020
"TR","2004-12-19",2004,12,354,0,42300,23100,65400
"TR","2004-12-20",2004,12,355,11400,42200,23100,76700
"TR","2004-12-21",2004,12,356,56500,42500,22900,121900
"TR","2004-12-22",2004,12,357,2420,42300,22900,67620
"TR","2004-12-23",2004,12,358,10400,42200,22900,75500
"TR","2004-12-24",2004,12,359,0,42000,23000,65000
"TR","2004-12-25",2004,12,360,0,41800,23100,64900
"TR","2004-12-26",2004,12,361,3460,41700,23100,68260
"TR","2004-12-27",2004,12,362,0,41500,23100,64600
"TR","2004-12-28",2004,12,363,0,41400,23200,64600
"TR","2004-12-29",2004,12,364,1120,41200,23200,65520
"TR","2004-12-30",2004,12,365,0,41100,23300,64400
"TR","2004-12-31",2004,12,366,0,40900,23300,64200
"TR","2005-01-01",2005,1,1,138000,41800,22700,202500
"TR","2005-01-02",2005,1,2,0,41600,22600,64200
"TR","2005-01-03",2005,1,3,141000,42300,22300,205600
"TR","2005-01-04",2005,1,4,0,42100,22300,64400
"TR","2005-01-05",2005,1,5,0,41900,22500,64400
"TR","2005-01-06",2005,1,6,0,41700,22600,64300
"TR","2005-01-07",2005,1,7,50800,42000,22500,115300
"TR","2005-01-08",2005,1,8,0,41800,22500,64300
"TR","2005-01-09",2005,1,9,0,41600,22700,64300
"TR","2005-01-10",2005,1,10,0,41300,22800,64100
"TR","2005-01-11",2005,1,11,24600,41300,22700,88600
"TR","2005-01-12",2005,1,12,15900,41200,22700,79800
"TR","2005-01-13",2005,1,13,22400,41200,22700,86300
"TR","2005-01-14",2005,1,14,10100,41000,22700,73800
"TR","2005-01-15",2005,1,15,0,40900,22800,63700
"TR","2005-01-16",2005,1,16,0,40700,22800,63500
"TR","2005-01-17",2005,1,17,0,40500,22900,63400
"TR","2005-01-18",2005,1,18,0,40400,22900,63300
"TR","2005-01-19",2005,1,19,0,40200,22900,63100
"TR","2005-01-20",2005,1,20,155000,41200,22300,218500
"TR","2005-01-21",2005,1,21,51500,41400,22000,114900
"TR","2005-01-22",2005,1,22,0,41200,22200,63400
"TR","2005-01-23",2005,1,23,202000,42400,21600,266000
"TR","2005-01-24",2005,1,24,0,42200,21600,63800
"TR","2005-01-25",2005,1,25,0,41900,21800,63700
"TR","2005-01-26",2005,1,26,8090,41700,22000,71790
"TR","2005-01-27",2005,1,27,0,41400,22100,63500
"TR","2005-01-28",2005,1,28,0,41200,22300,63500
"TR","2005-01-29",2005,1,29,0,40900,22300,63200
"TR","2005-01-30",2005,1,30,0,40700,22400,63100
"TR","2005-01-31",2005,1,31,0,40400,22500,62900
"TR","2005-02-01",2005,2,32,0,40200,22600,62800
"TR","2005-02-02",2005,2,33,0,40000,22600,62600
"TR","2005-02-03",2005,2,34,0,39800,22700,62500
"TR","2005-02-04",2005,2,35,0,39600,22700,62300
"TR","2005-02-05",2005,2,36,0,39400,22700,62100
"TR","2005-02-06",2005,2,37,0,39200,22800,62000
"TR","2005-02-07",2005,2,38,39200,39800,22600,101600
"TR","2005-02-08",2005,2,39,104000,40400,22200,166600
"TR","2005-02-09",2005,2,40,1420,40000,22200,63620
"TR","2005-02-10",2005,2,41,0,39800,22300,62100
"TR","2005-02-11",2005,2,42,0,39600,22400,62000
"TR","2005-02-12",2005,2,43,7110,39400,22400,68910
"TR","2005-02-13",2005,2,44,0,39200,22500,61700
"TR","2005-02-14",2005,2,45,0,39000,22600,61600
"TR","2005-02-15",2005,2,46,84900,39500,22200,146600
"TR","2005-02-16",2005,2,47,5630,39300,22200,67130
"TR","2005-02-17",2005,2,48,0,39200,22300,61500
"TR","2005-02-18",2005,2,49,0,39000,22400,61400
"TR","2005-02-19",2005,2,50,0,38900,22400,61300
"TR","2005-02-20",2005,2,51,0,38700,22500,61200
"TR","2005-02-21",2005,2,52,22300,38700,22400,83400
"TR","2005-02-22",2005,2,53,40200,38900,22300,101400
"TR","2005-02-23",2005,2,54,0,38700,22300,61000
"TR","2005-02-24",2005,2,55,2130,38600,22400,63130
"TR","2005-02-25",2005,2,56,0,38400,22400,60800
"TR","2005-02-26",2005,2,57,7290,38300,22400,67990
"TR","2005-02-27",2005,2,58,0,38200,22400,60600
"TR","2005-02-28",2005,2,59,23100,38200,22400,83700
"TR","2005-03-01",2005,3,60,53400,38500,22100,114000
"TR","2005-03-02",2005,3,61,6150,38400,22200,66750
"TR","2005-03-03",2005,3,62,0,38200,22200,60400
"TR","2005-03-04",2005,3,63,0,38100,22300,60400
"TR","2005-03-05",2005,3,64,16600,38000,22300,76900
"TR","2005-03-06",2005,3,65,44400,38100,22200,104700
"TR","2005-03-07",2005,3,66,0,37900,22200,60100
"TR","2005-03-08",2005,3,67,28200,37700,22300,88200
"TR","2005-03-09",2005,3,68,2230,37600,22400,62230
"TR","2005-03-10",2005,3,69,0,37400,22400,59800
"TR","2005-03-11",2005,3,70,39200,37600,22200,99000
"TR","2005-03-12",2005,3,71,31100,37700,22100,90900
"TR","2005-03-13",2005,3,72,17400,37700,22100,77200
"TR","2005-03-14",2005,3,73,0,37500,22100,59600
"TR","2005-03-15",2005,3,74,0,37300,22200,59500
"TR","2005-03-16",2005,3,75,14800,37200,22200,74200
"TR","2005-03-17",2005,3,76,0,37000,22300,59300
"TR","2005-03-18",2005,3,77,45100,37300,22100,104500
"TR","2005-03-19",2005,3,78,0,37100,22200,59300
"TR","2005-03-20",2005,3,79,48800,37300,22000,108100
"TR","2005-03-21",2005,3,80,24800,37400,22000,84200
"TR","2005-03-22",2005,3,81,0,37100,22100,59200
"TR","2005-03-23",2005,3,82,0,36800,22200,59000
"TR","2005-03-24",2005,3,83,0,36500,22400,58900
"TR","2005-03-25",2005,3,84,0,36200,22500,58700
"TR","2005-03-26",2005,3,85,0,35800,22600,58400
"TR","2005-03-27",2005,3,86,0,35500,22700,58200
"TR","2005-03-28",2005,3,87,0,35300,22700,58000
"TR","2005-03-29",2005,3,88,0,35000,22800,57800
"TR","2005-03-30",2005,3,89,0,35700,22900,58600
"TR","2005-03-31",2005,3,90,0,38600,30300,68900
"TR","2005-04-01",2005,4,91,175000,182000,535000,892000
"TR","2005-04-02",2005,4,92,11200,87000,32200,130400
"TR","2005-04-03",2005,4,93,0,79000,24300,103300
"TR","2005-04-04",2005,4,94,0,76000,28200,104200
"TR","2005-04-05",2005,4,95,0,71900,32500,104400
"TR","2005-04-06",2005,4,96,0,67800,34000,101800
"TR","2005-04-07",2005,4,97,63300,68800,42000,174100
"TR","2005-04-08",2005,4,98,90200,67000,26200,183400
"TR","2005-04-09",2005,4,99,0,59900,21900,81800
"TR","2005-04-10",2005,4,100,0,55000,22200,77200
"TR","2005-04-11",2005,4,101,0,51100,22200,73300
"TR","2005-04-12",2005,4,102,0,48200,22300,70500
"TR","2005-04-13",2005,4,103,0,45900,22300,68200
"TR","2005-04-14",2005,4,104,0,44700,22300,67000
"TR","2005-04-15",2005,4,105,0,44100,22300,66400
"TR","2005-04-16",2005,4,106,0,43600,22400,66000
"TR","2005-04-17",2005,4,107,0,43100,22400,65500
"TR","2005-04-18",2005,4,108,87900,44300,23000,155200
"TR","2005-04-19",2005,4,109,0,42900,22600,65500
"TR","2005-04-20",2005,4,110,0,42000,22700,64700
"TR","2005-04-21",2005,4,111,151000,45100,23100,219200
"TR","2005-04-22",2005,4,112,0,42800,22300,65100
"TR","2005-04-23",2005,4,113,0,41900,22500,64400
"TR","2005-04-24",2005,4,114,0,41400,22700,64100
"TR","2005-04-25",2005,4,115,0,41200,22900,64100
"TR","2005-04-26",2005,4,116,0,40900,23100,64000
"TR","2005-04-27",2005,4,117,16800,40900,23200,80900
"TR","2005-04-28",2005,4,118,72600,41800,23300,137700
"TR","2005-04-29",2005,4,119,18800,41200,23000,83000
"TR","2005-04-30",2005,4,120,0,40400,23000,63400
"TR","2005-05-01",2005,5,121,0,39900,23200,63100
"TR","2005-05-02",2005,5,122,0,39400,23300,62700
"TR","2005-05-03",2005,5,123,13800,39400,23500,76700
"TR","2005-05-04",2005,5,124,0,39100,23500,62600
"TR","2005-05-05",2005,5,125,0,38900,23600,62500
"TR","2005-05-06",2005,5,126,0,38500,23800,62300
"TR","2005-05-07",2005,5,127,110000,40700,24400,175100
"TR","2005-05-08",2005,5,128,0,38500,23500,62000
"TR","2005-05-09",2005,5,129,33000,38400,23800,95200
"TR","2005-05-10",2005,5,130,43400,38400,24100,105900
"TR","2005-05-11",2005,5,131,172000,41000,24700,237700
"TR","2005-05-12",2005,5,132,58900,40300,23300,122500
"TR","2005-05-13",2005,5,133,0,39000,23000,62000
"TR","2005-05-14",2005,5,134,248000,44800,32800,325600
"TR","2005-05-15",2005,5,135,111000,44200,29400,184600
"TR","2005-05-16",2005,5,136,133000,46000,30600,209600
"TR","2005-05-17",2005,5,137,52600,45200,25300,123100
"TR","2005-05-18",2005,5,138,6650,44200,22200,73050
"TR","2005-05-19",2005,5,139,16700,43400,22500,82600
"TR","2005-05-20",2005,5,140,67900,44000,22800,134700
"TR","2005-05-21",2005,5,141,88500,44300,24800,157600
"TR","2005-05-22",2005,5,142,16700,43100,22600,82400
"TR","2005-05-23",2005,5,143,52400,43100,22900,118400
"TR","2005-05-24",2005,5,144,56000,43100,22900,122000
"TR","2005-05-25",2005,5,145,0,41800,22600,64400
"TR","2005-05-26",2005,5,146,0,40800,22800,63600
"TR","2005-05-27",2005,5,147,43200,40300,22600,106100
"TR","2005-05-28",2005,5,148,15900,39700,22500,78100
"TR","2005-05-29",2005,5,149,25800,39400,22500,87700
"TR","2005-05-30",2005,5,150,16800,39000,22500,78300
"TR","2005-05-31",2005,5,151,75100,39500,22800,137400
"TR","2005-06-01",2005,6,152,0,38300,22500,60800
"TR","2005-06-02",2005,6,153,0,37400,22900,60300
"TR","2005-06-03",2005,6,154,0,36600,22900,59500
"TR","2005-06-04",2005,6,155,0,35800,23100,58900
"TR","2005-06-05",2005,6,156,0,35200,23200,58400
"TR","2005-06-06",2005,6,157,449000,42300,24000,515300
"TR","2005-06-07",2005,6,158,456000,50600,34200,540800
"TR","2005-06-08",2005,6,159,0,44200,21200,65400
"TR","2005-06-09",2005,6,160,6630,43000,21700,71330
"TR","2005-06-10",2005,6,161,0,41800,22000,63800
"TR","2005-06-11",2005,6,162,0,40800,22200,63000
"TR","2005-06-12",2005,6,163,151000,42400,23000,216400
"TR","2005-06-13",2005,6,164,174000,44200,23300,241500
"TR","2005-06-14",2005,6,165,0,42200,22500,64700
"TR","2005-06-15",2005,6,166,363000,52800,32800,448600
"TR","2005-06-16",2005,6,167,70400,48200,22100,140700
"TR","2005-06-17",2005,6,168,0,44600,22000,66600
"TR","2005-06-18",2005,6,169,0,43500,22400,65900
"TR","2005-06-19",2005,6,170,0,42500,22500,65000
"TR","2005-06-20",2005,6,171,0,41600,22600,64200
"TR","2005-06-21",2005,6,172,0,40600,22700,63300
"TR","2005-06-22",2005,6,173,0,39700,22800,62500
"TR","2005-06-23",2005,6,174,0,38800,22900,61700
"TR","2005-06-24",2005,6,175,0,38100,23100,61200
"TR","2005-06-25",2005,6,176,0,37200,23400,60600
"TR","2005-06-26",2005,6,177,0,36500,23400,59900
"TR","2005-06-27",2005,6,178,0,35900,23400,59300
"TR","2005-06-28",2005,6,179,0,35300,23500,58800
"TR","2005-06-29",2005,6,180,953000,60900,30700,1044600
"TR","2005-06-30",2005,6,181,0,46400,20600,67000
"TR","2005-07-01",2005,7,182,375000,63800,33600,472400
"TR","2005-07-02",2005,7,183,36600,54900,20700,112200
"TR","2005-07-03",2005,7,184,0,49500,21000,70500
"TR","2005-07-04",2005,7,185,0,45800,21300,67100
"TR","2005-07-05",2005,7,186,32300,44700,21500,98500
"TR","2005-07-06",2005,7,187,18800,43600,21600,84000
"TR","2005-07-07",2005,7,188,0,42200,21600,63800
"TR","2005-07-08",2005,7,189,11500,41300,21800,74600
"TR","2005-07-09",2005,7,190,0,40200,21900,62100
"TR","2005-07-10",2005,7,191,0,39200,22100,61300
"TR","2005-07-11",2005,7,192,0,38000,22200,60200
"TR","2005-07-12",2005,7,193,0,36800,22400,59200
"TR","2005-07-13",2005,7,194,0,35500,22500,58000
"TR","2005-07-14",2005,7,195,0,34400,22600,57000
"TR","2005-07-15",2005,7,196,0,33300,22800,56100
"TR","2005-07-16",2005,7,197,0,32400,22900,55300
"TR","2005-07-17",2005,7,198,0,31700,22900,54600
"TR","2005-07-18",2005,7,199,0,31100,23000,54100
"TR","2005-07-19",2005,7,200,84500,31500,23000,139000
"TR","2005-07-20",2005,7,201,4200,30700,22700,57600
"TR","2005-07-21",2005,7,202,0,30200,22700,52900
"TR","2005-07-22",2005,7,203,0,29600,22900,52500
"TR","2005-07-23",2005,7,204,0,28700,23100,51800
"TR","2005-07-24",2005,7,205,0,28400,23200,51600
"TR","2005-07-25",2005,7,206,380000,35600,22800,438400
"TR","2005-07-26",2005,7,207,0,32300,21400,53700
"TR","2005-07-27",2005,7,208,181000,34200,21800,237000
"TR","2005-07-28",2005,7,209,0,32300,21300,53600
"TR","2005-07-29",2005,7,210,76300,33100,21500,130900
"TR","2005-07-30",2005,7,211,172000,35700,21400,229100
"TR","2005-07-31",2005,7,212,0,34300,20900,55200
"TR","2005-08-01",2005,8,213,0,33100,21400,54500
"TR","2005-08-02",2005,8,214,0,31900,21900,53800
"TR","2005-08-03",2005,8,215,0,31200,22300,53500
"TR","2005-08-04",2005,8,216,0,30500,22700,53200
"TR","2005-08-05",2005,8,217,143000,32500,22800,198300
"TR","2005-08-06",2005,8,218,0,31400,22500,53900
"TR","2005-08-07",2005,8,219,0,30600,22900,53500
"TR","2005-08-08",2005,8,220,0,29800,23300,53100
"TR","2005-08-09",2005,8,221,0,29200,23500,52700
"TR","2005-08-10",2005,8,222,19000,28800,23700,71500
"TR","2005-08-11",2005,8,223,193000,31800,23500,248300
"TR","2005-08-12",2005,8,224,0,30700,22800,53500
"TR","2005-08-13",2005,8,225,39700,30800,23000,93500
"TR","2005-08-14",2005,8,226,0,30100,23100,53200
"TR","2005-08-15",2005,8,227,0,29800,23200,53000
"TR","2005-08-16",2005,8,228,0,29200,23500,52700
"TR","2005-08-17",2005,8,229,0,28400,23800,52200
"TR","2005-08-18",2005,8,230,0,28000,23900,51900
"TR","2005-08-19",2005,8,231,2110,27700,23900,53710
"TR","2005-08-20",2005,8,232,416000,35300,23700,475000
"TR","2005-08-21",2005,8,233,56200,33400,22100,111700
"TR","2005-08-22",2005,8,234,0,32300,22300,54600
"TR","2005-08-23",2005,8,235,0,31800,22600,54400
"TR","2005-08-24",2005,8,236,0,31400,22800,54200
"TR","2005-08-25",2005,8,237,0,30900,23000,53900
"TR","2005-08-26",2005,8,238,0,30500,23200,53700
"TR","2005-08-27",2005,8,239,31600,30500,23200,85300
"TR","2005-08-28",2005,8,240,42100,30700,23200,96000
"TR","2005-08-29",2005,8,241,0,30000,23200,53200
"TR","2005-08-30",2005,8,242,0,29700,23300,53000
"TR","2005-08-31",2005,8,243,0,29300,23400,52700
"TR","2005-09-01",2005,9,244,0,28900,23500,52400
"TR","2005-09-02",2005,9,245,3960,28600,23600,56160
"TR","2005-09-03",2005,9,246,0,28100,23700,51800
"TR","2005-09-04",2005,9,247,0,27900,23700,51600
"TR","2005-09-05",2005,9,248,0,27600,23800,51400
"TR","2005-09-06",2005,9,249,0,27200,23900,51100
"TR","2005-09-07",2005,9,250,0,26700,24000,50700
"TR","2005-09-08",2005,9,251,0,26300,24100,50400
"TR","2005-09-09",2005,9,252,0,26100,24100,50200
"TR","2005-09-10",2005,9,253,0,26000,24100,50100
"TR","2005-09-11",2005,9,254,4790,25800,24100,54690
"TR","2005-09-12",2005,9,255,0,25400,24200,49600
"TR","2005-09-13",2005,9,256,0,25000,24400,49400
"TR","2005-09-14",2005,9,257,361000,31500,24300,416800
"TR","2005-09-15",2005,9,258,54300,30600,22900,107800
"TR","2005-09-16",2005,9,259,0,29900,23000,52900
"TR","2005-09-17",2005,9,260,0,29600,23200,52800
"TR","2005-09-18",2005,9,261,0,29200,23400,52600
"TR","2005-09-19",2005,9,262,0,28700,23500,52200
"TR","2005-09-20",2005,9,263,78600,29600,23600,131800
"TR","2005-09-21",2005,9,264,214000,33300,23400,270700
"TR","2005-09-22",2005,9,265,0,31500,22600,54100
"TR","2005-09-23",2005,9,266,88100,32400,22900,143400
"TR","2005-09-24",2005,9,267,0,31500,22700,54200
"TR","2005-09-25",2005,9,268,0,31200,22900,54100
"TR","2005-09-26",2005,9,269,40600,31400,23000,95000
"TR","2005-09-27",2005,9,270,225000,36000,23100,284100
"TR","2005-09-28",2005,9,271,0,34100,22300,56400
"TR","2005-09-29",2005,9,272,0,33400,22500,55900
"TR","2005-09-30",2005,9,273,176000,36800,22900,235700
"TR","2005-10-01",2005,10,274,0,35400,22000,57400
"TR","2005-10-02",2005,10,275,0,34800,22300,57100
"TR","2005-10-03",2005,10,276,0,34100,22700,56800
"TR","2005-10-04",2005,10,277,0,33300,22900,56200
"TR","2005-10-05",2005,10,278,230000,37600,23000,290600
"TR","2005-10-06",2005,10,279,1790000,128000,152000,2070000
"TR","2005-10-07",2005,10,280,191000,94000,59300,344300
"TR","2005-10-08",2005,10,281,23600,89900,30700,144200
"TR","2005-10-09",2005,10,282,0,86900,20400,107300
"TR","2005-10-10",2005,10,283,0,83900,19300,103200
"TR","2005-10-11",2005,10,284,0,80000,19900,99900
"TR","2005-10-12",2005,10,285,0,75900,20400,96300
"TR","2005-10-13",2005,10,286,13400,72400,20800,106600
"TR","2005-10-14",2005,10,287,70100,69500,21300,160900
"TR","2005-10-15",2005,10,288,32000,65000,21600,118600
"TR","2005-10-16",2005,10,289,0,59500,21800,81300
"TR","2005-10-17",2005,10,290,0,55500,22000,77500
"TR","2005-10-18",2005,10,291,145000,59200,22800,227000
"TR","2005-10-19",2005,10,292,63100,60000,25200,148300
"TR","2005-10-20",2005,10,293,0,56200,22500,78700
"TR","2005-10-21",2005,10,294,0,53000,22500,75500
"TR","2005-10-22",2005,10,295,0,50500,22700,73200
"TR","2005-10-23",2005,10,296,71100,52100,23000,146200
"TR","2005-10-24",2005,10,297,88700,55300,27900,171900
"TR","2005-10-25",2005,10,298,19100,53300,24500,96900
"TR","2005-10-26",2005,10,299,15100,51200,23000,89300
"TR","2005-10-27",2005,10,300,2120,49100,23100,74320
"TR","2005-10-28",2005,10,301,0,47500,23200,70700
"TR","2005-10-29",2005,10,302,0,46400,23400,69800
"TR","2005-10-30",2005,10,303,0,45800,23500,69300
"TR","2005-10-31",2005,10,304,0,45600,23600,69200
"TR","2005-11-01",2005,11,305,55500,46600,23700,125800
"TR","2005-11-02",2005,11,306,0,46000,23700,69700
"TR","2005-11-03",2005,11,307,0,45100,23700,68800
"TR","2005-11-04",2005,11,308,0,44700,23700,68400
"TR","2005-11-05",2005,11,309,3360,44400,23700,71460
"TR","2005-11-06",2005,11,310,0,44100,23600,67700
"TR","2005-11-07",2005,11,311,56700,45100,23700,125500
"TR","2005-11-08",2005,11,312,3210,44700,23600,71510
"TR","2005-11-09",2005,11,313,0,43800,23600,67400
"TR","2005-11-10",2005,11,314,0,43300,23700,67000
"TR","2005-11-11",2005,11,315,6010,43200,23600,72810
"TR","2005-11-12",2005,11,316,0,43000,23800,66800
"TR","2005-11-13",2005,11,317,0,42800,24000,66800
"TR","2005-11-14",2005,11,318,47900,43800,24100,115800
"TR","2005-11-15",2005,11,319,71200,43900,23600,138700
"TR","2005-11-16",2005,11,320,0,43600,23600,67200
"TR","2005-11-17",2005,11,321,266000,45300,22800,334100
"TR","2005-11-18",2005,11,322,24900,45300,22600,92800
"TR","2005-11-19",2005,11,323,6530,45100,22800,74430
"TR","2005-11-20",2005,11,324,0,44800,23100,67900
"TR","2005-11-21",2005,11,325,0,44500,23300,67800
"TR","2005-11-22",2005,11,326,0,44200,23500,67700
"TR","2005-11-23",2005,11,327,18000,44000,23600,85600
"TR","2005-11-24",2005,11,328,91000,44500,23200,158700
"TR","2005-11-25",2005,11,329,54400,44600,23000,122000
"TR","2005-11-26",2005,11,330,65600,44900,22800,133300
"TR","2005-11-27",2005,11,331,0,44700,22800,67500
"TR","2005-11-28",2005,11,332,48700,44700,22800,116200
"TR","2005-11-29",2005,11,333,197000,47300,22200,266500
"TR","2005-11-30",2005,11,334,144000,52500,22700,219200
"TR","2005-12-01",2005,12,335,109000,51800,21600,182400
"TR","2005-12-02",2005,12,336,12200,49800,21700,83700
"TR","2005-12-03",2005,12,337,3840,48200,22000,74040
"TR","2005-12-04",2005,12,338,0,46800,22200,69000
"TR","2005-12-05",2005,12,339,0,45700,22400,68100
"TR","2005-12-06",2005,12,340,0,45300,22500,67800
"TR","2005-12-07",2005,12,341,0,45100,22700,67800
"TR","2005-12-08",2005,12,342,0,44800,22800,67600
"TR","2005-12-09",2005,12,343,0,44600,22900,67500
"TR","2005-12-10",2005,12,344,0,44300,22900,67200
"TR","2005-12-11",2005,12,345,0,44100,23000,67100
"TR","2005-12-12",2005,12,346,11700,44000,23000,78700
"TR","2005-12-13",2005,12,347,0,43800,23100,66900
"TR","2005-12-14",2005,12,348,0,43600,23100,66700
"TR","2005-12-15",2005,12,349,0,43400,23200,66600
"TR","2005-12-16",2005,12,350,132000,44100,22600,198700
"TR","2005-12-17",2005,12,351,47000,44200,22400,113600
"TR","2005-12-18",2005,12,352,7930,44100,22500,74530
"TR","2005-12-19",2005,12,353,0,43800,22600,66400
"TR","2005-12-20",2005,12,354,0,43600,22800,66400
"TR","2005-12-21",2005,12,355,0,43400,22800,66200
"TR","2005-12-22",2005,12,356,0,43200,22900,66100
"TR","2005-12-23",2005,12,357,0,43000,23000,66000
"TR","2005-12-24",2005,12,358,4500,42800,23000,70300
"TR","2005-12-25",2005,12,359,15600,42700,23000,81300
"TR","2005-12-26",2005,12,360,3640,42600,23000,69240
"TR","2005-12-27",2005,12,361,0,42400,23100,65500
"TR","2005-12-28",2005,12,362,0,42200,23100,65300
"TR","2005-12-29",2005,12,363,0,42000,23200,65200
"TR","2005-12-30",2005,12,364,0,41900,23200,65100
"TR","2005-12-31",2005,12,365,29000,41900,23100,94000
"TR","2006-01-01",2006,1,1,105000,42500,22600,170100
"TR","2006-01-02",2006,1,2,0,42300,22600,64900
"TR","2006-01-03",2006,1,3,0,42100,22800,64900
"TR","2006-01-04",2006,1,4,0,41900,22900,64800
"TR","2006-01-05",2006,1,5,34400,41900,22800,99100
"TR","2006-01-06",2006,1,6,15000,41700,22800,79500
"TR","2006-01-07",2006,1,7,0,41500,22900,64400
"TR","2006-01-08",2006,1,8,0,41300,23000,64300
"TR","2006-01-09",2006,1,9,14200,41200,23000,78400
"TR","2006-01-10",2006,1,10,0,41100,23000,64100
"TR","2006-01-11",2006,1,11,13100,41000,23000,77100
"TR","2006-01-12",2006,1,12,0,40800,23000,63800
"TR","2006-01-13",2006,1,13,0,40600,23100,63700
"TR","2006-01-14",2006,1,14,0,40400,23100,63500
"TR","2006-01-15",2006,1,15,0,40300,23100,63400
"TR","2006-01-16",2006,1,16,0,40100,23100,63200
"TR","2006-01-17",2006,1,17,0,40000,23200,63200
"TR","2006-01-18",2006,1,18,179000,41100,22400,242500
"TR","2006-01-19",2006,1,19,6070,41000,22300,69370
"TR","2006-01-20",2006,1,20,0,40800,22400,63200
"TR","2006-01-21",2006,1,21,72300,41100,22200,135600
"TR","2006-01-22",2006,1,22,0,40900,22300,63200
"TR","2006-01-23",2006,1,23,0,40700,22400,63100
"TR","2006-01-24",2006,1,24,0,40500,22500,63000
"TR","2006-01-25",2006,1,25,25100,40500,22500,88100
"TR","2006-01-26",2006,1,26,29700,40400,22400,92500
"TR","2006-01-27",2006,1,27,0,40300,22500,62800
"TR","2006-01-28",2006,1,28,0,40000,22600,62600
"TR","2006-01-29",2006,1,29,0,39800,22700,62500
"TR","2006-01-30",2006,1,30,178000,40900,22000,240900
"TR","2006-01-31",2006,1,31,155000,41700,21300,218000
"TR","2006-02-01",2006,2,32,0,41500,21400,62900
"TR","2006-02-02",2006,2,33,123000,42100,21200,186300
"TR","2006-02-03",2006,2,34,0,41800,21300,63100
"TR","2006-02-04",2006,2,35,0,41500,21500,63000
"TR","2006-02-05",2006,2,36,10700,41300,21600,73600
"TR","2006-02-06",2006,2,37,3380,41000,21800,66180
"TR","2006-02-07",2006,2,38,0,40800,21900,62700
"TR","2006-02-08",2006,2,39,0,40500,22000,62500
"TR","2006-02-09",2006,2,40,0,40300,22000,62300
"TR","2006-02-10",2006,2,41,0,40100,22100,62200
"TR","2006-02-11",2006,2,42,4680,39900,22100,66680
"TR","2006-02-12",2006,2,43,0,39700,22200,61900
"TR","2006-02-13",2006,2,44,2250,39500,22200,63950
"TR","2006-02-14",2006,2,45,0,39300,22200,61500
"TR","2006-02-15",2006,2,46,0,39200,22300,61500
"TR","2006-02-16",2006,2,47,0,39000,22300,61300
"TR","2006-02-17",2006,2,48,0,38800,22300,61100
"TR","2006-02-18",2006,2,49,34100,38900,22200,95200
"TR","2006-02-19",2006,2,50,0,38800,22200,61000
"TR","2006-02-20",2006,2,51,0,38600,22200,60800
"TR","2006-02-21",2006,2,52,0,38500,22300,60800
"TR","2006-02-22",2006,2,53,0,38300,22300,60600
"TR","2006-02-23",2006,2,54,0,38200,22300,60500
"TR","2006-02-24",2006,2,55,0,38000,22300,60300
"TR","2006-02-25",2006,2,56,0,37900,22300,60200
"TR","2006-02-26",2006,2,57,70000,38200,22000,130200
"TR","2006-02-27",2006,2,58,0,38100,22000,60100
"TR","2006-02-28",2006,2,59,0,38000,22100,60100
"TR","2006-03-01",2006,3,60,0,37800,22100,59900
"TR","2006-03-02",2006,3,61,0,37600,22200,59800
"TR","2006-03-03",2006,3,62,238000,39000,21300,298300
"TR","2006-03-04",2006,3,63,0,38800,21200,60000
"TR","2006-03-05",2006,3,64,0,38600,21400,60000
"TR","2006-03-06",2006,3,65,0,38300,21600,59900
"TR","2006-03-07",2006,3,66,209000,39500,20900,269400
"TR","2006-03-08",2006,3,67,0,39200,20900,60100
"TR","2006-03-09",2006,3,68,38400,39300,21000,98700
"TR","2006-03-10",2006,3,69,15500,39100,21100,75700
"TR","2006-03-11",2006,3,70,0,38700,21400,60100
"TR","2006-03-12",2006,3,71,0,38400,21600,60000
"TR","2006-03-13",2006,3,72,0,38000,21800,59800
"TR","2006-03-14",2006,3,73,117000,38500,21300,176800
"TR","2006-03-15",2006,3,74,282000,40200,20300,342500
"TR","2006-03-16",2006,3,75,4460,39900,20200,64560
"TR","2006-03-17",2006,3,76,0,39600,20500,60100
"TR","2006-03-18",2006,3,77,0,39200,20800,60000
"TR","2006-03-19",2006,3,78,0,38900,21000,59900
"TR","2006-03-20",2006,3,79,0,38600,21200,59800
"TR","2006-03-21",2006,3,80,0,38200,21400,59600
"TR","2006-03-22",2006,3,81,0,37900,21500,59400
"TR","2006-03-23",2006,3,82,0,37600,21600,59200
"TR","2006-03-24",2006,3,83,0,37300,21700,59000
"TR","2006-03-25",2006,3,84,16900,37100,21700,75700
"TR","2006-03-26",2006,3,85,0,36800,21800,58600
"TR","2006-03-27",2006,3,86,0,36500,21900,58400
"TR","2006-03-28",2006,3,87,0,36100,22100,58200
"TR","2006-03-29",2006,3,88,0,35700,22200,57900
"TR","2006-03-30",2006,3,89,0,35300,22400,57700
"TR","2006-03-31",2006,3,90,12600,38300,25400,76300
"TR","2006-04-01",2006,4,91,103000,124000,320000,547000
"TR","2006-04-02",2006,4,92,51800,64700,39200,155700
"TR","2006-04-03",2006,4,93,0,62100,35300,97400
"TR","2006-04-04",2006,4,94,82200,60700,26600,169500
"TR","2006-04-05",2006,4,95,0,56500,26700,83200
"TR","2006-04-06",2006,4,96,0,54100,26700,80800
"TR","2006-04-07",2006,4,97,0,55400,32100,87500
"TR","2006-04-08",2006,4,98,0,65400,48700,114100
"TR","2006-04-09",2006,4,99,0,56800,28400,85200
"TR","2006-04-10",2006,4,100,0,55000,30000,85000
"TR","2006-04-11",2006,4,101,0,55400,35300,90700
"TR","2006-04-12",2006,4,102,0,57700,48600,106300
"TR","2006-04-13",2006,4,103,0,57500,26000,83500
"TR","2006-04-14",2006,4,104,3280,54600,24900,82780
"TR","2006-04-15",2006,4,105,28600,53300,25000,106900
"TR","2006-04-16",2006,4,106,0,50500,25000,75500
"TR","2006-04-17",2006,4,107,0,48600,25100,73700
"TR","2006-04-18",2006,4,108,0,47100,25200,72300
"TR","2006-04-19",2006,4,109,0,46300,25200,71500
"TR","2006-04-20",2006,4,110,24600,46200,25300,96100
"TR","2006-04-21",2006,4,111,19500,45800,25300,90600
"TR","2006-04-22",2006,4,112,0,45200,25200,70400
"TR","2006-04-23",2006,4,113,20200,45000,25300,90500
"TR","2006-04-24",2006,4,114,9750,44500,25500,79750
"TR","2006-04-25",2006,4,115,3280,44000,25600,72880
"TR","2006-04-26",2006,4,116,6080,43700,25800,75580
"TR","2006-04-27",2006,4,117,0,43300,25700,69000
"TR","2006-04-28",2006,4,118,0,42900,25900,68800
"TR","2006-04-29",2006,4,119,0,42500,26000,68500
"TR","2006-04-30",2006,4,120,13100,42400,26200,81700
"TR","2006-05-01",2006,5,121,31700,42600,26400,100700
"TR","2006-05-02",2006,5,122,116000,44200,26800,187000
"TR","2006-05-03",2006,5,123,88100,45000,26500,159600
"TR","2006-05-04",2006,5,124,0,43400,25800,69200
"TR","2006-05-05",2006,5,125,4780,42500,25900,73180
"TR","2006-05-06",2006,5,126,6650,42300,25800,74750
"TR","2006-05-07",2006,5,127,0,41800,25700,67500
"TR","2006-05-08",2006,5,128,0,41500,26000,67500
"TR","2006-05-09",2006,5,129,85400,42600,26600,154600
"TR","2006-05-10",2006,5,130,164000,45200,28800,238000
"TR","2006-05-11",2006,5,131,92100,45200,26400,163700
"TR","2006-05-12",2006,5,132,212000,50900,43100,306000
"TR","2006-05-13",2006,5,133,325000,68400,42000,435400
"TR","2006-05-14",2006,5,134,85500,63600,28700,177800
"TR","2006-05-15",2006,5,135,33700,59600,24400,117700
"TR","2006-05-16",2006,5,136,29200,56200,24500,109900
"TR","2006-05-17",2006,5,137,15400,52800,24600,92800
"TR","2006-05-18",2006,5,138,33000,50500,24900,108400
"TR","2006-05-19",2006,5,139,13100,48100,24800,86000
"TR","2006-05-20",2006,5,140,0,45600,24800,70400
"TR","2006-05-21",2006,5,141,7180,44900,24900,76980
"TR","2006-05-22",2006,5,142,4430,44000,24900,73330
"TR","2006-05-23",2006,5,143,0,43200,24900,68100
"TR","2006-05-24",2006,5,144,0,42400,25100,67500
"TR","2006-05-25",2006,5,145,120000,43300,25400,188700
"TR","2006-05-26",2006,5,146,307000,53300,26400,386700
"TR","2006-05-27",2006,5,147,36100,48700,24600,109400
"TR","2006-05-28",2006,5,148,86100,48600,25300,160000
"TR","2006-05-29",2006,5,149,169000,55700,25800,250500
"TR","2006-05-30",2006,5,150,38300,51300,24700,114300
"TR","2006-05-31",2006,5,151,0,47200,24500,71700
"TR","2006-06-01",2006,6,152,32200,45600,24700,102500
"TR","2006-06-02",2006,6,153,0,43900,24700,68600
"TR","2006-06-03",2006,6,154,0,42900,25000,67900
"TR","2006-06-04",2006,6,155,0,41900,25200,67100
"TR","2006-06-05",2006,6,156,0,40900,25400,66300
"TR","2006-06-06",2006,6,157,0,40100,25600,65700
"TR","2006-06-07",2006,6,158,6630,39500,25600,71730
"TR","2006-06-08",2006,6,159,372000,45000,26200,443200
"TR","2006-06-09",2006,6,160,0,42700,24600,67300
"TR","2006-06-10",2006,6,161,0,41900,25000,66900
"TR","2006-06-11",2006,6,162,0,41000,25200,66200
"TR","2006-06-12",2006,6,163,0,40400,25200,65600
"TR","2006-06-13",2006,6,164,0,39800,25400,65200
"TR","2006-06-14",2006,6,165,0,39300,25500,64800
"TR","2006-06-15",2006,6,166,4420,38700,25500,68620
"TR","2006-06-16",2006,6,167,0,38200,25600,63800
"TR","2006-06-17",2006,6,168,0,37600,25700,63300
"TR","2006-06-18",2006,6,169,0,37000,25800,62800
"TR","2006-06-19",2006,6,170,198000,39300,26100,263400
"TR","2006-06-20",2006,6,171,0,38100,25300,63400
"TR","2006-06-21",2006,6,172,13600,37600,25400,76600
"TR","2006-06-22",2006,6,173,16300,37300,25500,79100
"TR","2006-06-23",2006,6,174,0,36700,25600,62300
"TR","2006-06-24",2006,6,175,0,36300,25600,61900
"TR","2006-06-25",2006,6,176,219000,39400,26100,284500
"TR","2006-06-26",2006,6,177,229000,41900,25600,296500
"TR","2006-06-27",2006,6,178,0,40100,24700,64800
"TR","2006-06-28",2006,6,179,0,39300,25100,64400
"TR","2006-06-29",2006,6,180,175000,42200,25600,242800
"TR","2006-06-30",2006,6,181,46100,41600,25000,112700
"TR","2006-07-01",2006,7,182,0,40500,25100,65600
"TR","2006-07-02",2006,7,183,14200,39500,25200,78900
"TR","2006-07-03",2006,7,184,175000,41800,25400,242200
"TR","2006-07-04",2006,7,185,27500,40000,24800,92300
"TR","2006-07-05",2006,7,186,73700,39600,24700,138000
"TR","2006-07-06",2006,7,187,0,38300,24400,62700
"TR","2006-07-07",2006,7,188,0,37500,24500,62000
"TR","2006-07-08",2006,7,189,0,36400,24700,61100
"TR","2006-07-09",2006,7,190,0,35500,24600,60100
"TR","2006-07-10",2006,7,191,184000,37600,24700,246300
"TR","2006-07-11",2006,7,192,0,35900,24100,60000
"TR","2006-07-12",2006,7,193,0,34700,24200,58900
"TR","2006-07-13",2006,7,194,0,33400,24400,57800
"TR","2006-07-14",2006,7,195,0,32400,24500,56900
"TR","2006-07-15",2006,7,196,49400,32400,24400,106200
"TR","2006-07-16",2006,7,197,26600,31600,24500,82700
"TR","2006-07-17",2006,7,198,0,30500,24500,55000
"TR","2006-07-18",2006,7,199,0,30100,24500,54600
"TR","2006-07-19",2006,7,200,0,29100,24700,53800
"TR","2006-07-20",2006,7,201,0,28600,24700,53300
"TR","2006-07-21",2006,7,202,0,28300,24700,53000
"TR","2006-07-22",2006,7,203,0,28100,24600,52700
"TR","2006-07-23",2006,7,204,885,27700,24600,53185
"TR","2006-07-24",2006,7,205,0,27600,24500,52100
"TR","2006-07-25",2006,7,206,113000,29300,24300,166600
"TR","2006-07-26",2006,7,207,0,28300,24000,52300
"TR","2006-07-27",2006,7,208,152000,30200,24000,206200
"TR","2006-07-28",2006,7,209,0,29100,23500,52600
"TR","2006-07-29",2006,7,210,0,28500,23700,52200
"TR","2006-07-30",2006,7,211,3e+05,32800,23800,356600
"TR","2006-07-31",2006,7,212,413000,39000,22900,474900
"TR","2006-08-01",2006,8,213,210000,39700,21500,271200
"TR","2006-08-02",2006,8,214,282000,43400,29900,355300
"TR","2006-08-03",2006,8,215,429000,55200,45200,529400
"TR","2006-08-04",2006,8,216,51700,50300,22800,124800
"TR","2006-08-05",2006,8,217,29800,46900,21400,98100
"TR","2006-08-06",2006,8,218,6320,44100,21900,72320
"TR","2006-08-07",2006,8,219,0,42700,22300,65000
"TR","2006-08-08",2006,8,220,0,41600,22700,64300
"TR","2006-08-09",2006,8,221,0,40500,23000,63500
"TR","2006-08-10",2006,8,222,0,39600,23200,62800
"TR","2006-08-11",2006,8,223,0,38700,23400,62100
"TR","2006-08-12",2006,8,224,0,38000,23500,61500
"TR","2006-08-13",2006,8,225,0,37200,23600,60800
"TR","2006-08-14",2006,8,226,75000,37500,23800,136300
"TR","2006-08-15",2006,8,227,30700,37200,23600,91500
"TR","2006-08-16",2006,8,228,0,36300,23600,59900
"TR","2006-08-17",2006,8,229,0,35700,23800,59500
"TR","2006-08-18",2006,8,230,0,34900,24000,58900
"TR","2006-08-19",2006,8,231,175000,36900,24400,236300
"TR","2006-08-20",2006,8,232,514000,49200,24700,587900
"TR","2006-08-21",2006,8,233,0,41400,22100,63500
"TR","2006-08-22",2006,8,234,11400,40400,22600,74400
"TR","2006-08-23",2006,8,235,72800,40400,23300,136500
"TR","2006-08-24",2006,8,236,12400,39200,23200,74800
"TR","2006-08-25",2006,8,237,95200,40000,23700,158900
"TR","2006-08-26",2006,8,238,370000,49100,24600,443700
"TR","2006-08-27",2006,8,239,35400,43900,22400,101700
"TR","2006-08-28",2006,8,240,0,42400,22600,65000
"TR","2006-08-29",2006,8,241,0,41400,23000,64400
"TR","2006-08-30",2006,8,242,0,40400,23100,63500
"TR","2006-08-31",2006,8,243,0,39500,23200,62700
"TR","2006-09-01",2006,9,244,0,38600,23400,62000
"TR","2006-09-02",2006,9,245,0,37800,23400,61200
"TR","2006-09-03",2006,9,246,0,37200,23600,60800
"TR","2006-09-04",2006,9,247,0,36600,23600,60200
"TR","2006-09-05",2006,9,248,0,35900,23700,59600
"TR","2006-09-06",2006,9,249,0,35300,23800,59100
"TR","2006-09-07",2006,9,250,0,34600,23900,58500
"TR","2006-09-08",2006,9,251,15300,34200,24000,73500
"TR","2006-09-09",2006,9,252,51700,34500,24000,110200
"TR","2006-09-10",2006,9,253,29400,34600,23800,87800
"TR","2006-09-11",2006,9,254,0,34000,23700,57700
"TR","2006-09-12",2006,9,255,0,33700,23800,57500
"TR","2006-09-13",2006,9,256,3330,33300,23900,60530
"TR","2006-09-14",2006,9,257,0,33000,23900,56900
"TR","2006-09-15",2006,9,258,0,32600,24000,56600
"TR","2006-09-16",2006,9,259,0,32200,24000,56200
"TR","2006-09-17",2006,9,260,64100,32700,24200,121000
"TR","2006-09-18",2006,9,261,117000,34500,24100,175600
"TR","2006-09-19",2006,9,262,22600,34000,23700,80300
"TR","2006-09-20",2006,9,263,38000,34400,23700,96100
"TR","2006-09-21",2006,9,264,27000,34500,23600,85100
"TR","2006-09-22",2006,9,265,9970,34200,23600,67770
"TR","2006-09-23",2006,9,266,36000,34400,23700,94100
"TR","2006-09-24",2006,9,267,46800,34800,23700,105300
"TR","2006-09-25",2006,9,268,25200,34700,23600,83500
"TR","2006-09-26",2006,9,269,2640,34100,23600,60340
"TR","2006-09-27",2006,9,270,28500,34200,23700,86400
"TR","2006-09-28",2006,9,271,57500,35200,23500,116200
"TR","2006-09-29",2006,9,272,44000,35900,23400,103300
"TR","2006-09-30",2006,9,273,26800,35700,23400,85900
"TR","2006-10-01",2006,10,274,24800,35700,23400,83900
"TR","2006-10-02",2006,10,275,0,35200,23500,58700
"TR","2006-10-03",2006,10,276,0,34800,23600,58400
"TR","2006-10-04",2006,10,277,0,34200,23800,58000
"TR","2006-10-05",2006,10,278,103000,36000,23500,162500
"TR","2006-10-06",2006,10,279,0,35600,23300,58900
"TR","2006-10-07",2006,10,280,0,35200,23500,58700
"TR","2006-10-08",2006,10,281,0,34700,23600,58300
"TR","2006-10-09",2006,10,282,0,34300,23600,57900
"TR","2006-10-10",2006,10,283,0,34200,23600,57800
"TR","2006-10-11",2006,10,284,0,34100,23700,57800
"TR","2006-10-12",2006,10,285,90300,36100,23800,150200
"TR","2006-10-13",2006,10,286,24000,36100,23500,83600
"TR","2006-10-14",2006,10,287,110000,36400,22800,169200
"TR","2006-10-15",2006,10,288,77600,36800,22400,136800
"TR","2006-10-16",2006,10,289,0,36700,22400,59100
"TR","2006-10-17",2006,10,290,0,36800,22900,59700
"TR","2006-10-18",2006,10,291,198000,44200,25500,267700
"TR","2006-10-19",2006,10,292,16800,40000,22300,79100
"TR","2006-10-20",2006,10,293,16000,39200,22300,77500
"TR","2006-10-21",2006,10,294,0,38600,22300,60900
"TR","2006-10-22",2006,10,295,25700,38800,22500,87000
"TR","2006-10-23",2006,10,296,0,38300,22400,60700
"TR","2006-10-24",2006,10,297,0,38100,22500,60600
"TR","2006-10-25",2006,10,298,11400,38000,22500,71900
"TR","2006-10-26",2006,10,299,0,37900,22500,60400
"TR","2006-10-27",2006,10,300,0,37700,22500,60200
"TR","2006-10-28",2006,10,301,0,37400,22500,59900
"TR","2006-10-29",2006,10,302,45300,38100,22600,106000
"TR","2006-10-30",2006,10,303,0,37400,22300,59700
"TR","2006-10-31",2006,10,304,0,37000,22400,59400
"TR","2006-11-01",2006,11,305,0,36900,22500,59400
"TR","2006-11-02",2006,11,306,0,36700,22400,59100
"TR","2006-11-03",2006,11,307,0,36600,22300,58900
"TR","2006-11-04",2006,11,308,0,36400,22200,58600
"TR","2006-11-05",2006,11,309,0,36300,22200,58500
"TR","2006-11-06",2006,11,310,0,36100,22100,58200
"TR","2006-11-07",2006,11,311,2410,35900,22100,60410
"TR","2006-11-08",2006,11,312,12100,35800,22100,70000
"TR","2006-11-09",2006,11,313,28300,36200,22300,86800
"TR","2006-11-10",2006,11,314,40100,36300,22200,98600
"TR","2006-11-11",2006,11,315,47200,36400,21800,105400
"TR","2006-11-12",2006,11,316,43200,36300,21600,101100
"TR","2006-11-13",2006,11,317,54000,36600,21300,111900
"TR","2006-11-14",2006,11,318,66100,36900,21100,124100
"TR","2006-11-15",2006,11,319,40500,37200,21200,98900
"TR","2006-11-16",2006,11,320,0,37000,21300,58300
"TR","2006-11-17",2006,11,321,0,36800,21500,58300
"TR","2006-11-18",2006,11,322,0,36600,21700,58300
"TR","2006-11-19",2006,11,323,0,36400,21800,58200
"TR","2006-11-20",2006,11,324,0,36200,21900,58100
"TR","2006-11-21",2006,11,325,0,36100,21900,58000
"TR","2006-11-22",2006,11,326,0,35900,22000,57900
"TR","2006-11-23",2006,11,327,0,36000,22300,58300
"TR","2006-11-24",2006,11,328,0,36000,22200,58200
"TR","2006-11-25",2006,11,329,0,35300,22100,57400
"TR","2006-11-26",2006,11,330,0,34900,22000,56900
"TR","2006-11-27",2006,11,331,14500,34900,21900,71300
"TR","2006-11-28",2006,11,332,53100,35900,21900,110900
"TR","2006-11-29",2006,11,333,143000,38000,22100,203100
"TR","2006-11-30",2006,11,334,98300,39600,21300,159200
"TR","2006-12-01",2006,12,335,0,38600,20900,59500
"TR","2006-12-02",2006,12,336,0,38200,21000,59200
"TR","2006-12-03",2006,12,337,14400,38100,21000,73500
"TR","2006-12-04",2006,12,338,19300,38100,21000,78400
"TR","2006-12-05",2006,12,339,14400,38100,21000,73500
"TR","2006-12-06",2006,12,340,21800,38100,20900,80800
"TR","2006-12-07",2006,12,341,37300,38100,20800,96200
"TR","2006-12-08",2006,12,342,19200,38000,20700,77900
"TR","2006-12-09",2006,12,343,0,37800,20800,58600
"TR","2006-12-10",2006,12,344,0,37600,20800,58400
"TR","2006-12-11",2006,12,345,0,37400,20900,58300
"TR","2006-12-12",2006,12,346,38800,37800,20900,97500
"TR","2006-12-13",2006,12,347,25700,38800,21200,85700
"TR","2006-12-14",2006,12,348,3550,38700,20900,63150
"TR","2006-12-15",2006,12,349,37900,38400,20700,97000
"TR","2006-12-16",2006,12,350,12200,38300,20800,71300
"TR","2006-12-17",2006,12,351,0,38100,20700,58800
"TR","2006-12-18",2006,12,352,0,37800,20700,58500
"TR","2006-12-19",2006,12,353,0,37700,20800,58500
"TR","2006-12-20",2006,12,354,0,37500,20800,58300
"TR","2006-12-21",2006,12,355,0,37300,20800,58100
"TR","2006-12-22",2006,12,356,6060,37200,20800,64060
"TR","2006-12-23",2006,12,357,109000,37700,20400,167100
"TR","2006-12-24",2006,12,358,149000,38500,19800,207300
"TR","2006-12-25",2006,12,359,0,38300,19800,58100
"TR","2006-12-26",2006,12,360,0,38100,20000,58100
"TR","2006-12-27",2006,12,361,0,37900,20200,58100
"TR","2006-12-28",2006,12,362,0,37600,20300,57900
"TR","2006-12-29",2006,12,363,0,37400,20300,57700
"TR","2006-12-30",2006,12,364,9700,37200,20400,67300
"TR","2006-12-31",2006,12,365,20900,37200,20300,78400
"TR","2007-01-01",2007,1,1,66700,37400,20100,124200
"TR","2007-01-02",2007,1,2,178000,38400,19500,235900
"TR","2007-01-03",2007,1,3,0,38100,19500,57600
"TR","2007-01-04",2007,1,4,0,37900,19700,57600
"TR","2007-01-05",2007,1,5,0,37600,19900,57500
"TR","2007-01-06",2007,1,6,0,37300,20000,57300
"TR","2007-01-07",2007,1,7,0,37000,20100,57100
"TR","2007-01-08",2007,1,8,10100,36800,20200,67100
"TR","2007-01-09",2007,1,9,5920,36700,20200,62820
"TR","2007-01-10",2007,1,10,0,36500,20300,56800
"TR","2007-01-11",2007,1,11,0,36300,20300,56600
"TR","2007-01-12",2007,1,12,0,36100,20400,56500
"TR","2007-01-13",2007,1,13,0,35900,20400,56300
"TR","2007-01-14",2007,1,14,0,35700,20500,56200
"TR","2007-01-15",2007,1,15,0,35600,20500,56100
"TR","2007-01-16",2007,1,16,33700,35700,20300,89700
"TR","2007-01-17",2007,1,17,5340,35500,20300,61140
"TR","2007-01-18",2007,1,18,0,35400,20400,55800
"TR","2007-01-19",2007,1,19,14200,35300,20300,69800
"TR","2007-01-20",2007,1,20,20300,35400,20300,76000
"TR","2007-01-21",2007,1,21,0,35200,20300,55500
"TR","2007-01-22",2007,1,22,0,35100,20400,55500
"TR","2007-01-23",2007,1,23,12000,35000,20400,67400
"TR","2007-01-24",2007,1,24,0,34900,20400,55300
"TR","2007-01-25",2007,1,25,0,34700,20400,55100
"TR","2007-01-26",2007,1,26,27400,34800,20300,82500
"TR","2007-01-27",2007,1,27,0,34600,20300,54900
"TR","2007-01-28",2007,1,28,8090,34500,20400,62990
"TR","2007-01-29",2007,1,29,9380,34500,20300,64180
"TR","2007-01-30",2007,1,30,0,34300,20400,54700
"TR","2007-01-31",2007,1,31,20400,34400,20300,75100
"TR","2007-02-01",2007,2,32,30400,34500,20200,85100
"TR","2007-02-02",2007,2,33,0,34400,20200,54600
"TR","2007-02-03",2007,2,34,0,34200,20300,54500
"TR","2007-02-04",2007,2,35,0,34100,20300,54400
"TR","2007-02-05",2007,2,36,0,34000,20300,54300
"TR","2007-02-06",2007,2,37,0,33900,20400,54300
"TR","2007-02-07",2007,2,38,0,33800,20400,54200
"TR","2007-02-08",2007,2,39,0,33700,20400,54100
"TR","2007-02-09",2007,2,40,0,33600,20400,54000
"TR","2007-02-10",2007,2,41,0,33500,20400,53900
"TR","2007-02-11",2007,2,42,0,33400,20400,53800
"TR","2007-02-12",2007,2,43,0,33300,20400,53700
"TR","2007-02-13",2007,2,44,0,33300,20400,53700
"TR","2007-02-14",2007,2,45,0,33200,20400,53600
"TR","2007-02-15",2007,2,46,0,33100,20400,53500
"TR","2007-02-16",2007,2,47,0,33000,20400,53400
"TR","2007-02-17",2007,2,48,0,33000,20400,53400
"TR","2007-02-18",2007,2,49,7120,33000,20400,60520
"TR","2007-02-19",2007,2,50,9960,33000,20400,63360
"TR","2007-02-20",2007,2,51,0,32900,20400,53300
"TR","2007-02-21",2007,2,52,0,32800,20400,53200
"TR","2007-02-22",2007,2,53,0,32700,20400,53100
"TR","2007-02-23",2007,2,54,11300,32700,20400,64400
"TR","2007-02-24",2007,2,55,0,32600,20400,53000
"TR","2007-02-25",2007,2,56,28000,32700,20300,81000
"TR","2007-02-26",2007,2,57,45200,33000,20100,98300
"TR","2007-02-27",2007,2,58,20500,33100,20000,73600
"TR","2007-02-28",2007,2,59,18700,33100,20000,71800
"TR","2007-03-01",2007,3,60,19400,33100,20000,72500
"TR","2007-03-02",2007,3,61,65900,33500,19700,119100
"TR","2007-03-03",2007,3,62,150000,34500,19200,203700
"TR","2007-03-04",2007,3,63,41300,34600,19100,95000
"TR","2007-03-05",2007,3,64,8280,34400,19200,61880
"TR","2007-03-06",2007,3,65,0,34200,19400,53600
"TR","2007-03-07",2007,3,66,35700,34300,19400,89400
"TR","2007-03-08",2007,3,67,64000,34600,19200,117800
"TR","2007-03-09",2007,3,68,0,34400,19300,53700
"TR","2007-03-10",2007,3,69,0,34000,19400,53400
"TR","2007-03-11",2007,3,70,0,33700,19600,53300
"TR","2007-03-12",2007,3,71,0,33300,19800,53100
"TR","2007-03-13",2007,3,72,10300,33600,20300,64200
"TR","2007-03-14",2007,3,73,0,35000,30600,65600
"TR","2007-03-15",2007,3,74,0,35600,26500,62100
"TR","2007-03-16",2007,3,75,0,34300,21000,55300
"TR","2007-03-17",2007,3,76,0,33900,20300,54200
"TR","2007-03-18",2007,3,77,0,33700,20400,54100
"TR","2007-03-19",2007,3,78,69200,34100,20000,123300
"TR","2007-03-20",2007,3,79,73200,34700,19700,127600
"TR","2007-03-21",2007,3,80,0,34400,19700,54100
"TR","2007-03-22",2007,3,81,22300,34200,19800,76300
"TR","2007-03-23",2007,3,82,19000,34400,19900,73300
"TR","2007-03-24",2007,3,83,0,35200,28000,63200
"TR","2007-03-25",2007,3,84,0,37000,34700,71700
"TR","2007-03-26",2007,3,85,104000,46200,67200,217400
"TR","2007-03-27",2007,3,86,73400,43900,22200,139500
"TR","2007-03-28",2007,3,87,6030,42200,19900,68130
"TR","2007-03-29",2007,3,88,14000,41600,19900,75500
"TR","2007-03-30",2007,3,89,0,40600,19800,60400
"TR","2007-03-31",2007,3,90,48000,40700,20100,108800
"TR","2007-04-01",2007,4,91,104000,41600,20400,166000
"TR","2007-04-02",2007,4,92,191000,44600,27000,262600
"TR","2007-04-03",2007,4,93,62000,43400,22700,128100
"TR","2007-04-04",2007,4,94,9150,42200,19700,71050
"TR","2007-04-05",2007,4,95,333000,46700,18800,398500
"TR","2007-04-06",2007,4,96,57100,45400,18600,121100
"TR","2007-04-07",2007,4,97,0,43100,18900,62000
"TR","2007-04-08",2007,4,98,7060,42200,19100,68360
"TR","2007-04-09",2007,4,99,0,41700,19400,61100
"TR","2007-04-10",2007,4,100,0,41200,19600,60800
"TR","2007-04-11",2007,4,101,0,40600,19800,60400
"TR","2007-04-12",2007,4,102,0,40100,20000,60100
"TR","2007-04-13",2007,4,103,54900,40900,20600,116400
"TR","2007-04-14",2007,4,104,0,40500,21700,62200
"TR","2007-04-15",2007,4,105,0,41100,26400,67500
"TR","2007-04-16",2007,4,106,0,41100,29700,70800
"TR","2007-04-17",2007,4,107,0,40200,22700,62900
"TR","2007-04-18",2007,4,108,36400,40300,21400,98100
"TR","2007-04-19",2007,4,109,0,39500,20500,60000
"TR","2007-04-20",2007,4,110,0,38900,20500,59400
"TR","2007-04-21",2007,4,111,0,38500,20500,59000
"TR","2007-04-22",2007,4,112,0,38100,20400,58500
"TR","2007-04-23",2007,4,113,0,37700,20400,58100
"TR","2007-04-24",2007,4,114,210000,42600,21100,273700
"TR","2007-04-25",2007,4,115,0,39100,20000,59100
"TR","2007-04-26",2007,4,116,0,38200,20100,58300
"TR","2007-04-27",2007,4,117,0,37800,20200,58000
"TR","2007-04-28",2007,4,118,0,37300,20200,57500
"TR","2007-04-29",2007,4,119,0,37000,20200,57200
"TR","2007-04-30",2007,4,120,0,36700,20200,56900
"TR","2007-05-01",2007,5,121,0,36400,20200,56600
"TR","2007-05-02",2007,5,122,0,36000,20400,56400
"TR","2007-05-03",2007,5,123,0,35700,20600,56300
"TR","2007-05-04",2007,5,124,0,35300,20800,56100
"TR","2007-05-05",2007,5,125,0,35000,21000,56000
"TR","2007-05-06",2007,5,126,0,34600,21200,55800
"TR","2007-05-07",2007,5,127,0,34300,21300,55600
"TR","2007-05-08",2007,5,128,0,34100,21500,55600
"TR","2007-05-09",2007,5,129,95400,35700,21900,153000
"TR","2007-05-10",2007,5,130,145000,37700,22200,204900
"TR","2007-05-11",2007,5,131,184000,40400,27800,252200
"TR","2007-05-12",2007,5,132,0,37600,20500,58100
"TR","2007-05-13",2007,5,133,0,36400,20400,56800
"TR","2007-05-14",2007,5,134,0,35800,20600,56400
"TR","2007-05-15",2007,5,135,28000,35600,20500,84100
"TR","2007-05-16",2007,5,136,329000,40800,21900,391700
"TR","2007-05-17",2007,5,137,1730,37500,19800,59030
"TR","2007-05-18",2007,5,138,0,36800,20000,56800
"TR","2007-05-19",2007,5,139,0,36200,20300,56500
"TR","2007-05-20",2007,5,140,19200,35600,20200,75000
"TR","2007-05-21",2007,5,141,0,34900,20400,55300
"TR","2007-05-22",2007,5,142,115000,36100,20600,171700
"TR","2007-05-23",2007,5,143,55300,36200,20300,111800
"TR","2007-05-24",2007,5,144,2390,35300,20200,57890
"TR","2007-05-25",2007,5,145,480000,45100,30200,555300
"TR","2007-05-26",2007,5,146,510000,63300,49400,622700
"TR","2007-05-27",2007,5,147,0,50800,18000,68800
"TR","2007-05-28",2007,5,148,62500,48800,18900,130200
"TR","2007-05-29",2007,5,149,0,45000,18900,63900
"TR","2007-05-30",2007,5,150,0,42700,19300,62000
"TR","2007-05-31",2007,5,151,49500,42100,19500,111100
"TR","2007-06-01",2007,6,152,74900,42200,19700,136800
"TR","2007-06-02",2007,6,153,77200,42300,19900,139400
"TR","2007-06-03",2007,6,154,9770,41000,19900,70670
"TR","2007-06-04",2007,6,155,13400,40000,20100,73500
"TR","2007-06-05",2007,6,156,15400,39300,20300,75000
"TR","2007-06-06",2007,6,157,0,38400,20300,58700
"TR","2007-06-07",2007,6,158,14300,37800,20500,72600
"TR","2007-06-08",2007,6,159,13300,37300,20600,71200
"TR","2007-06-09",2007,6,160,4420,36600,20700,61720
"TR","2007-06-10",2007,6,161,0,35900,20800,56700
"TR","2007-06-11",2007,6,162,2380,35300,21000,58680
"TR","2007-06-12",2007,6,163,0,34700,21200,55900
"TR","2007-06-13",2007,6,164,0,34000,21300,55300
"TR","2007-06-14",2007,6,165,0,33200,21600,54800
"TR","2007-06-15",2007,6,166,0,32700,21700,54400
"TR","2007-06-16",2007,6,167,0,32100,21800,53900
"TR","2007-06-17",2007,6,168,0,31600,21900,53500
"TR","2007-06-18",2007,6,169,7150,31200,21900,60250
"TR","2007-06-19",2007,6,170,243000,34400,22000,299400
"TR","2007-06-20",2007,6,171,219000,37500,21100,277600
"TR","2007-06-21",2007,6,172,11900,35400,20400,67700
"TR","2007-06-22",2007,6,173,9770,34600,21000,65370
"TR","2007-06-23",2007,6,174,0,33600,21200,54800
"TR","2007-06-24",2007,6,175,0,33000,21400,54400
"TR","2007-06-25",2007,6,176,0,32400,21600,54000
"TR","2007-06-26",2007,6,177,0,31800,21700,53500
"TR","2007-06-27",2007,6,178,169000,33700,21900,224600
"TR","2007-06-28",2007,6,179,145000,35400,21400,201800
"TR","2007-06-29",2007,6,180,0,34000,21000,55000
"TR","2007-06-30",2007,6,181,0,33400,21300,54700
"TR","2007-07-01",2007,7,182,0,32600,21500,54100
"TR","2007-07-02",2007,7,183,0,31400,21600,53000
"TR","2007-07-03",2007,7,184,4310,30700,21500,56510
"TR","2007-07-04",2007,7,185,12500,30200,21400,64100
"TR","2007-07-05",2007,7,186,88500,30900,21400,140800
"TR","2007-07-06",2007,7,187,68800,30400,21300,120500
"TR","2007-07-07",2007,7,188,0,29000,21100,50100
"TR","2007-07-08",2007,7,189,0,28200,21300,49500
"TR","2007-07-09",2007,7,190,0,27500,21400,48900
"TR","2007-07-10",2007,7,191,214000,30200,21500,265700
"TR","2007-07-11",2007,7,192,0,28600,20600,49200
"TR","2007-07-12",2007,7,193,5390,27800,20900,54090
"TR","2007-07-13",2007,7,194,71000,28300,20900,120200
"TR","2007-07-14",2007,7,195,47000,28400,20600,96000
"TR","2007-07-15",2007,7,196,48200,28600,20500,97300
"TR","2007-07-16",2007,7,197,5610,28000,20500,54110
"TR","2007-07-17",2007,7,198,0,27500,20600,48100
"TR","2007-07-18",2007,7,199,0,26900,20800,47700
"TR","2007-07-19",2007,7,200,27100,26700,20800,74600
"TR","2007-07-20",2007,7,201,11200,25900,21000,58100
"TR","2007-07-21",2007,7,202,0,25000,21100,46100
"TR","2007-07-22",2007,7,203,0,24600,21100,45700
"TR","2007-07-23",2007,7,204,0,24100,21100,45200
"TR","2007-07-24",2007,7,205,0,23800,21200,45000
"TR","2007-07-25",2007,7,206,0,23300,21200,44500
"TR","2007-07-26",2007,7,207,0,22900,21300,44200
"TR","2007-07-27",2007,7,208,42300,23200,21300,86800
"TR","2007-07-28",2007,7,209,117000,24800,21000,162800
"TR","2007-07-29",2007,7,210,0,23900,20600,44500
"TR","2007-07-30",2007,7,211,0,23400,20800,44200
"TR","2007-07-31",2007,7,212,0,22700,21000,43700
"TR","2007-08-01",2007,8,213,0,22100,21100,43200
"TR","2007-08-02",2007,8,214,0,21700,21400,43100
"TR","2007-08-03",2007,8,215,0,21400,21700,43100
"TR","2007-08-04",2007,8,216,0,20500,22100,42600
"TR","2007-08-05",2007,8,217,0,19800,22600,42400
"TR","2007-08-06",2007,8,218,0,19300,22900,42200
"TR","2007-08-07",2007,8,219,0,19500,22900,42400
"TR","2007-08-08",2007,8,220,0,19500,22900,42400
"TR","2007-08-09",2007,8,221,0,18800,23200,42000
"TR","2007-08-10",2007,8,222,0,18900,23300,42200
"TR","2007-08-11",2007,8,223,242000,23500,23100,288600
"TR","2007-08-12",2007,8,224,0,22300,22200,44500
"TR","2007-08-13",2007,8,225,12200,22000,22500,56700
"TR","2007-08-14",2007,8,226,0,21100,22800,43900
"TR","2007-08-15",2007,8,227,0,20500,23100,43600
"TR","2007-08-16",2007,8,228,0,20400,23100,43500
"TR","2007-08-17",2007,8,229,36700,21000,23000,80700
"TR","2007-08-18",2007,8,230,0,20900,22900,43800
"TR","2007-08-19",2007,8,231,0,20900,22900,43800
"TR","2007-08-20",2007,8,232,0,21000,22800,43800
"TR","2007-08-21",2007,8,233,7210,21200,22800,51210
"TR","2007-08-22",2007,8,234,17700,21400,22700,61800
"TR","2007-08-23",2007,8,235,82000,22900,22600,127500
"TR","2007-08-24",2007,8,236,20900,22800,22400,66100
"TR","2007-08-25",2007,8,237,0,22300,22400,44700
"TR","2007-08-26",2007,8,238,0,22100,22500,44600
"TR","2007-08-27",2007,8,239,0,21800,22600,44400
"TR","2007-08-28",2007,8,240,42200,21800,22700,86700
"TR","2007-08-29",2007,8,241,350000,28300,22500,400800
"TR","2007-08-30",2007,8,242,141000,28600,21100,190700
"TR","2007-08-31",2007,8,243,0,27300,20800,48100
"TR","2007-09-01",2007,9,244,0,26500,21300,47800
"TR","2007-09-02",2007,9,245,0,25800,21600,47400
"TR","2007-09-03",2007,9,246,0,25300,21800,47100
"TR","2007-09-04",2007,9,247,0,24900,22000,46900
"TR","2007-09-05",2007,9,248,0,24400,22100,46500
"TR","2007-09-06",2007,9,249,0,23700,22300,46000
"TR","2007-09-07",2007,9,250,0,23000,22500,45500
"TR","2007-09-08",2007,9,251,1670,22600,22600,46870
"TR","2007-09-09",2007,9,252,7950,22500,22600,53050
"TR","2007-09-10",2007,9,253,0,22300,22500,44800
"TR","2007-09-11",2007,9,254,0,22200,22500,44700
"TR","2007-09-12",2007,9,255,25800,22700,22400,70900
"TR","2007-09-13",2007,9,256,0,22600,22200,44800
"TR","2007-09-14",2007,9,257,3820,22700,22200,48720
"TR","2007-09-15",2007,9,258,71900,23900,22100,117900
"TR","2007-09-16",2007,9,259,27500,24500,21700,73700
"TR","2007-09-17",2007,9,260,0,24300,21600,45900
"TR","2007-09-18",2007,9,261,0,24100,21600,45700
"TR","2007-09-19",2007,9,262,9240,23900,21700,54840
"TR","2007-09-20",2007,9,263,316000,29400,21700,367100
"TR","2007-09-21",2007,9,264,0,27000,20500,47500
"TR","2007-09-22",2007,9,265,262000,31400,20800,314200
"TR","2007-09-23",2007,9,266,119000,31900,19900,170800
"TR","2007-09-24",2007,9,267,0,30700,19700,50400
"TR","2007-09-25",2007,9,268,0,30200,20000,50200
"TR","2007-09-26",2007,9,269,245000,35000,20000,3e+05
"TR","2007-09-27",2007,9,270,8680,33200,19400,61280
"TR","2007-09-28",2007,9,271,11100,32600,19900,63600
"TR","2007-09-29",2007,9,272,16800,32200,20100,69100
"TR","2007-09-30",2007,9,273,0,31500,20200,51700
"TR","2007-10-01",2007,10,274,34800,31500,20400,86700
"TR","2007-10-02",2007,10,275,333000,38300,29100,400400
"TR","2007-10-03",2007,10,276,6100,35600,19900,61600
"TR","2007-10-04",2007,10,277,520000,50300,47700,618000
"TR","2007-10-05",2007,10,278,0,42000,18900,60900
"TR","2007-10-06",2007,10,279,159000,46800,23500,229300
"TR","2007-10-07",2007,10,280,641000,81100,69500,791600
"TR","2007-10-08",2007,10,281,19300,70000,22400,111700
"TR","2007-10-09",2007,10,282,55200,65100,18100,138400
"TR","2007-10-10",2007,10,283,67700,62600,21900,152200
"TR","2007-10-11",2007,10,284,64700,60700,22300,147700
"TR","2007-10-12",2007,10,285,33500,56900,21100,111500
"TR","2007-10-13",2007,10,286,0,52000,18500,70500
"TR","2007-10-14",2007,10,287,0,48500,18800,67300
"TR","2007-10-15",2007,10,288,0,45700,19000,64700
"TR","2007-10-16",2007,10,289,42300,45700,19200,107200
"TR","2007-10-17",2007,10,290,89500,48400,20600,158500
"TR","2007-10-18",2007,10,291,136000,53500,29300,218800
"TR","2007-10-19",2007,10,292,156000,58800,31200,246000
"TR","2007-10-20",2007,10,293,310000,72600,41500,424100
"TR","2007-10-21",2007,10,294,95500,68200,26800,190500
"TR","2007-10-22",2007,10,295,0,61200,19500,80700
"TR","2007-10-23",2007,10,296,18300,56400,19000,93700
"TR","2007-10-24",2007,10,297,0,52100,19300,71400
"TR","2007-10-25",2007,10,298,79700,53000,20100,152800
"TR","2007-10-26",2007,10,299,0,49800,20000,69800
"TR","2007-10-27",2007,10,300,0,47100,20400,67500
"TR","2007-10-28",2007,10,301,5510,45200,20800,71510
"TR","2007-10-29",2007,10,302,4010,43900,20900,68810
"TR","2007-10-30",2007,10,303,0,43400,21100,64500
"TR","2007-10-31",2007,10,304,0,42900,21300,64200
"TR","2007-11-01",2007,11,305,16100,42800,21500,80400
"TR","2007-11-02",2007,11,306,9560,42300,21500,73360
"TR","2007-11-03",2007,11,307,0,41900,21500,63400
"TR","2007-11-04",2007,11,308,0,41500,21600,63100
"TR","2007-11-05",2007,11,309,5060,41300,21600,67960
"TR","2007-11-06",2007,11,310,47000,42000,21600,110600
"TR","2007-11-07",2007,11,311,86500,42400,21400,150300
"TR","2007-11-08",2007,11,312,0,41900,21500,63400
"TR","2007-11-09",2007,11,313,0,41500,21700,63200
"TR","2007-11-10",2007,11,314,0,41200,21900,63100
"TR","2007-11-11",2007,11,315,0,40900,22100,63000
"TR","2007-11-12",2007,11,316,22400,40800,22200,85400
"TR","2007-11-13",2007,11,317,0,40100,22200,62300
"TR","2007-11-14",2007,11,318,0,39500,22200,61700
"TR","2007-11-15",2007,11,319,0,39100,22200,61300
"TR","2007-11-16",2007,11,320,66600,40200,22100,128900
"TR","2007-11-17",2007,11,321,5060,39900,22000,66960
"TR","2007-11-18",2007,11,322,0,39600,22100,61700
"TR","2007-11-19",2007,11,323,0,39200,22100,61300
"TR","2007-11-20",2007,11,324,68000,39500,21800,129300
"TR","2007-11-21",2007,11,325,0,39300,21900,61200
"TR","2007-11-22",2007,11,326,4010,39700,22300,66010
"TR","2007-11-23",2007,11,327,22300,39200,22200,83700
"TR","2007-11-24",2007,11,328,2160,39000,22200,63360
"TR","2007-11-25",2007,11,329,2160,38900,22200,63260
"TR","2007-11-26",2007,11,330,2160,38800,22200,63160
"TR","2007-11-27",2007,11,331,0,38400,22300,60700
"TR","2007-11-28",2007,11,332,47400,38500,22000,107900
"TR","2007-11-29",2007,11,333,4320,38500,21900,64720
"TR","2007-11-30",2007,11,334,0,38400,22000,60400
"TR","2007-12-01",2007,12,335,0,38400,22000,60400
"TR","2007-12-02",2007,12,336,0,38300,22000,60300
"TR","2007-12-03",2007,12,337,191000,39400,21300,251700
"TR","2007-12-04",2007,12,338,22900,39400,21100,83400
"TR","2007-12-05",2007,12,339,2250,39300,21300,62850
"TR","2007-12-06",2007,12,340,5970,39200,21400,66570
"TR","2007-12-07",2007,12,341,0,39000,21500,60500
"TR","2007-12-08",2007,12,342,4670,38900,21500,65070
"TR","2007-12-09",2007,12,343,0,38700,21600,60300
"TR","2007-12-10",2007,12,344,0,38600,21600,60200
"TR","2007-12-11",2007,12,345,0,38400,21700,60100
"TR","2007-12-12",2007,12,346,0,38300,21700,60000
"TR","2007-12-13",2007,12,347,0,38100,21700,59800
"TR","2007-12-14",2007,12,348,0,38000,21700,59700
"TR","2007-12-15",2007,12,349,0,37900,21700,59600
"TR","2007-12-16",2007,12,350,0,37800,21800,59600
"TR","2007-12-17",2007,12,351,0,37700,21800,59500
"TR","2007-12-18",2007,12,352,1120,37600,21800,60520
"TR","2007-12-19",2007,12,353,0,37500,21800,59300
"TR","2007-12-20",2007,12,354,1120,37400,21800,60320
"TR","2007-12-21",2007,12,355,0,37300,21800,59100
"TR","2007-12-22",2007,12,356,1210,37200,21800,60210
"TR","2007-12-23",2007,12,357,70800,37700,21500,130000
"TR","2007-12-24",2007,12,358,134000,38300,20900,193200
"TR","2007-12-25",2007,12,359,96100,38800,20500,155400
"TR","2007-12-26",2007,12,360,22000,38800,20500,81300
"TR","2007-12-27",2007,12,361,89800,39200,20400,149400
"TR","2007-12-28",2007,12,362,71100,39400,20200,130700
"TR","2007-12-29",2007,12,363,0,39200,20300,59500
"TR","2007-12-30",2007,12,364,13900,39000,20500,73400
"TR","2007-12-31",2007,12,365,12000,38800,20500,71300
"TR","2008-01-01",2008,1,1,0,38600,20700,59300
"TR","2008-01-02",2008,1,2,5630,38400,20800,64830
"TR","2008-01-03",2008,1,3,3750,38200,20800,62750
"TR","2008-01-04",2008,1,4,0,38100,20900,59000
"TR","2008-01-05",2008,1,5,0,37900,21000,58900
"TR","2008-01-06",2008,1,6,0,37700,21000,58700
"TR","2008-01-07",2008,1,7,2020,37500,21100,60620
"TR","2008-01-08",2008,1,8,0,37300,21200,58500
"TR","2008-01-09",2008,1,9,88300,37800,20800,146900
"TR","2008-01-10",2008,1,10,0,37600,20800,58400
"TR","2008-01-11",2008,1,11,0,37400,20900,58300
"TR","2008-01-12",2008,1,12,0,37200,21000,58200
"TR","2008-01-13",2008,1,13,31100,37200,20900,89200
"TR","2008-01-14",2008,1,14,23100,37200,20900,81200
"TR","2008-01-15",2008,1,15,13300,37000,20900,71200
"TR","2008-01-16",2008,1,16,12400,37000,20900,70300
"TR","2008-01-17",2008,1,17,0,36800,21000,57800
"TR","2008-01-18",2008,1,18,45300,36900,20800,103000
"TR","2008-01-19",2008,1,19,114000,37500,20300,171800
"TR","2008-01-20",2008,1,20,0,37400,20300,57700
"TR","2008-01-21",2008,1,21,0,37200,20500,57700
"TR","2008-01-22",2008,1,22,0,37000,20600,57600
"TR","2008-01-23",2008,1,23,0,36800,20700,57500
"TR","2008-01-24",2008,1,24,0,36700,20800,57500
"TR","2008-01-25",2008,1,25,0,36500,20800,57300
"TR","2008-01-26",2008,1,26,0,36300,20900,57200
"TR","2008-01-27",2008,1,27,0,36200,20900,57100
"TR","2008-01-28",2008,1,28,0,36000,20900,56900
"TR","2008-01-29",2008,1,29,0,35900,21000,56900
"TR","2008-01-30",2008,1,30,54500,36000,20700,111200
"TR","2008-01-31",2008,1,31,66500,36400,20400,123300
"TR","2008-02-01",2008,2,32,0,36300,20500,56800
"TR","2008-02-02",2008,2,33,0,36100,20600,56700
"TR","2008-02-03",2008,2,34,6400,36000,20600,63000
"TR","2008-02-04",2008,2,35,33500,36000,20600,90100
"TR","2008-02-05",2008,2,36,2850,35900,20600,59350
"TR","2008-02-06",2008,2,37,12600,35800,20600,69000
"TR","2008-02-07",2008,2,38,0,35600,20700,56300
"TR","2008-02-08",2008,2,39,0,35500,20700,56200
"TR","2008-02-09",2008,2,40,0,35300,20700,56000
"TR","2008-02-10",2008,2,41,2850,35200,20800,58850
"TR","2008-02-11",2008,2,42,2250,35100,20800,58150
"TR","2008-02-12",2008,2,43,0,35000,20800,55800
"TR","2008-02-13",2008,2,44,0,34800,20800,55600
"TR","2008-02-14",2008,2,45,34200,35000,20700,89900
"TR","2008-02-15",2008,2,46,53500,35200,20400,109100
"TR","2008-02-16",2008,2,47,0,35100,20400,55500
"TR","2008-02-17",2008,2,48,0,35000,20500,55500
"TR","2008-02-18",2008,2,49,11400,34900,20500,66800
"TR","2008-02-19",2008,2,50,61500,35100,20300,116900
"TR","2008-02-20",2008,2,51,1270,35000,20300,56570
"TR","2008-02-21",2008,2,52,0,34900,20400,55300
"TR","2008-02-22",2008,2,53,0,34700,20500,55200
"TR","2008-02-23",2008,2,54,0,34600,20500,55100
"TR","2008-02-24",2008,2,55,0,34400,20500,54900
"TR","2008-02-25",2008,2,56,0,34300,20600,54900
"TR","2008-02-26",2008,2,57,0,34100,20600,54700
"TR","2008-02-27",2008,2,58,2250,34000,20600,56850
"TR","2008-02-28",2008,2,59,0,33900,20600,54500
"TR","2008-02-29",2008,2,60,2130,33800,20600,56530
"TR","2008-03-01",2008,3,61,14200,33800,20600,68600
"TR","2008-03-02",2008,3,62,43300,33900,20400,97600
"TR","2008-03-03",2008,3,63,0,33700,20400,54100
"TR","2008-03-04",2008,3,64,23700,33700,20400,77800
"TR","2008-03-05",2008,3,65,0,33600,20400,54000
"TR","2008-03-06",2008,3,66,2610,33500,20500,56610
"TR","2008-03-07",2008,3,67,0,33300,20500,53800
"TR","2008-03-08",2008,3,68,0,33200,20500,53700
"TR","2008-03-09",2008,3,69,0,33100,20500,53600
"TR","2008-03-10",2008,3,70,0,33000,20500,53500
"TR","2008-03-11",2008,3,71,0,32900,20500,53400
"TR","2008-03-12",2008,3,72,0,32800,20600,53400
"TR","2008-03-13",2008,3,73,68000,33400,20300,121700
"TR","2008-03-14",2008,3,74,109000,34000,19800,162800
"TR","2008-03-15",2008,3,75,0,33700,19900,53600
"TR","2008-03-16",2008,3,76,0,33500,20000,53500
"TR","2008-03-17",2008,3,77,0,33300,20200,53500
"TR","2008-03-18",2008,3,78,10500,33200,20200,63900
"TR","2008-03-19",2008,3,79,75700,33600,19900,129200
"TR","2008-03-20",2008,3,80,16000,33400,19900,69300
"TR","2008-03-21",2008,3,81,0,33100,20100,53200
"TR","2008-03-22",2008,3,82,0,32900,20200,53100
"TR","2008-03-23",2008,3,83,0,32700,20300,53000
"TR","2008-03-24",2008,3,84,0,32400,20400,52800
"TR","2008-03-25",2008,3,85,22200,32500,20300,75000
"TR","2008-03-26",2008,3,86,30700,32500,20200,83400
"TR","2008-03-27",2008,3,87,0,32300,20300,52600
"TR","2008-03-28",2008,3,88,0,32100,20400,52500
"TR","2008-03-29",2008,3,89,0,31900,20400,52300
"TR","2008-03-30",2008,3,90,0,31600,20500,52100
"TR","2008-03-31",2008,3,91,0,31400,20600,52000
"TR","2008-04-01",2008,4,92,56200,31800,20400,108400
"TR","2008-04-02",2008,4,93,220000,33100,19500,272600
"TR","2008-04-03",2008,4,94,0,33000,19400,52400
"TR","2008-04-04",2008,4,95,0,32800,19600,52400
"TR","2008-04-05",2008,4,96,0,32500,19800,52300
"TR","2008-04-06",2008,4,97,0,32400,19900,52300
"TR","2008-04-07",2008,4,98,12500,38900,32500,83900
"TR","2008-04-08",2008,4,99,84800,65600,158000,308400
"TR","2008-04-09",2008,4,100,218000,44300,28900,291200
"TR","2008-04-10",2008,4,101,60700,43400,25300,129400
"TR","2008-04-11",2008,4,102,72000,43900,24400,140300
"TR","2008-04-12",2008,4,103,281000,48400,27800,357200
"TR","2008-04-13",2008,4,104,156000,48200,19900,224100
"TR","2008-04-14",2008,4,105,0,45300,18600,63900
"TR","2008-04-15",2008,4,106,0,43300,19000,62300
"TR","2008-04-16",2008,4,107,0,43000,19400,62400
"TR","2008-04-17",2008,4,108,0,45200,31100,76300
"TR","2008-04-18",2008,4,109,67700,86900,136000,290600
"TR","2008-04-19",2008,4,110,115000,85800,67500,268300
"TR","2008-04-20",2008,4,111,124000,80200,41800,246000
"TR","2008-04-21",2008,4,112,35000,75200,22500,132700
"TR","2008-04-22",2008,4,113,46100,70300,21400,137800
"TR","2008-04-23",2008,4,114,49800,64700,21500,136000
"TR","2008-04-24",2008,4,115,32100,59900,21800,113800
"TR","2008-04-25",2008,4,116,35500,57000,22200,114700
"TR","2008-04-26",2008,4,117,69300,56400,22700,148400
"TR","2008-04-27",2008,4,118,113000,57900,26100,197000
"TR","2008-04-28",2008,4,119,4820,53200,22500,80520
"TR","2008-04-29",2008,4,120,0,50100,22700,72800
"TR","2008-04-30",2008,4,121,0,47700,23000,70700
"TR","2008-05-01",2008,5,122,0,45700,23200,68900
"TR","2008-05-02",2008,5,123,82200,48000,23800,154000
"TR","2008-05-03",2008,5,124,381000,74600,39700,495300
"TR","2008-05-04",2008,5,125,504000,93400,58900,656300
"TR","2008-05-05",2008,5,126,27500,77400,24700,129600
"TR","2008-05-06",2008,5,127,0,69300,22000,91300
"TR","2008-05-07",2008,5,128,0,62700,22800,85500
"TR","2008-05-08",2008,5,129,41100,59100,23400,123600
"TR","2008-05-09",2008,5,130,0,54500,23500,78000
"TR","2008-05-10",2008,5,131,0,50900,23900,74800
"TR","2008-05-11",2008,5,132,0,47700,24200,71900
"TR","2008-05-12",2008,5,133,0,45400,24300,69700
"TR","2008-05-13",2008,5,134,0,44600,24500,69100
"TR","2008-05-14",2008,5,135,8400,44100,24700,77200
"TR","2008-05-15",2008,5,136,11400,43500,24800,79700
"TR","2008-05-16",2008,5,137,0,42800,25000,67800
"TR","2008-05-17",2008,5,138,13600,42000,25200,80800
"TR","2008-05-18",2008,5,139,44300,41900,25400,111600
"TR","2008-05-19",2008,5,140,41900,41800,25300,109000
"TR","2008-05-20",2008,5,141,15700,41500,25200,82400
"TR","2008-05-21",2008,5,142,0,41000,25300,66300
"TR","2008-05-22",2008,5,143,0,40600,25500,66100
"TR","2008-05-23",2008,5,144,0,40100,25600,65700
"TR","2008-05-24",2008,5,145,0,39700,25700,65400
"TR","2008-05-25",2008,5,146,9800,39200,25800,74800
"TR","2008-05-26",2008,5,147,154000,41600,26200,221800
"TR","2008-05-27",2008,5,148,350000,47200,26400,423600
"TR","2008-05-28",2008,5,149,0,43200,24900,68100
"TR","2008-05-29",2008,5,150,0,42000,25300,67300
"TR","2008-05-30",2008,5,151,96600,43100,25900,165600
"TR","2008-05-31",2008,5,152,339000,51400,26900,417300
"TR","2008-06-01",2008,6,153,4780,45600,24700,75080
"TR","2008-06-02",2008,6,154,8380,44100,25100,77580
"TR","2008-06-03",2008,6,155,14500,43400,25500,83400
"TR","2008-06-04",2008,6,156,16000,42700,25600,84300
"TR","2008-06-05",2008,6,157,1400,41800,25700,68900
"TR","2008-06-06",2008,6,158,99800,43100,26000,168900
"TR","2008-06-07",2008,6,159,386000,54500,27100,467600
"TR","2008-06-08",2008,6,160,3260,45900,24900,74060
"TR","2008-06-09",2008,6,161,43700,45000,25400,114100
"TR","2008-06-10",2008,6,162,102000,45900,25900,173800
"TR","2008-06-11",2008,6,163,37700,44900,25700,108300
"TR","2008-06-12",2008,6,164,67600,45800,26000,139400
"TR","2008-06-13",2008,6,165,306000,58300,27300,391600
"TR","2008-06-14",2008,6,166,31000,51500,25000,107500
"TR","2008-06-15",2008,6,167,2790,47600,25200,75590
"TR","2008-06-16",2008,6,168,13000,45000,25400,83400
"TR","2008-06-17",2008,6,169,58200,44700,25700,128600
"TR","2008-06-18",2008,6,170,0,43500,25400,68900
"TR","2008-06-19",2008,6,171,0,42800,25500,68300
"TR","2008-06-20",2008,6,172,8380,42100,25600,76080
"TR","2008-06-21",2008,6,173,32900,41900,25600,100400
"TR","2008-06-22",2008,6,174,262000,47000,26200,335200
"TR","2008-06-23",2008,6,175,297000,53800,26300,377100
"TR","2008-06-24",2008,6,176,11900,46600,24700,83200
"TR","2008-06-25",2008,6,177,0,44600,25000,69600
"TR","2008-06-26",2008,6,178,0,43600,25300,68900
"TR","2008-06-27",2008,6,179,0,42500,25300,67800
"TR","2008-06-28",2008,6,180,32100,42000,25400,99500
"TR","2008-06-29",2008,6,181,105000,43100,25700,173800
"TR","2008-06-30",2008,6,182,178000,45000,26200,249200
"TR","2008-07-01",2008,7,183,9360,43400,25400,78160
"TR","2008-07-02",2008,7,184,0,42000,25400,67400
"TR","2008-07-03",2008,7,185,13500,40900,25300,79700
"TR","2008-07-04",2008,7,186,0,39900,25100,65000
"TR","2008-07-05",2008,7,187,0,38900,25100,64000
"TR","2008-07-06",2008,7,188,0,37900,25100,63000
"TR","2008-07-07",2008,7,189,7080,37200,25100,69380
"TR","2008-07-08",2008,7,190,10900,36500,25000,72400
"TR","2008-07-09",2008,7,191,249000,40300,25100,314400
"TR","2008-07-10",2008,7,192,0,37800,24100,61900
"TR","2008-07-11",2008,7,193,0,36600,24300,60900
"TR","2008-07-12",2008,7,194,9940,35800,24400,70140
"TR","2008-07-13",2008,7,195,269000,40000,24800,333800
"TR","2008-07-14",2008,7,196,4200,37800,23700,65700
"TR","2008-07-15",2008,7,197,23900,37300,24000,85200
"TR","2008-07-16",2008,7,198,138000,38800,24300,201100
"TR","2008-07-17",2008,7,199,13200,37400,23900,74500
"TR","2008-07-18",2008,7,200,118000,39000,24300,181300
"TR","2008-07-19",2008,7,201,321000,43800,25000,389800
"TR","2008-07-20",2008,7,202,0,39900,23200,63100
"TR","2008-07-21",2008,7,203,36400,39300,23600,99300
"TR","2008-07-22",2008,7,204,8700,38200,23700,70600
"TR","2008-07-23",2008,7,205,0,37200,23700,60900
"TR","2008-07-24",2008,7,206,0,36200,23900,60100
"TR","2008-07-25",2008,7,207,5310,35000,24000,64310
"TR","2008-07-26",2008,7,208,88400,36000,24000,148400
"TR","2008-07-27",2008,7,209,2800,35000,23700,61500
"TR","2008-07-28",2008,7,210,0,34200,23800,58000
"TR","2008-07-29",2008,7,211,0,33600,23900,57500
"TR","2008-07-30",2008,7,212,161000,36200,24100,221300
"TR","2008-07-31",2008,7,213,75400,36100,23600,135100
"TR","2008-08-01",2008,8,214,0,34900,23400,58300
"TR","2008-08-02",2008,8,215,14800,34200,23800,72800
"TR","2008-08-03",2008,8,216,0,33300,24100,57400
"TR","2008-08-04",2008,8,217,14600,32800,24300,71700
"TR","2008-08-05",2008,8,218,67300,33200,24500,125000
"TR","2008-08-06",2008,8,219,0,32300,24400,56700
"TR","2008-08-07",2008,8,220,18600,31900,24700,75200
"TR","2008-08-08",2008,8,221,50500,32100,24700,107300
"TR","2008-08-09",2008,8,222,0,31400,24600,56000
"TR","2008-08-10",2008,8,223,0,30800,24800,55600
"TR","2008-08-11",2008,8,224,0,30000,25100,55100
"TR","2008-08-12",2008,8,225,0,29300,25300,54600
"TR","2008-08-13",2008,8,226,0,28600,25500,54100
"TR","2008-08-14",2008,8,227,1330,28300,25500,55130
"TR","2008-08-15",2008,8,228,0,28100,25400,53500
"TR","2008-08-16",2008,8,229,0,27600,25600,53200
"TR","2008-08-17",2008,8,230,0,26900,25800,52700
"TR","2008-08-18",2008,8,231,277000,30800,26100,333900
"TR","2008-08-19",2008,8,232,0,29300,24900,54200
"TR","2008-08-20",2008,8,233,0,28500,25300,53800
"TR","2008-08-21",2008,8,234,0,27900,25400,53300
"TR","2008-08-22",2008,8,235,0,27600,25400,53000
"TR","2008-08-23",2008,8,236,53600,28100,25400,107100
"TR","2008-08-24",2008,8,237,41300,28300,25300,94900
"TR","2008-08-25",2008,8,238,0,27800,25100,52900
"TR","2008-08-26",2008,8,239,0,27400,25300,52700
"TR","2008-08-27",2008,8,240,0,26900,25400,52300
"TR","2008-08-28",2008,8,241,0,26100,25600,51700
"TR","2008-08-29",2008,8,242,193000,29800,25500,248300
"TR","2008-08-30",2008,8,243,26600,29200,24700,80500
"TR","2008-08-31",2008,8,244,0,28300,24900,53200
"TR","2008-09-01",2008,9,245,0,27700,25100,52800
"TR","2008-09-02",2008,9,246,0,27200,25300,52500
"TR","2008-09-03",2008,9,247,0,26700,25400,52100
"TR","2008-09-04",2008,9,248,99900,28000,25400,153300
"TR","2008-09-05",2008,9,249,0,27500,24900,52400
"TR","2008-09-06",2008,9,250,0,27300,25000,52300
"TR","2008-09-07",2008,9,251,29500,27400,25000,81900
"TR","2008-09-08",2008,9,252,4760,27200,24900,56860
"TR","2008-09-09",2008,9,253,102000,28700,24900,155600
"TR","2008-09-10",2008,9,254,3680,28300,24500,56480
"TR","2008-09-11",2008,9,255,0,28000,24500,52500
"TR","2008-09-12",2008,9,256,0,27800,24600,52400
"TR","2008-09-13",2008,9,257,245000,31800,24800,301600
"TR","2008-09-14",2008,9,258,0,30300,23800,54100
"TR","2008-09-15",2008,9,259,491000,41100,24800,556900
"TR","2008-09-16",2008,9,260,5940,36200,22300,64440
"TR","2008-09-17",2008,9,261,0,35400,22700,58100
"TR","2008-09-18",2008,9,262,0,34800,23100,57900
"TR","2008-09-19",2008,9,263,0,34100,23600,57700
"TR","2008-09-20",2008,9,264,0,33500,23700,57200
"TR","2008-09-21",2008,9,265,0,32800,23900,56700
"TR","2008-09-22",2008,9,266,0,32200,24000,56200
"TR","2008-09-23",2008,9,267,0,31700,24000,55700
"TR","2008-09-24",2008,9,268,0,31100,24100,55200
"TR","2008-09-25",2008,9,269,115000,32900,23900,171800
"TR","2008-09-26",2008,9,270,0,32300,23500,55800
"TR","2008-09-27",2008,9,271,0,31900,23700,55600
"TR","2008-09-28",2008,9,272,81300,33100,23600,138000
"TR","2008-09-29",2008,9,273,0,32600,23400,56000
"TR","2008-09-30",2008,9,274,0,32100,23600,55700
"TR","2008-10-01",2008,10,275,36500,32200,23600,92300
"TR","2008-10-02",2008,10,276,18500,32100,23600,74200
"TR","2008-10-03",2008,10,277,89500,33600,23500,146600
"TR","2008-10-04",2008,10,278,22500,33600,23300,79400
"TR","2008-10-05",2008,10,279,0,33100,23200,56300
"TR","2008-10-06",2008,10,280,0,32600,23400,56000
"TR","2008-10-07",2008,10,281,127000,35000,23500,185500
"TR","2008-10-08",2008,10,282,83500,36000,23200,142700
"TR","2008-10-09",2008,10,283,191000,39900,23600,254500
"TR","2008-10-10",2008,10,284,3470,37400,22300,63170
"TR","2008-10-11",2008,10,285,0,36400,22300,58700
"TR","2008-10-12",2008,10,286,6940,36000,22500,65440
"TR","2008-10-13",2008,10,287,0,35500,22700,58200
"TR","2008-10-14",2008,10,288,0,35300,22800,58100
"TR","2008-10-15",2008,10,289,57000,36200,22700,115900
"TR","2008-10-16",2008,10,290,1020,35800,22600,59420
"TR","2008-10-17",2008,10,291,0,35100,22600,57700
"TR","2008-10-18",2008,10,292,0,34700,22700,57400
"TR","2008-10-19",2008,10,293,0,34500,22600,57100
"TR","2008-10-20",2008,10,294,0,34200,22600,56800
"TR","2008-10-21",2008,10,295,14700,34300,22600,71600
"TR","2008-10-22",2008,10,296,0,33800,22600,56400
"TR","2008-10-23",2008,10,297,0,33700,22600,56300
"TR","2008-10-24",2008,10,298,0,33500,22500,56000
"TR","2008-10-25",2008,10,299,9740,33500,22600,65840
"TR","2008-10-26",2008,10,300,211000,38900,23300,273200
"TR","2008-10-27",2008,10,301,19600,36700,23600,79900
"TR","2008-10-28",2008,10,302,241000,38500,25600,305100
"TR","2008-10-29",2008,10,303,35900,38100,21600,95600
"TR","2008-10-30",2008,10,304,0,37700,21700,59400
"TR","2008-10-31",2008,10,305,0,38000,23900,61900
"TR","2008-11-01",2008,11,306,0,39200,29500,68700
"TR","2008-11-02",2008,11,307,0,37800,22100,59900
"TR","2008-11-03",2008,11,308,0,37100,22000,59100
"TR","2008-11-04",2008,11,309,0,36600,21900,58500
"TR","2008-11-05",2008,11,310,0,36200,21900,58100
"TR","2008-11-06",2008,11,311,0,35900,21900,57800
"TR","2008-11-07",2008,11,312,15300,35800,21900,73000
"TR","2008-11-08",2008,11,313,52000,36500,21600,110100
"TR","2008-11-09",2008,11,314,79800,37800,21600,139200
"TR","2008-11-10",2008,11,315,53400,37400,21200,112000
"TR","2008-11-11",2008,11,316,4320,36900,21200,62420
"TR","2008-11-12",2008,11,317,0,36600,21400,58000
"TR","2008-11-13",2008,11,318,32600,36500,21400,90500
"TR","2008-11-14",2008,11,319,120000,37400,26400,183800
"TR","2008-11-15",2008,11,320,19700,40200,25800,85700
"TR","2008-11-16",2008,11,321,15200,38400,21200,74800
"TR","2008-11-17",2008,11,322,2160,37600,21200,60960
"TR","2008-11-18",2008,11,323,50900,37500,21000,109400
"TR","2008-11-19",2008,11,324,46500,37700,20800,105000
"TR","2008-11-20",2008,11,325,0,37600,20900,58500
"TR","2008-11-21",2008,11,326,19400,37500,20900,77800
"TR","2008-11-22",2008,11,327,34800,37400,20900,93100
"TR","2008-11-23",2008,11,328,0,37200,20900,58100
"TR","2008-11-24",2008,11,329,0,36900,21000,57900
"TR","2008-11-25",2008,11,330,0,36600,21100,57700
"TR","2008-11-26",2008,11,331,28700,36500,21100,86300
"TR","2008-11-27",2008,11,332,0,36200,21100,57300
"TR","2008-11-28",2008,11,333,0,36000,21100,57100
"TR","2008-11-29",2008,11,334,7100,35800,21200,64100
"TR","2008-11-30",2008,11,335,0,35700,21200,56900
"TR","2008-12-01",2008,12,336,0,35500,21200,56700
"TR","2008-12-02",2008,12,337,4670,35300,21200,61170
"TR","2008-12-03",2008,12,338,20400,35300,21100,76800
"TR","2008-12-04",2008,12,339,0,35100,21100,56200
"TR","2008-12-05",2008,12,340,0,35000,21100,56100
"TR","2008-12-06",2008,12,341,0,34800,21100,55900
"TR","2008-12-07",2008,12,342,37900,35000,21000,93900
"TR","2008-12-08",2008,12,343,18100,35000,20900,74000
"TR","2008-12-09",2008,12,344,29800,35100,20800,85700
"TR","2008-12-10",2008,12,345,39000,35200,20600,94800
"TR","2008-12-11",2008,12,346,0,35100,20700,55800
"TR","2008-12-12",2008,12,347,1210,34900,20700,56810
"TR","2008-12-13",2008,12,348,0,34800,20800,55600
"TR","2008-12-14",2008,12,349,3460,34600,20800,58860
"TR","2008-12-15",2008,12,350,38500,34800,20700,94000
"TR","2008-12-16",2008,12,351,66100,35100,20400,121600
"TR","2008-12-17",2008,12,352,0,35000,20400,55400
"TR","2008-12-18",2008,12,353,30200,35000,20400,85600
"TR","2008-12-19",2008,12,354,0,34800,20400,55200
"TR","2008-12-20",2008,12,355,0,34700,20500,55200
"TR","2008-12-21",2008,12,356,0,34500,20600,55100
"TR","2008-12-22",2008,12,357,78300,35000,20300,133600
"TR","2008-12-23",2008,12,358,2420,34800,20300,57520
"TR","2008-12-24",2008,12,359,18400,34700,20300,73400
"TR","2008-12-25",2008,12,360,37300,34900,20200,92400
"TR","2008-12-26",2008,12,361,3340,34700,20200,58240
"TR","2008-12-27",2008,12,362,78000,35100,20000,133100
"TR","2008-12-28",2008,12,363,5380,35000,20000,60380
"TR","2008-12-29",2008,12,364,12300,34900,20100,67300
"TR","2008-12-30",2008,12,365,2250,34700,20200,57150
"TR","2008-12-31",2008,12,366,0,34500,20300,54800
"TR","2009-01-01",2009,1,1,13200,34400,20300,67900
"TR","2009-01-02",2009,1,2,0,34200,20300,54500
"TR","2009-01-03",2009,1,3,0,34100,20400,54500
"TR","2009-01-04",2009,1,4,14200,34000,20400,68600
"TR","2009-01-05",2009,1,5,122000,34700,19900,176600
"TR","2009-01-06",2009,1,6,0,34500,19900,54400
"TR","2009-01-07",2009,1,7,0,34300,20000,54300
"TR","2009-01-08",2009,1,8,2020,34200,20100,56320
"TR","2009-01-09",2009,1,9,122000,35100,19700,176800
"TR","2009-01-10",2009,1,10,0,35000,19700,54700
"TR","2009-01-11",2009,1,11,0,34700,19800,54500
"TR","2009-01-12",2009,1,12,0,34500,20000,54500
"TR","2009-01-13",2009,1,13,0,34300,20100,54400
"TR","2009-01-14",2009,1,14,33100,34300,20000,87400
"TR","2009-01-15",2009,1,15,0,34100,20000,54100
"TR","2009-01-16",2009,1,16,0,34000,20100,54100
"TR","2009-01-17",2009,1,17,0,33800,20200,54000
"TR","2009-01-18",2009,1,18,61300,34100,19900,115300
"TR","2009-01-19",2009,1,19,21600,34100,19900,75600
"TR","2009-01-20",2009,1,20,17500,34100,19900,71500
"TR","2009-01-21",2009,1,21,39100,34200,19800,93100
"TR","2009-01-22",2009,1,22,0,34000,19900,53900
"TR","2009-01-23",2009,1,23,0,33800,20000,53800
"TR","2009-01-24",2009,1,24,0,33600,20100,53700
"TR","2009-01-25",2009,1,25,3900,33400,20100,57400
"TR","2009-01-26",2009,1,26,0,33300,20200,53500
"TR","2009-01-27",2009,1,27,0,33100,20200,53300
"TR","2009-01-28",2009,1,28,0,33000,20200,53200
"TR","2009-01-29",2009,1,29,0,32800,20300,53100
"TR","2009-01-30",2009,1,30,17800,32800,20200,70800
"TR","2009-01-31",2009,1,31,4390,32800,20200,57390
"TR","2009-02-01",2009,2,32,0,32600,20200,52800
"TR","2009-02-02",2009,2,33,0,32500,20300,52800
"TR","2009-02-03",2009,2,34,0,32400,20300,52700
"TR","2009-02-04",2009,2,35,0,32300,20300,52600
"TR","2009-02-05",2009,2,36,0,32200,20300,52500
"TR","2009-02-06",2009,2,37,0,32100,20400,52500
"TR","2009-02-07",2009,2,38,0,32000,20400,52400
"TR","2009-02-08",2009,2,39,0,31900,20400,52300
"TR","2009-02-09",2009,2,40,0,31800,20400,52200
"TR","2009-02-10",2009,2,41,0,31700,20400,52100
"TR","2009-02-11",2009,2,42,18300,31700,20400,70400
"TR","2009-02-12",2009,2,43,2130,32100,20500,54730
"TR","2009-02-13",2009,2,44,19600,32300,20500,72400
"TR","2009-02-14",2009,2,45,11100,32100,20300,63500
"TR","2009-02-15",2009,2,46,11000,31900,20300,63200
"TR","2009-02-16",2009,2,47,1220,31800,20300,53320
"TR","2009-02-17",2009,2,48,0,31700,20300,52000
"TR","2009-02-18",2009,2,49,0,31600,20300,51900
"TR","2009-02-19",2009,2,50,11000,31500,20300,62800
"TR","2009-02-20",2009,2,51,2130,31500,20300,53930
"TR","2009-02-21",2009,2,52,0,31400,20300,51700
"TR","2009-02-22",2009,2,53,0,31300,20300,51600
"TR","2009-02-23",2009,2,54,16500,31400,20300,68200
"TR","2009-02-24",2009,2,55,27700,31600,20200,79500
"TR","2009-02-25",2009,2,56,0,31500,20200,51700
"TR","2009-02-26",2009,2,57,9010,31400,20200,60610
"TR","2009-02-27",2009,2,58,8540,31400,20200,60140
"TR","2009-02-28",2009,2,59,57000,31700,20000,108700
"TR","2009-03-01",2009,3,60,0,31600,19900,51500
"TR","2009-03-02",2009,3,61,0,31500,20000,51500
"TR","2009-03-03",2009,3,62,0,31400,20100,51500
"TR","2009-03-04",2009,3,63,0,31300,20100,51400
"TR","2009-03-05",2009,3,64,0,31200,20200,51400
"TR","2009-03-06",2009,3,65,0,31000,20200,51200
"TR","2009-03-07",2009,3,66,0,30800,20300,51100
"TR","2009-03-08",2009,3,67,0,30500,20400,50900
"TR","2009-03-09",2009,3,68,0,30400,20500,50900
"TR","2009-03-10",2009,3,69,0,30200,20500,50700
"TR","2009-03-11",2009,3,70,8280,30100,20500,58880
"TR","2009-03-12",2009,3,71,60300,30500,20200,111000
"TR","2009-03-13",2009,3,72,0,30400,20100,50500
"TR","2009-03-14",2009,3,73,0,30400,20200,50600
"TR","2009-03-15",2009,3,74,0,30200,20200,50400
"TR","2009-03-16",2009,3,75,0,30000,20400,50400
"TR","2009-03-17",2009,3,76,0,29800,20500,50300
"TR","2009-03-18",2009,3,77,0,31100,26200,57300
"TR","2009-03-19",2009,3,78,0,32600,32000,64600
"TR","2009-03-20",2009,3,79,0,32200,27400,59600
"TR","2009-03-21",2009,3,80,0,31300,21000,52300
"TR","2009-03-22",2009,3,81,25400,31200,20700,77300
"TR","2009-03-23",2009,3,82,0,31600,21600,53200
"TR","2009-03-24",2009,3,83,0,32400,27100,59500
"TR","2009-03-25",2009,3,84,129000,34000,26100,189100
"TR","2009-03-26",2009,3,85,138000,38000,44100,220100
"TR","2009-03-27",2009,3,86,0,36300,24700,61000
"TR","2009-03-28",2009,3,87,2070,35900,21200,59170
"TR","2009-03-29",2009,3,88,0,35400,20600,56000
"TR","2009-03-30",2009,3,89,0,35000,20600,55600
"TR","2009-03-31",2009,3,90,0,34500,20700,55200
"TR","2009-04-01",2009,4,91,0,34100,21600,55700
"TR","2009-04-02",2009,4,92,379000,37800,19700,436500
"TR","2009-04-03",2009,4,93,44400,38200,19800,102400
"TR","2009-04-04",2009,4,94,0,37900,22200,60100
"TR","2009-04-05",2009,4,95,0,37500,23000,60500
"TR","2009-04-06",2009,4,96,0,37000,25000,62000
"TR","2009-04-07",2009,4,97,0,36500,22400,58900
"TR","2009-04-08",2009,4,98,0,36100,20300,56400
"TR","2009-04-09",2009,4,99,0,35800,23600,59400
"TR","2009-04-10",2009,4,100,0,35700,21400,57100
"TR","2009-04-11",2009,4,101,0,35500,20400,55900
"TR","2009-04-12",2009,4,102,0,35300,20400,55700
"TR","2009-04-13",2009,4,103,0,35100,20300,55400
"TR","2009-04-14",2009,4,104,0,34900,20300,55200
"TR","2009-04-15",2009,4,105,0,34700,20200,54900
"TR","2009-04-16",2009,4,106,0,34400,20100,54500
"TR","2009-04-17",2009,4,107,0,34000,20100,54100
"TR","2009-04-18",2009,4,108,0,33700,20100,53800
"TR","2009-04-19",2009,4,109,0,33300,20000,53300
"TR","2009-04-20",2009,4,110,23700,33400,20000,77100
"TR","2009-04-21",2009,4,111,356000,38100,19300,413400
"TR","2009-04-22",2009,4,112,321000,40300,21100,382400
"TR","2009-04-23",2009,4,113,29300,41600,27700,98600
"TR","2009-04-24",2009,4,114,0,40800,26100,66900
"TR","2009-04-25",2009,4,115,0,40600,31100,71700
"TR","2009-04-26",2009,4,116,204000,45700,32000,281700
"TR","2009-04-27",2009,4,117,3840,42500,18900,65240
"TR","2009-04-28",2009,4,118,203000,50500,29400,282900
"TR","2009-04-29",2009,4,119,0,45100,18800,63900
"TR","2009-04-30",2009,4,120,0,42600,19100,61700
"TR","2009-05-01",2009,5,121,19500,42100,19300,80900
"TR","2009-05-02",2009,5,122,26400,41800,19600,87800
"TR","2009-05-03",2009,5,123,0,40900,19600,60500
"TR","2009-05-04",2009,5,124,0,40300,19800,60100
"TR","2009-05-05",2009,5,125,0,39700,20000,59700
"TR","2009-05-06",2009,5,126,0,39000,20100,59100
"TR","2009-05-07",2009,5,127,378000,49700,30700,458400
"TR","2009-05-08",2009,5,128,42100,43300,20400,105800
"TR","2009-05-09",2009,5,129,0,41500,19800,61300
"TR","2009-05-10",2009,5,130,4780,40500,20000,65280
"TR","2009-05-11",2009,5,131,0,39400,19900,59300
"TR","2009-05-12",2009,5,132,0,38800,20000,58800
"TR","2009-05-13",2009,5,133,0,38100,20200,58300
"TR","2009-05-14",2009,5,134,6650,37500,20300,64450
"TR","2009-05-15",2009,5,135,327000,43400,21500,391900
"TR","2009-05-16",2009,5,136,0,40300,19900,60200
"TR","2009-05-17",2009,5,137,1e+05,41100,20700,161800
"TR","2009-05-18",2009,5,138,0,39300,20000,59300
"TR","2009-05-19",2009,5,139,0,38600,20300,58900
"TR","2009-05-20",2009,5,140,2390,37700,20400,60490
"TR","2009-05-21",2009,5,141,0,36800,20400,57200
"TR","2009-05-22",2009,5,142,4430,36000,20600,61030
"TR","2009-05-23",2009,5,143,69400,36100,20700,126200
"TR","2009-05-24",2009,5,144,4780,35100,20600,60480
"TR","2009-05-25",2009,5,145,0,34300,20600,54900
"TR","2009-05-26",2009,5,146,0,33500,20800,54300
"TR","2009-05-27",2009,5,147,27100,33300,20700,81100
"TR","2009-05-28",2009,5,148,175000,35800,20900,231700
"TR","2009-05-29",2009,5,149,84000,36100,20400,140500
"TR","2009-05-30",2009,5,150,0,35200,20200,55400
"TR","2009-05-31",2009,5,151,12000,34800,20400,67200
"TR","2009-06-01",2009,6,152,0,34000,20600,54600
"TR","2009-06-02",2009,6,153,157000,36200,20800,214000
"TR","2009-06-03",2009,6,154,0,35000,20300,55300
"TR","2009-06-04",2009,6,155,0,34300,20800,55100
"TR","2009-06-05",2009,6,156,0,33300,21000,54300
"TR","2009-06-06",2009,6,157,0,32600,21200,53800
"TR","2009-06-07",2009,6,158,0,31800,21400,53200
"TR","2009-06-08",2009,6,159,216000,34900,21500,272400
"TR","2009-06-09",2009,6,160,9940,33900,20700,64540
"TR","2009-06-10",2009,6,161,407000,42100,22000,471100
"TR","2009-06-11",2009,6,162,0,37600,19800,57400
"TR","2009-06-12",2009,6,163,0,36700,20300,57000
"TR","2009-06-13",2009,6,164,0,36000,20600,56600
"TR","2009-06-14",2009,6,165,0,35300,20800,56100
"TR","2009-06-15",2009,6,166,130000,36800,21200,188000
"TR","2009-06-16",2009,6,167,0,35400,20900,56300
"TR","2009-06-17",2009,6,168,0,34500,21100,55600
"TR","2009-06-18",2009,6,169,0,33700,21200,54900
"TR","2009-06-19",2009,6,170,0,33000,21300,54300
"TR","2009-06-20",2009,6,171,0,32300,21400,53700
"TR","2009-06-21",2009,6,172,0,31600,21500,53100
"TR","2009-06-22",2009,6,173,0,31100,21600,52700
"TR","2009-06-23",2009,6,174,11400,30700,21600,63700
"TR","2009-06-24",2009,6,175,0,30100,21700,51800
"TR","2009-06-25",2009,6,176,0,29600,21800,51400
"TR","2009-06-26",2009,6,177,0,29300,21900,51200
"TR","2009-06-27",2009,6,178,0,28700,22100,50800
"TR","2009-06-28",2009,6,179,0,28400,22100,50500
"TR","2009-06-29",2009,6,180,127000,30000,21900,178900
"TR","2009-06-30",2009,6,181,92700,31000,21400,145100
"TR","2009-07-01",2009,7,182,45300,31000,21100,97400
"TR","2009-07-02",2009,7,183,15600,30400,21000,67000
"TR","2009-07-03",2009,7,184,0,29700,21000,50700
"TR","2009-07-04",2009,7,185,0,29000,21000,50000
"TR","2009-07-05",2009,7,186,0,28100,21100,49200
"TR","2009-07-06",2009,7,187,0,27100,21300,48400
"TR","2009-07-07",2009,7,188,0,26300,21400,47700
"TR","2009-07-08",2009,7,189,0,25500,21400,46900
"TR","2009-07-09",2009,7,190,0,24600,21500,46100
"TR","2009-07-10",2009,7,191,0,23800,21500,45300
"TR","2009-07-11",2009,7,192,138000,26000,21400,185400
"TR","2009-07-12",2009,7,193,20300,24700,21000,66000
"TR","2009-07-13",2009,7,194,0,24200,21000,45200
"TR","2009-07-14",2009,7,195,0,23500,21100,44600
"TR","2009-07-15",2009,7,196,0,22600,21200,43800
"TR","2009-07-16",2009,7,197,212000,26700,21000,259700
"TR","2009-07-17",2009,7,198,0,25700,20100,45800
"TR","2009-07-18",2009,7,199,28800,25700,20200,74700
"TR","2009-07-19",2009,7,200,8960,25300,20200,54460
"TR","2009-07-20",2009,7,201,1510,24800,20300,46610
"TR","2009-07-21",2009,7,202,0,24300,20400,44700
"TR","2009-07-22",2009,7,203,53300,24800,20300,98400
"TR","2009-07-23",2009,7,204,0,24000,20200,44200
"TR","2009-07-24",2009,7,205,99000,25900,20200,145100
"TR","2009-07-25",2009,7,206,885,25000,19900,45785
"TR","2009-07-26",2009,7,207,109000,26200,20000,155200
"TR","2009-07-27",2009,7,208,54100,26400,19600,100100
"TR","2009-07-28",2009,7,209,0,25600,19600,45200
"TR","2009-07-29",2009,7,210,14700,25000,19800,59500
"TR","2009-07-30",2009,7,211,13900,24700,19800,58400
"TR","2009-07-31",2009,7,212,0,24100,19900,44000
"TR","2009-08-01",2009,8,213,212000,27400,19800,259200
"TR","2009-08-02",2009,8,214,10800,26500,19100,56400
"TR","2009-08-03",2009,8,215,50600,26900,19500,97000
"TR","2009-08-04",2009,8,216,38100,26800,19500,84400
"TR","2009-08-05",2009,8,217,4550,26100,19700,50350
"TR","2009-08-06",2009,8,218,0,25600,20000,45600
"TR","2009-08-07",2009,8,219,0,25200,20200,45400
"TR","2009-08-08",2009,8,220,0,24600,20300,44900
"TR","2009-08-09",2009,8,221,198000,27600,20200,245800
"TR","2009-08-10",2009,8,222,14500,26500,19700,60700
"TR","2009-08-11",2009,8,223,0,25700,20000,45700
"TR","2009-08-12",2009,8,224,0,25100,20200,45300
"TR","2009-08-13",2009,8,225,0,24300,20500,44800
"TR","2009-08-14",2009,8,226,0,23000,20900,43900
"TR","2009-08-15",2009,8,227,20000,22800,21000,63800
"TR","2009-08-16",2009,8,228,43400,23100,21100,87600
"TR","2009-08-17",2009,8,229,105000,24500,20900,150400
"TR","2009-08-18",2009,8,230,16100,24000,20600,60700
"TR","2009-08-19",2009,8,231,0,23300,20700,44000
"TR","2009-08-20",2009,8,232,0,23000,20800,43800
"TR","2009-08-21",2009,8,233,220000,26800,20700,267500
"TR","2009-08-22",2009,8,234,598000,38500,24800,661300
"TR","2009-08-23",2009,8,235,36700,33300,17800,87800
"TR","2009-08-24",2009,8,236,0,32200,18100,50300
"TR","2009-08-25",2009,8,237,0,31200,18700,49900
"TR","2009-08-26",2009,8,238,152000,32700,19200,203900
"TR","2009-08-27",2009,8,239,144000,34000,21400,199400
"TR","2009-08-28",2009,8,240,0,32400,18900,51300
"TR","2009-08-29",2009,8,241,223000,36400,23100,282500
"TR","2009-08-30",2009,8,242,239000,38900,32400,310300
"TR","2009-08-31",2009,8,243,133000,39300,25000,197300
"TR","2009-09-01",2009,9,244,0,37700,18100,55800
"TR","2009-09-02",2009,9,245,0,36800,18500,55300
"TR","2009-09-03",2009,9,246,0,35900,18900,54800
"TR","2009-09-04",2009,9,247,0,34900,19200,54100
"TR","2009-09-05",2009,9,248,0,33900,19400,53300
"TR","2009-09-06",2009,9,249,0,32900,19500,52400
"TR","2009-09-07",2009,9,250,0,32100,19700,51800
"TR","2009-09-08",2009,9,251,0,31300,19800,51100
"TR","2009-09-09",2009,9,252,0,30600,19900,50500
"TR","2009-09-10",2009,9,253,0,29900,20000,49900
"TR","2009-09-11",2009,9,254,0,29200,20100,49300
"TR","2009-09-12",2009,9,255,0,28500,20200,48700
"TR","2009-09-13",2009,9,256,0,28000,20300,48300
"TR","2009-09-14",2009,9,257,0,27400,20400,47800
"TR","2009-09-15",2009,9,258,0,26900,20500,47400
"TR","2009-09-16",2009,9,259,0,26500,20600,47100
"TR","2009-09-17",2009,9,260,0,26100,20600,46700
"TR","2009-09-18",2009,9,261,0,25700,20600,46300
"TR","2009-09-19",2009,9,262,11200,25600,20600,57400
"TR","2009-09-20",2009,9,263,0,25200,20600,45800
"TR","2009-09-21",2009,9,264,0,24800,20700,45500
"TR","2009-09-22",2009,9,265,0,24400,20700,45100
"TR","2009-09-23",2009,9,266,0,24000,20800,44800
"TR","2009-09-24",2009,9,267,11500,23900,20800,56200
"TR","2009-09-25",2009,9,268,0,23600,20700,44300
"TR","2009-09-26",2009,9,269,0,23400,20800,44200
"TR","2009-09-27",2009,9,270,54000,24800,20400,99200
"TR","2009-09-28",2009,9,271,39600,25400,20200,85200
"TR","2009-09-29",2009,9,272,106000,27100,20000,153100
"TR","2009-09-30",2009,9,273,48100,27800,19500,95400
"TR","2009-10-01",2009,10,274,1880,27600,19400,48880
"TR","2009-10-02",2009,10,275,0,27300,19600,46900
"TR","2009-10-03",2009,10,276,142000,29700,19600,191300
"TR","2009-10-04",2009,10,277,221000,33500,19400,273900
"TR","2009-10-05",2009,10,278,47700,32200,18600,98500
"TR","2009-10-06",2009,10,279,16700,31500,18800,67000
"TR","2009-10-07",2009,10,280,104000,33100,19000,156100
"TR","2009-10-08",2009,10,281,584000,48600,50400,683000
"TR","2009-10-09",2009,10,282,0,41300,18800,60100
"TR","2009-10-10",2009,10,283,0,40500,17300,57800
"TR","2009-10-11",2009,10,284,0,39700,17700,57400
"TR","2009-10-12",2009,10,285,0,38900,17900,56800
"TR","2009-10-13",2009,10,286,0,38200,18000,56200
"TR","2009-10-14",2009,10,287,65000,38300,17800,121100
"TR","2009-10-15",2009,10,288,0,37900,18000,55900
"TR","2009-10-16",2009,10,289,0,37600,18300,55900
"TR","2009-10-17",2009,10,290,11400,37300,18700,67400
"TR","2009-10-18",2009,10,291,2280,36600,18700,57580
"TR","2009-10-19",2009,10,292,0,36200,18700,54900
"TR","2009-10-20",2009,10,293,0,35800,18900,54700
"TR","2009-10-21",2009,10,294,0,35300,19000,54300
"TR","2009-10-22",2009,10,295,4830,35000,19000,58830
"TR","2009-10-23",2009,10,296,365000,44800,31100,440900
"TR","2009-10-24",2009,10,297,6350,39600,19400,65350
"TR","2009-10-25",2009,10,298,511000,46500,21900,579400
"TR","2009-10-26",2009,10,299,9890,44200,19500,73590
"TR","2009-10-27",2009,10,300,303000,101000,149000,553000
"TR","2009-10-28",2009,10,301,0,72000,19500,91500
"TR","2009-10-29",2009,10,302,0,65500,21100,86600
"TR","2009-10-30",2009,10,303,0,60200,22400,82600
"TR","2009-10-31",2009,10,304,142000,64200,28600,234800
"TR","2009-11-01",2009,11,305,16800,58000,19900,94700
"TR","2009-11-02",2009,11,306,6480,53000,17700,77180
"TR","2009-11-03",2009,11,307,2240,48900,17900,69040
"TR","2009-11-04",2009,11,308,0,45500,18100,63600
"TR","2009-11-05",2009,11,309,0,43200,18300,61500
"TR","2009-11-06",2009,11,310,0,42500,18500,61000
"TR","2009-11-07",2009,11,311,0,42000,18600,60600
"TR","2009-11-08",2009,11,312,0,41400,18800,60200
"TR","2009-11-09",2009,11,313,0,40800,18900,59700
"TR","2009-11-10",2009,11,314,0,40300,19100,59400
"TR","2009-11-11",2009,11,315,0,39800,19100,58900
"TR","2009-11-12",2009,11,316,0,39400,19300,58700
"TR","2009-11-13",2009,11,317,0,39000,19500,58500
"TR","2009-11-14",2009,11,318,0,38600,19700,58300
"TR","2009-11-15",2009,11,319,0,38200,19900,58100
"TR","2009-11-16",2009,11,320,0,37900,20000,57900
"TR","2009-11-17",2009,11,321,0,37600,20000,57600
"TR","2009-11-18",2009,11,322,0,37300,20100,57400
"TR","2009-11-19",2009,11,323,0,37100,20200,57300
"TR","2009-11-20",2009,11,324,0,36800,20300,57100
"TR","2009-11-21",2009,11,325,32500,37100,20500,90100
"TR","2009-11-22",2009,11,326,0,36400,20300,56700
"TR","2009-11-23",2009,11,327,0,36200,20400,56600
"TR","2009-11-24",2009,11,328,6740,36000,20600,63340
"TR","2009-11-25",2009,11,329,0,35800,20600,56400
"TR","2009-11-26",2009,11,330,0,35500,20700,56200
"TR","2009-11-27",2009,11,331,44500,36200,20900,101600
"TR","2009-11-28",2009,11,332,11400,35600,20500,67500
"TR","2009-11-29",2009,11,333,0,35300,20600,55900
"TR","2009-11-30",2009,11,334,23200,35500,20700,79400
"TR","2009-12-01",2009,12,335,18700,35100,20600,74400
"TR","2009-12-02",2009,12,336,15600,35500,20700,71800
"TR","2009-12-03",2009,12,337,0,35300,20500,55800
"TR","2009-12-04",2009,12,338,8040,35200,20500,63740
"TR","2009-12-05",2009,12,339,4670,35200,20500,60370
"TR","2009-12-06",2009,12,340,9310,35200,20400,64910
"TR","2009-12-07",2009,12,341,5060,35200,20400,60660
"TR","2009-12-08",2009,12,342,0,35100,20400,55500
"TR","2009-12-09",2009,12,343,0,35000,20400,55400
"TR","2009-12-10",2009,12,344,95200,35600,20000,150800
"TR","2009-12-11",2009,12,345,58500,36000,19700,114200
"TR","2009-12-12",2009,12,346,2840,35900,19700,58440
"TR","2009-12-13",2009,12,347,0,35700,19800,55500
"TR","2009-12-14",2009,12,348,0,35600,19900,55500
"TR","2009-12-15",2009,12,349,69800,35900,19600,125300
"TR","2009-12-16",2009,12,350,18200,35900,19500,73600
"TR","2009-12-17",2009,12,351,0,35800,19600,55400
"TR","2009-12-18",2009,12,352,0,35600,19700,55300
"TR","2009-12-19",2009,12,353,0,35500,19700,55200
"TR","2009-12-20",2009,12,354,0,35400,19800,55200
"TR","2009-12-21",2009,12,355,1210,35200,19800,56210
"TR","2009-12-22",2009,12,356,7840,35200,19800,62840
"TR","2009-12-23",2009,12,357,5880,35100,19800,60780
"TR","2009-12-24",2009,12,358,0,35000,19800,54800
"TR","2009-12-25",2009,12,359,60400,35200,19500,115100
"TR","2009-12-26",2009,12,360,74800,35600,19200,129600
"TR","2009-12-27",2009,12,361,33400,35700,19100,88200
"TR","2009-12-28",2009,12,362,3880,35500,19200,58580
"TR","2009-12-29",2009,12,363,24600,35500,19200,79300
"TR","2009-12-30",2009,12,364,0,35400,19300,54700
"TR","2009-12-31",2009,12,365,0,35200,19300,54500
"TR","2010-01-01",2010,1,1,0,35100,19400,54500
"TR","2010-01-02",2010,1,2,110000,35900,19000,164900
"TR","2010-01-03",2010,1,3,0,35700,19000,54700
"TR","2010-01-04",2010,1,4,0,35600,19100,54700
"TR","2010-01-05",2010,1,5,4050,35400,19200,58650
"TR","2010-01-06",2010,1,6,10100,35300,19200,64600
"TR","2010-01-07",2010,1,7,0,35200,19200,54400
"TR","2010-01-08",2010,1,8,0,35000,19300,54300
"TR","2010-01-09",2010,1,9,4050,34900,19300,58250
"TR","2010-01-10",2010,1,10,3550,34700,19400,57650
"TR","2010-01-11",2010,1,11,0,34600,19400,54000
"TR","2010-01-12",2010,1,12,55500,34800,19200,109500
"TR","2010-01-13",2010,1,13,0,34700,19200,53900
"TR","2010-01-14",2010,1,14,0,34500,19300,53800
"TR","2010-01-15",2010,1,15,0,34300,19300,53600
"TR","2010-01-16",2010,1,16,0,34200,19400,53600
"TR","2010-01-17",2010,1,17,0,34000,19400,53400
"TR","2010-01-18",2010,1,18,0,33800,19500,53300
"TR","2010-01-19",2010,1,19,0,33700,19500,53200
"TR","2010-01-20",2010,1,20,0,33500,19500,53000
"TR","2010-01-21",2010,1,21,0,33400,19500,52900
"TR","2010-01-22",2010,1,22,0,33300,19500,52800
"TR","2010-01-23",2010,1,23,0,33200,19600,52800
"TR","2010-01-24",2010,1,24,0,33000,19600,52600
"TR","2010-01-25",2010,1,25,65400,33400,19300,118100
"TR","2010-01-26",2010,1,26,202000,34800,18500,255300
"TR","2010-01-27",2010,1,27,34900,34800,18300,88000
"TR","2010-01-28",2010,1,28,0,34700,18500,53200
"TR","2010-01-29",2010,1,29,0,34500,18600,53100
"TR","2010-01-30",2010,1,30,0,34300,18800,53100
"TR","2010-01-31",2010,1,31,0,34100,18800,52900
"TR","2010-02-01",2010,2,32,0,33900,18900,52800
"TR","2010-02-02",2010,2,33,0,33800,19000,52800
"TR","2010-02-03",2010,2,34,0,33600,19000,52600
"TR","2010-02-04",2010,2,35,10400,33500,19000,62900
"TR","2010-02-05",2010,2,36,0,33400,19000,52400
"TR","2010-02-06",2010,2,37,0,33200,19100,52300
"TR","2010-02-07",2010,2,38,0,33100,19100,52200
"TR","2010-02-08",2010,2,39,0,32900,19100,52000
"TR","2010-02-09",2010,2,40,0,32800,19200,52000
"TR","2010-02-10",2010,2,41,5900,32700,19200,57800
"TR","2010-02-11",2010,2,42,26100,32800,19100,78000
"TR","2010-02-12",2010,2,43,0,32700,19100,51800
"TR","2010-02-13",2010,2,44,0,32600,19100,51700
"TR","2010-02-14",2010,2,45,0,32500,19100,51600
"TR","2010-02-15",2010,2,46,0,32400,19200,51600
"TR","2010-02-16",2010,2,47,57400,32700,18900,109000
"TR","2010-02-17",2010,2,48,4980,32600,18900,56480
"TR","2010-02-18",2010,2,49,0,32500,19000,51500
"TR","2010-02-19",2010,2,50,0,32400,19000,51400
"TR","2010-02-20",2010,2,51,0,32200,19100,51300
"TR","2010-02-21",2010,2,52,0,32100,19100,51200
"TR","2010-02-22",2010,2,53,0,32000,19100,51100
"TR","2010-02-23",2010,2,54,0,31900,19100,51000
"TR","2010-02-24",2010,2,55,0,31700,19200,50900
"TR","2010-02-25",2010,2,56,12900,31700,19100,63700
"TR","2010-02-26",2010,2,57,2250,31700,19100,53050
"TR","2010-02-27",2010,2,58,0,31600,19100,50700
"TR","2010-02-28",2010,2,59,0,31500,19100,50600
"TR","2010-03-01",2010,3,60,1220,31400,19200,51820
"TR","2010-03-02",2010,3,61,0,31200,19200,50400
"TR","2010-03-03",2010,3,62,0,31100,19200,50300
"TR","2010-03-04",2010,3,63,0,30900,19300,50200
"TR","2010-03-05",2010,3,64,0,30700,19400,50100
"TR","2010-03-06",2010,3,65,0,30500,19400,49900
"TR","2010-03-07",2010,3,66,0,30300,19500,49800
"TR","2010-03-08",2010,3,67,0,30100,19600,49700
"TR","2010-03-09",2010,3,68,0,30400,19700,50100
"TR","2010-03-10",2010,3,69,0,31300,20200,51500
"TR","2010-03-11",2010,3,70,0,31700,21000,52700
"TR","2010-03-12",2010,3,71,19700,36700,44000,100400
"TR","2010-03-13",2010,3,72,116000,37400,39800,193200
"TR","2010-03-14",2010,3,73,3320,36300,21000,60620
"TR","2010-03-15",2010,3,74,0,35500,19400,54900
"TR","2010-03-16",2010,3,75,0,34800,19500,54300
"TR","2010-03-17",2010,3,76,0,34200,19400,53600
"TR","2010-03-18",2010,3,77,0,33700,19300,53000
"TR","2010-03-19",2010,3,78,0,33100,19300,52400
"TR","2010-03-20",2010,3,79,0,32700,19400,52100
"TR","2010-03-21",2010,3,80,0,32400,19400,51800
"TR","2010-03-22",2010,3,81,0,32200,19400,51600
"TR","2010-03-23",2010,3,82,0,31900,19500,51400
"TR","2010-03-24",2010,3,83,0,31500,19700,51200
"TR","2010-03-25",2010,3,84,0,31100,19800,50900
"TR","2010-03-26",2010,3,85,0,30800,19900,50700
"TR","2010-03-27",2010,3,86,0,30800,19900,50700
"TR","2010-03-28",2010,3,87,0,30700,19800,50500
"TR","2010-03-29",2010,3,88,11000,30600,19900,61500
"TR","2010-03-30",2010,3,89,2230,30500,19800,52530
"TR","2010-03-31",2010,3,90,0,30200,19900,50100
"TR","2010-04-01",2010,4,91,0,29800,20000,49800
"TR","2010-04-02",2010,4,92,0,29700,20100,49800
"TR","2010-04-03",2010,4,93,0,29600,20100,49700
"TR","2010-04-04",2010,4,94,4680,29500,20100,54280
"TR","2010-04-05",2010,4,95,480,29400,20100,49980
"TR","2010-04-06",2010,4,96,16100,29600,20100,65800
"TR","2010-04-07",2010,4,97,0,29400,20100,49500
"TR","2010-04-08",2010,4,98,959,29300,20100,50359
"TR","2010-04-09",2010,4,99,0,29200,20100,49300
"TR","2010-04-10",2010,4,100,0,29200,20000,49200
"TR","2010-04-11",2010,4,101,0,29100,20000,49100
"TR","2010-04-12",2010,4,102,0,29100,20000,49100
"TR","2010-04-13",2010,4,103,0,29000,20100,49100
"TR","2010-04-14",2010,4,104,17300,29100,20100,66500
"TR","2010-04-15",2010,4,105,3840,29000,20100,52940
"TR","2010-04-16",2010,4,106,98000,31000,20400,149400
"TR","2010-04-17",2010,4,107,38200,30300,19700,88200
"TR","2010-04-18",2010,4,108,0,29500,19400,48900
"TR","2010-04-19",2010,4,109,0,29200,19400,48600
"TR","2010-04-20",2010,4,110,0,29000,19500,48500
"TR","2010-04-21",2010,4,111,0,28900,19600,48500
"TR","2010-04-22",2010,4,112,0,28800,19700,48500
"TR","2010-04-23",2010,4,113,0,28700,19700,48400
"TR","2010-04-24",2010,4,114,0,28600,19700,48300
"TR","2010-04-25",2010,4,115,15700,28800,19800,64300
"TR","2010-04-26",2010,4,116,46100,29400,19900,95400
"TR","2010-04-27",2010,4,117,0,28800,19500,48300
"TR","2010-04-28",2010,4,118,0,28700,19600,48300
"TR","2010-04-29",2010,4,119,0,28500,19700,48200
"TR","2010-04-30",2010,4,120,0,28400,19700,48100
"TR","2010-05-01",2010,5,121,64000,29500,20000,113500
"TR","2010-05-02",2010,5,122,470000,42100,39700,551800
"TR","2010-05-03",2010,5,123,0,35000,17700,52700
"TR","2010-05-04",2010,5,124,0,34100,18100,52200
"TR","2010-05-05",2010,5,125,2390,33700,18100,54190
"TR","2010-05-06",2010,5,126,123000,35700,18900,177600
"TR","2010-05-07",2010,5,127,10400,34200,18200,62800
"TR","2010-05-08",2010,5,128,0,33500,18300,51800
"TR","2010-05-09",2010,5,129,299000,36200,18000,353200
"TR","2010-05-10",2010,5,130,0,36400,18100,54500
"TR","2010-05-11",2010,5,131,0,36100,24500,60600
"TR","2010-05-12",2010,5,132,0,35000,18300,53300
"TR","2010-05-13",2010,5,133,59000,35300,18500,112800
"TR","2010-05-14",2010,5,134,65000,35700,18500,119200
"TR","2010-05-15",2010,5,135,175000,38900,26100,240000
"TR","2010-05-16",2010,5,136,14600,36600,18000,69200
"TR","2010-05-17",2010,5,137,0,35300,18100,53400
"TR","2010-05-18",2010,5,138,0,34200,18200,52400
"TR","2010-05-19",2010,5,139,0,33100,18300,51400
"TR","2010-05-20",2010,5,140,0,32100,18500,50600
"TR","2010-05-21",2010,5,141,0,31200,18600,49800
"TR","2010-05-22",2010,5,142,4430,30400,18700,53530
"TR","2010-05-23",2010,5,143,19000,30000,18700,67700
"TR","2010-05-24",2010,5,144,0,29400,18600,48000
"TR","2010-05-25",2010,5,145,0,28800,18800,47600
"TR","2010-05-26",2010,5,146,0,28300,18900,47200
"TR","2010-05-27",2010,5,147,45500,28200,18900,92600
"TR","2010-05-28",2010,5,148,0,27500,18900,46400
"TR","2010-05-29",2010,5,149,0,26900,19100,46000
"TR","2010-05-30",2010,5,150,0,26400,19300,45700
"TR","2010-05-31",2010,5,151,133000,27800,19200,180000
"TR","2010-06-01",2010,6,152,104000,28200,18900,151100
"TR","2010-06-02",2010,6,153,0,27100,18700,45800
"TR","2010-06-03",2010,6,154,184000,29700,18800,232500
"TR","2010-06-04",2010,6,155,6160,28600,18300,53060
"TR","2010-06-05",2010,6,156,52300,28800,18500,99600
"TR","2010-06-06",2010,6,157,291000,33100,18500,342600
"TR","2010-06-07",2010,6,158,144000,33100,17700,194800
"TR","2010-06-08",2010,6,159,0,31600,17500,49100
"TR","2010-06-09",2010,6,160,0,30900,18000,48900
"TR","2010-06-10",2010,6,161,873000,55200,42200,970400
"TR","2010-06-11",2010,6,162,86900,46500,19300,152700
"TR","2010-06-12",2010,6,163,37600,43200,15900,96700
"TR","2010-06-13",2010,6,164,599000,73100,51400,723500
"TR","2010-06-14",2010,6,165,38300,60300,17900,116500
"TR","2010-06-15",2010,6,166,167000,60800,20400,248200
"TR","2010-06-16",2010,6,167,12700,53200,16200,82100
"TR","2010-06-17",2010,6,168,266000,61300,31300,358600
"TR","2010-06-18",2010,6,169,0,52900,16500,69400
"TR","2010-06-19",2010,6,170,0,47700,17100,64800
"TR","2010-06-20",2010,6,171,0,43400,17500,60900
"TR","2010-06-21",2010,6,172,0,41200,17800,59000
"TR","2010-06-22",2010,6,173,0,40100,18200,58300
"TR","2010-06-23",2010,6,174,692000,66600,40900,799500
"TR","2010-06-24",2010,6,175,370000,73700,42000,485700
"TR","2010-06-25",2010,6,176,318000,77600,36800,432400
"TR","2010-06-26",2010,6,177,111000,71100,19500,201600
"TR","2010-06-27",2010,6,178,667000,100000,52600,819600
"TR","2010-06-28",2010,6,179,72200,82400,19000,173600
"TR","2010-06-29",2010,6,180,42600,77600,17700,137900
"TR","2010-06-30",2010,6,181,9540,72700,18300,100540
"TR","2010-07-01",2010,7,182,0,65500,19000,84500
"TR","2010-07-02",2010,7,183,0,58700,19700,78400
"TR","2010-07-03",2010,7,184,0,52700,20300,73000
"TR","2010-07-04",2010,7,185,0,47700,20800,68500
"TR","2010-07-05",2010,7,186,0,44100,21300,65400
"TR","2010-07-06",2010,7,187,222000,48900,22100,293000
"TR","2010-07-07",2010,7,188,311000,59000,23100,393100
"TR","2010-07-08",2010,7,189,22600,51000,21500,95100
"TR","2010-07-09",2010,7,190,145000,52800,22700,220500
"TR","2010-07-10",2010,7,191,0,47300,22000,69300
"TR","2010-07-11",2010,7,192,0,44300,22400,66700
"TR","2010-07-12",2010,7,193,5050,43000,22700,70750
"TR","2010-07-13",2010,7,194,154000,44600,23200,221800
"TR","2010-07-14",2010,7,195,0,42800,22600,65400
"TR","2010-07-15",2010,7,196,242000,47700,23400,313100
"TR","2010-07-16",2010,7,197,844000,94400,67400,1005800
"TR","2010-07-17",2010,7,198,0,69500,20400,89900
"TR","2010-07-18",2010,7,199,0,61000,21400,82400
"TR","2010-07-19",2010,7,200,83600,58200,22300,164100
"TR","2010-07-20",2010,7,201,89800,56300,23000,169100
"TR","2010-07-21",2010,7,202,0,50800,22800,73600
"TR","2010-07-22",2010,7,203,3020,47000,23100,73120
"TR","2010-07-23",2010,7,204,0,44900,23300,68200
"TR","2010-07-24",2010,7,205,13200,43900,23500,80600
"TR","2010-07-25",2010,7,206,41500,43500,23700,108700
"TR","2010-07-26",2010,7,207,16900,42700,23700,83300
"TR","2010-07-27",2010,7,208,0,41700,23900,65600
"TR","2010-07-28",2010,7,209,1770,40900,24100,66770
"TR","2010-07-29",2010,7,210,462000,51200,25400,538600
"TR","2010-07-30",2010,7,211,0,45000,23300,68300
"TR","2010-07-31",2010,7,212,0,43800,23800,67600
"TR","2010-08-01",2010,8,213,37600,43100,24100,104800
"TR","2010-08-02",2010,8,214,42300,42700,24500,109500
"TR","2010-08-03",2010,8,215,501000,60700,26800,588500
"TR","2010-08-04",2010,8,216,9100,49300,23500,81900
"TR","2010-08-05",2010,8,217,98300,48100,24800,171200
"TR","2010-08-06",2010,8,218,6320,45000,24600,75920
"TR","2010-08-07",2010,8,219,0,43600,24800,68400
"TR","2010-08-08",2010,8,220,0,42800,25000,67800
"TR","2010-08-09",2010,8,221,921000,94200,67300,1082500
"TR","2010-08-10",2010,8,222,0,69200,24000,93200
"TR","2010-08-11",2010,8,223,0,61100,23700,84800
"TR","2010-08-12",2010,8,224,189000,64700,25200,278900
"TR","2010-08-13",2010,8,225,0,56700,24600,81300
"TR","2010-08-14",2010,8,226,93100,55200,25400,173700
"TR","2010-08-15",2010,8,227,482000,83100,54600,619700
"TR","2010-08-16",2010,8,228,171000,78200,34300,283500
"TR","2010-08-17",2010,8,229,23500,68800,24700,117000
"TR","2010-08-18",2010,8,230,0,62000,25200,87200
"TR","2010-08-19",2010,8,231,0,57200,25800,83000
"TR","2010-08-20",2010,8,232,211000,63300,28800,303100
"TR","2010-08-21",2010,8,233,193000,69100,35500,297600
"TR","2010-08-22",2010,8,234,1050000,130000,113000,1293000
"TR","2010-08-23",2010,8,235,0,95000,35700,130700
"TR","2010-08-24",2010,8,236,0,89200,25200,114400
"TR","2010-08-25",2010,8,237,0,83100,25900,109000
"TR","2010-08-26",2010,8,238,9100,78300,26800,114200
"TR","2010-08-27",2010,8,239,0,72300,27500,99800
"TR","2010-08-28",2010,8,240,0,66500,28100,94600
"TR","2010-08-29",2010,8,241,0,61400,28700,90100
"TR","2010-08-30",2010,8,242,0,57100,29100,86200
"TR","2010-08-31",2010,8,243,0,53600,29400,83000
"TR","2010-09-01",2010,9,244,6320,50700,29800,86820
"TR","2010-09-02",2010,9,245,74100,51300,30400,155800
"TR","2010-09-03",2010,9,246,13200,49200,30400,92800
"TR","2010-09-04",2010,9,247,111000,52200,31200,194400
"TR","2010-09-05",2010,9,248,58300,52300,31100,141700
"TR","2010-09-06",2010,9,249,0,50100,31000,81100
"TR","2010-09-07",2010,9,250,0,48700,31300,80000
"TR","2010-09-08",2010,9,251,76400,50000,31900,158300
"TR","2010-09-09",2010,9,252,49000,50100,31800,130900
"TR","2010-09-10",2010,9,253,1670,48400,31600,81670
"TR","2010-09-11",2010,9,254,0,47700,31700,79400
"TR","2010-09-12",2010,9,255,166000,53500,32800,252300
"TR","2010-09-13",2010,9,256,29200,51600,32100,112900
"TR","2010-09-14",2010,9,257,12100,49600,32000,93700
"TR","2010-09-15",2010,9,258,0,47900,31900,79800
"TR","2010-09-16",2010,9,259,0,47400,32000,79400
"TR","2010-09-17",2010,9,260,885000,102000,62700,1049700
"TR","2010-09-18",2010,9,261,8820,79200,30300,118320
"TR","2010-09-19",2010,9,262,16400,72400,29700,118500
"TR","2010-09-20",2010,9,263,0,66800,30100,96900
"TR","2010-09-21",2010,9,264,0,63000,30600,93600
"TR","2010-09-22",2010,9,265,55800,61900,31200,148900
"TR","2010-09-23",2010,9,266,9970,58700,31100,99770
"TR","2010-09-24",2010,9,267,39700,58900,31300,129900
"TR","2010-09-25",2010,9,268,1120000,137000,112000,1369000
"TR","2010-09-26",2010,9,269,53200,98900,42500,194600
"TR","2010-09-27",2010,9,270,0,94100,31700,125800
"TR","2010-09-28",2010,9,271,0,89100,30100,119200
"TR","2010-09-29",2010,9,272,0,84400,30800,115200
"TR","2010-09-30",2010,9,273,0,80500,31400,111900
"TR","2010-10-01",2010,10,274,25300,76100,32000,133400
"TR","2010-10-02",2010,10,275,0,71100,32200,103300
"TR","2010-10-03",2010,10,276,72300,71100,33100,176500
"TR","2010-10-04",2010,10,277,20900,69000,33400,123300
"TR","2010-10-05",2010,10,278,0,65400,33300,98700
"TR","2010-10-06",2010,10,279,0,62600,33600,96200
"TR","2010-10-07",2010,10,280,0,60100,33500,93600
"TR","2010-10-08",2010,10,281,0,58500,33500,92000
"TR","2010-10-09",2010,10,282,0,57100,33500,90600
"TR","2010-10-10",2010,10,283,0,55900,33600,89500
"TR","2010-10-11",2010,10,284,0,54900,33600,88500
"TR","2010-10-12",2010,10,285,0,54100,33900,88000
"TR","2010-10-13",2010,10,286,0,53400,34200,87600
"TR","2010-10-14",2010,10,287,31000,54500,34600,120100
"TR","2010-10-15",2010,10,288,0,53300,34200,87500
"TR","2010-10-16",2010,10,289,0,52800,34400,87200
"TR","2010-10-17",2010,10,290,0,52400,34500,86900
"TR","2010-10-18",2010,10,291,0,52000,34600,86600
"TR","2010-10-19",2010,10,292,0,51800,34600,86400
"TR","2010-10-20",2010,10,293,0,51600,34600,86200
"TR","2010-10-21",2010,10,294,0,51300,34700,86000
"TR","2010-10-22",2010,10,295,9060,51400,34700,95160
"TR","2010-10-23",2010,10,296,1340,51300,34600,87240
"TR","2010-10-24",2010,10,297,0,51000,34600,85600
"TR","2010-10-25",2010,10,298,225000,64000,37200,326200
"TR","2010-10-26",2010,10,299,199000,72500,48200,319700
"TR","2010-10-27",2010,10,300,240000,82500,49900,372400
"TR","2010-10-28",2010,10,301,269000,90700,57500,417200
"TR","2010-10-29",2010,10,302,82000,85600,41300,208900
"TR","2010-10-30",2010,10,303,0,81000,32100,113100
"TR","2010-10-31",2010,10,304,0,75000,32500,107500
"TR","2010-11-01",2010,11,305,0,70600,32800,103400
"TR","2010-11-02",2010,11,306,0,67000,33100,100100
"TR","2010-11-03",2010,11,307,0,63900,33100,97000
"TR","2010-11-04",2010,11,308,7190,61700,33100,101990
"TR","2010-11-05",2010,11,309,24600,61100,33200,118900
"TR","2010-11-06",2010,11,310,0,59000,32800,91800
"TR","2010-11-07",2010,11,311,0,57800,32900,90700
"TR","2010-11-08",2010,11,312,0,56700,32900,89600
"TR","2010-11-09",2010,11,313,0,55700,32800,88500
"TR","2010-11-10",2010,11,314,0,54700,32800,87500
"TR","2010-11-11",2010,11,315,0,53800,32700,86500
"TR","2010-11-12",2010,11,316,0,53100,32900,86000
"TR","2010-11-13",2010,11,317,0,52600,33000,85600
"TR","2010-11-14",2010,11,318,25900,53400,33200,112500
"TR","2010-11-15",2010,11,319,202000,61600,35100,298700
"TR","2010-11-16",2010,11,320,50300,60100,33000,143400
"TR","2010-11-17",2010,11,321,0,58300,33000,91300
"TR","2010-11-18",2010,11,322,0,57600,34900,92500
"TR","2010-11-19",2010,11,323,0,56200,33100,89300
"TR","2010-11-20",2010,11,324,0,55100,32900,88000
"TR","2010-11-21",2010,11,325,0,54300,32800,87100
"TR","2010-11-22",2010,11,326,2160,53800,32700,88660
"TR","2010-11-23",2010,11,327,22800,53600,32600,109000
"TR","2010-11-24",2010,11,328,55800,54500,32200,142500
"TR","2010-11-25",2010,11,329,42600,55300,32000,129900
"TR","2010-11-26",2010,11,330,129000,57800,31500,218300
"TR","2010-11-27",2010,11,331,2160,56500,31500,90160
"TR","2010-11-28",2010,11,332,0,55400,31700,87100
"TR","2010-11-29",2010,11,333,0,54500,31800,86300
"TR","2010-11-30",2010,11,334,0,53600,31900,85500
"TR","2010-12-01",2010,12,335,97200,55600,31800,184600
"TR","2010-12-02",2010,12,336,5620,55400,32100,93120
"TR","2010-12-03",2010,12,337,10800,54600,31800,97200
"TR","2010-12-04",2010,12,338,0,53700,31800,85500
"TR","2010-12-05",2010,12,339,3310,53200,31800,88310
"TR","2010-12-06",2010,12,340,26800,53200,31700,111700
"TR","2010-12-07",2010,12,341,13900,53000,31600,98500
"TR","2010-12-08",2010,12,342,6780,52700,31600,91080
"TR","2010-12-09",2010,12,343,3450,52300,31600,87350
"TR","2010-12-10",2010,12,344,0,51900,31600,83500
"TR","2010-12-11",2010,12,345,61800,53100,31300,146200
"TR","2010-12-12",2010,12,346,10600,52900,31200,94700
"TR","2010-12-13",2010,12,347,90500,54500,30900,175900
"TR","2010-12-14",2010,12,348,355,53500,30800,84655
"TR","2010-12-15",2010,12,349,0,52800,30900,83700
"TR","2010-12-16",2010,12,350,0,52100,31000,83100
"TR","2010-12-17",2010,12,351,0,51600,31000,82600
"TR","2010-12-18",2010,12,352,0,51100,31100,82200
"TR","2010-12-19",2010,12,353,0,50700,31100,81800
"TR","2010-12-20",2010,12,354,1400,50400,31000,82800
"TR","2010-12-21",2010,12,355,0,50200,31000,81200
"TR","2010-12-22",2010,12,356,58300,51300,30700,140300
"TR","2010-12-23",2010,12,357,52800,52100,30400,135300
"TR","2010-12-24",2010,12,358,0,51400,30400,81800
"TR","2010-12-25",2010,12,359,0,50700,30500,81200
"TR","2010-12-26",2010,12,360,0,50200,30600,80800
"TR","2010-12-27",2010,12,361,3880,49900,30600,84380
"TR","2010-12-28",2010,12,362,0,49500,30600,80100
"TR","2010-12-29",2010,12,363,0,49200,30600,79800
"TR","2010-12-30",2010,12,364,0,48900,30600,79500
"TR","2010-12-31",2010,12,365,2790,48700,30500,81990
"TR","2011-01-01",2011,1,1,48000,49800,30300,128100
"TR","2011-01-02",2011,1,2,0,49300,30300,79600
"TR","2011-01-03",2011,1,3,8110,49100,30200,87410
"TR","2011-01-04",2011,1,4,0,48700,30200,78900
"TR","2011-01-05",2011,1,5,22100,48900,30100,101100
"TR","2011-01-06",2011,1,6,0,48500,30100,78600
"TR","2011-01-07",2011,1,7,18100,48600,30000,96700
"TR","2011-01-08",2011,1,8,4850,48400,30000,83250
"TR","2011-01-09",2011,1,9,0,48100,30000,78100
"TR","2011-01-10",2011,1,10,15300,48100,29900,93300
"TR","2011-01-11",2011,1,11,0,47800,29900,77700
"TR","2011-01-12",2011,1,12,10500,47800,29800,88100
"TR","2011-01-13",2011,1,13,45200,48400,29600,123200
"TR","2011-01-14",2011,1,14,13100,48200,29500,90800
"TR","2011-01-15",2011,1,15,13500,48100,29500,91100
"TR","2011-01-16",2011,1,16,113000,50200,29000,192200
"TR","2011-01-17",2011,1,17,0,49300,29000,78300
"TR","2011-01-18",2011,1,18,0,48600,29100,77700
"TR","2011-01-19",2011,1,19,25000,48600,29100,102700
"TR","2011-01-20",2011,1,20,0,48000,29100,77100
"TR","2011-01-21",2011,1,21,0,47500,29100,76600
"TR","2011-01-22",2011,1,22,0,47200,29200,76400
"TR","2011-01-23",2011,1,23,0,47100,29200,76300
"TR","2011-01-24",2011,1,24,0,46900,29200,76100
"TR","2011-01-25",2011,1,25,2140,46800,29200,78140
"TR","2011-01-26",2011,1,26,3450,46700,29100,79250
"TR","2011-01-27",2011,1,27,1070,46500,29100,76670
"TR","2011-01-28",2011,1,28,4900,46400,29100,80400
"TR","2011-01-29",2011,1,29,34300,46500,29000,109800
"TR","2011-01-30",2011,1,30,137000,48200,28300,213500
"TR","2011-01-31",2011,1,31,7260,47600,28200,83060
"TR","2011-02-01",2011,2,32,15000,47300,28300,90600
"TR","2011-02-02",2011,2,33,16700,47100,28300,92100
"TR","2011-02-03",2011,2,34,0,46700,28400,75100
"TR","2011-02-04",2011,2,35,0,46500,28400,74900
"TR","2011-02-05",2011,2,36,0,46300,28500,74800
"TR","2011-02-06",2011,2,37,8270,46200,28500,82970
"TR","2011-02-07",2011,2,38,0,46000,28500,74500
"TR","2011-02-08",2011,2,39,8030,45900,28500,82430
"TR","2011-02-09",2011,2,40,1600,45800,28400,75800
"TR","2011-02-10",2011,2,41,0,45600,28400,74000
"TR","2011-02-11",2011,2,42,0,45500,28400,73900
"TR","2011-02-12",2011,2,43,0,45300,28400,73700
"TR","2011-02-13",2011,2,44,0,45200,28400,73600
"TR","2011-02-14",2011,2,45,17000,45200,28300,90500
"TR","2011-02-15",2011,2,46,2820,45000,28300,76120
"TR","2011-02-16",2011,2,47,0,44900,28300,73200
"TR","2011-02-17",2011,2,48,0,44700,28300,73000
"TR","2011-02-18",2011,2,49,0,44500,28300,72800
"TR","2011-02-19",2011,2,50,0,44400,28300,72700
"TR","2011-02-20",2011,2,51,0,44300,28300,72600
"TR","2011-02-21",2011,2,52,0,44100,28200,72300
"TR","2011-02-22",2011,2,53,2430,44000,28200,74630
"TR","2011-02-23",2011,2,54,0,43900,28200,72100
"TR","2011-02-24",2011,2,55,0,43800,28100,71900
"TR","2011-02-25",2011,2,56,0,43700,28100,71800
"TR","2011-02-26",2011,2,57,962,43600,28100,72662
"TR","2011-02-27",2011,2,58,0,43500,28000,71500
"TR","2011-02-28",2011,2,59,19500,43500,27900,90900
"TR","2011-03-01",2011,3,60,2600,43400,27900,73900
"TR","2011-03-02",2011,3,61,0,43200,27900,71100
"TR","2011-03-03",2011,3,62,0,43000,27900,70900
"TR","2011-03-04",2011,3,63,0,42900,27900,70800
"TR","2011-03-05",2011,3,64,14800,42900,27800,85500
"TR","2011-03-06",2011,3,65,0,42700,27800,70500
"TR","2011-03-07",2011,3,66,0,42600,27800,70400
"TR","2011-03-08",2011,3,67,45700,42700,27600,116000
"TR","2011-03-09",2011,3,68,57600,43000,27300,127900
"TR","2011-03-10",2011,3,69,0,42800,27300,70100
"TR","2011-03-11",2011,3,70,84100,43200,27000,154300
"TR","2011-03-12",2011,3,71,0,43000,27000,70000
"TR","2011-03-13",2011,3,72,72200,43300,26800,142300
"TR","2011-03-14",2011,3,73,57300,43500,26600,127400
"TR","2011-03-15",2011,3,74,13500,43400,26600,83500
"TR","2011-03-16",2011,3,75,0,43100,26800,69900
"TR","2011-03-17",2011,3,76,0,42800,27000,69800
"TR","2011-03-18",2011,3,77,0,42500,27100,69600
"TR","2011-03-19",2011,3,78,0,42300,27200,69500
"TR","2011-03-20",2011,3,79,0,42100,27200,69300
"TR","2011-03-21",2011,3,80,19300,45300,32400,97000
"TR","2011-03-22",2011,3,81,327000,46100,29900,403000
"TR","2011-03-23",2011,3,82,0,45600,28200,73800
"TR","2011-03-24",2011,3,83,468000,50800,24800,543600
"TR","2011-03-25",2011,3,84,69200,50100,24200,143500
"TR","2011-03-26",2011,3,85,0,47900,24600,72500
"TR","2011-03-27",2011,3,86,0,46300,24900,71200
"TR","2011-03-28",2011,3,87,0,45600,25200,70800
"TR","2011-03-29",2011,3,88,0,45200,25400,70600
"TR","2011-03-30",2011,3,89,0,44900,25700,70600
"TR","2011-03-31",2011,3,90,0,44400,25900,70300
"TR","2011-04-01",2011,4,91,0,43900,26100,70000
"TR","2011-04-02",2011,4,92,0,43600,26200,69800
"TR","2011-04-03",2011,4,93,30900,43400,26100,100400
"TR","2011-04-04",2011,4,94,34000,45700,26800,106500
"TR","2011-04-05",2011,4,95,99600,47600,38200,185400
"TR","2011-04-06",2011,4,96,14100,45700,27600,87400
"TR","2011-04-07",2011,4,97,0,46500,31300,77800
"TR","2011-04-08",2011,4,98,0,48100,33000,81100
"TR","2011-04-09",2011,4,99,0,50500,37300,87800
"TR","2011-04-10",2011,4,100,0,53000,39900,92900
"TR","2011-04-11",2011,4,101,147000,285000,479000,911000
"TR","2011-04-12",2011,4,102,48300,108000,61900,218200
"TR","2011-04-13",2011,4,103,0,92500,25600,118100
"TR","2011-04-14",2011,4,104,0,86200,25600,111800
"TR","2011-04-15",2011,4,105,0,80800,26000,106800
"TR","2011-04-16",2011,4,106,0,76900,26300,103200
"TR","2011-04-17",2011,4,107,5650,71500,26700,103850
"TR","2011-04-18",2011,4,108,147000,70200,26400,243600
"TR","2011-04-19",2011,4,109,5150,65300,26600,97050
"TR","2011-04-20",2011,4,110,0,61500,27200,88700
"TR","2011-04-21",2011,4,111,13600,60200,28800,102600
"TR","2011-04-22",2011,4,112,2120,56600,28300,87020
"TR","2011-04-23",2011,4,113,0,53800,28400,82200
"TR","2011-04-24",2011,4,114,296000,71900,41000,408900
"TR","2011-04-25",2011,4,115,0,61300,27600,88900
"TR","2011-04-26",2011,4,116,0,57400,28000,85400
"TR","2011-04-27",2011,4,117,0,54300,28000,82300
"TR","2011-04-28",2011,4,118,375000,71800,45700,492500
"TR","2011-04-29",2011,4,119,61700,70600,31600,163900
"TR","2011-04-30",2011,4,120,11300,63600,27600,102500
"TR","2011-05-01",2011,5,121,0,59400,27800,87200
"TR","2011-05-02",2011,5,122,126000,63500,33400,222900
"TR","2011-05-03",2011,5,123,9620,59000,28300,96920
"TR","2011-05-04",2011,5,124,2450,56100,28600,87150
"TR","2011-05-05",2011,5,125,0,53600,28700,82300
"TR","2011-05-06",2011,5,126,0,51000,28900,79900
"TR","2011-05-07",2011,5,127,69400,52500,29100,151000
"TR","2011-05-08",2011,5,128,0,49800,28800,78600
"TR","2011-05-09",2011,5,129,0,48600,28800,77400
"TR","2011-05-10",2011,5,130,2550,48000,28600,79150
"TR","2011-05-11",2011,5,131,26600,47300,28600,102500
"TR","2011-05-12",2011,5,132,219000,53000,30000,302000
"TR","2011-05-13",2011,5,133,295000,67500,47900,410400
"TR","2011-05-14",2011,5,134,154000,69000,36500,259500
"TR","2011-05-15",2011,5,135,0,61100,28000,89100
"TR","2011-05-16",2011,5,136,70700,60700,29600,161000
"TR","2011-05-17",2011,5,137,0,56600,28600,85200
"TR","2011-05-18",2011,5,138,0,53500,29000,82500
"TR","2011-05-19",2011,5,139,0,50100,28800,78900
"TR","2011-05-20",2011,5,140,0,48200,28500,76700
"TR","2011-05-21",2011,5,141,8200,47400,28500,84100
"TR","2011-05-22",2011,5,142,0,46600,28500,75100
"TR","2011-05-23",2011,5,143,201000,51100,29700,281800
"TR","2011-05-24",2011,5,144,150000,54700,29600,234300
"TR","2011-05-25",2011,5,145,14900,51200,28700,94800
"TR","2011-05-26",2011,5,146,0,48700,28800,77500
"TR","2011-05-27",2011,5,147,0,47800,28900,76700
"TR","2011-05-28",2011,5,148,0,47000,28900,75900
"TR","2011-05-29",2011,5,149,107000,48500,29500,185000
"TR","2011-05-30",2011,5,150,88800,49100,29500,167400
"TR","2011-05-31",2011,5,151,26300,48300,29100,103700
"TR","2011-06-01",2011,6,152,27400,47800,29100,104300
"TR","2011-06-02",2011,6,153,1400,46600,29000,77000
"TR","2011-06-03",2011,6,154,0,45700,29000,74700
"TR","2011-06-04",2011,6,155,0,45100,29100,74200
"TR","2011-06-05",2011,6,156,1400,44100,29400,74900
"TR","2011-06-06",2011,6,157,0,42900,29500,72400
"TR","2011-06-07",2011,6,158,0,42100,29500,71600
"TR","2011-06-08",2011,6,159,39300,42000,29500,110800
"TR","2011-06-09",2011,6,160,0,41200,29400,70600
"TR","2011-06-10",2011,6,161,0,40500,29700,70200
"TR","2011-06-11",2011,6,162,0,40000,29600,69600
"TR","2011-06-12",2011,6,163,190000,43300,29500,262800
"TR","2011-06-13",2011,6,164,0,42200,28700,70900
"TR","2011-06-14",2011,6,165,0,41600,29100,70700
"TR","2011-06-15",2011,6,166,0,40400,29400,69800
"TR","2011-06-16",2011,6,167,0,39600,29500,69100
"TR","2011-06-17",2011,6,168,135000,41400,29500,205900
"TR","2011-06-18",2011,6,169,20200,40900,28900,90000
"TR","2011-06-19",2011,6,170,5090,40200,29000,74290
"TR","2011-06-20",2011,6,171,419000,48800,29800,497600
"TR","2011-06-21",2011,6,172,71300,45900,28200,145400
"TR","2011-06-22",2011,6,173,112000,46900,28400,187300
"TR","2011-06-23",2011,6,174,883000,92800,71000,1046800
"TR","2011-06-24",2011,6,175,109000,80300,28700,218000
"TR","2011-06-25",2011,6,176,17300,74700,26100,118100
"TR","2011-06-26",2011,6,177,0,67600,26700,94300
"TR","2011-06-27",2011,6,178,0,61600,27300,88900
"TR","2011-06-28",2011,6,179,0,56500,27400,83900
"TR","2011-06-29",2011,6,180,112000,57200,28100,197300
"TR","2011-06-30",2011,6,181,0,53300,27600,80900
"TR","2011-07-01",2011,7,182,0,50100,28000,78100
"TR","2011-07-02",2011,7,183,0,47400,27800,75200
"TR","2011-07-03",2011,7,184,4970,46100,27700,78770
"TR","2011-07-04",2011,7,185,0,44600,27800,72400
"TR","2011-07-05",2011,7,186,0,43100,27900,71000
"TR","2011-07-06",2011,7,187,0,41800,28000,69800
"TR","2011-07-07",2011,7,188,62500,41500,28000,132000
"TR","2011-07-08",2011,7,189,0,40400,27700,68100
"TR","2011-07-09",2011,7,190,8960,39800,27700,76460
"TR","2011-07-10",2011,7,191,0,39100,27700,66800
"TR","2011-07-11",2011,7,192,0,38300,27700,66000
"TR","2011-07-12",2011,7,193,11400,37700,27700,76800
"TR","2011-07-13",2011,7,194,0,36900,27800,64700
"TR","2011-07-14",2011,7,195,0,36400,27700,64100
"TR","2011-07-15",2011,7,196,0,36000,27700,63700
"TR","2011-07-16",2011,7,197,8330,35700,27600,71630
"TR","2011-07-17",2011,7,198,40500,35900,27500,103900
"TR","2011-07-18",2011,7,199,0,35100,27500,62600
"TR","2011-07-19",2011,7,200,1090000,67600,33800,1191400
"TR","2011-07-20",2011,7,201,36200,48900,23900,109000
"TR","2011-07-21",2011,7,202,66400,48500,24600,139500
"TR","2011-07-22",2011,7,203,0,46700,25000,71700
"TR","2011-07-23",2011,7,204,0,45100,25600,70700
"TR","2011-07-24",2011,7,205,0,43600,25900,69500
"TR","2011-07-25",2011,7,206,139000,45200,26200,210400
"TR","2011-07-26",2011,7,207,0,43700,25800,69500
"TR","2011-07-27",2011,7,208,0,42400,26200,68600
"TR","2011-07-28",2011,7,209,101000,43200,26200,170400
"TR","2011-07-29",2011,7,210,206000,45900,26500,278400
"TR","2011-07-30",2011,7,211,1330,43600,25800,70730
"TR","2011-07-31",2011,7,212,0,41900,26000,67900
"TR","2011-08-01",2011,8,213,211000,45200,26600,282800
"TR","2011-08-02",2011,8,214,1330,42700,26300,70330
"TR","2011-08-03",2011,8,215,313000,48500,27500,389000
"TR","2011-08-04",2011,8,216,872000,90300,72400,1034700
"TR","2011-08-05",2011,8,217,1330,69100,23900,94330
"TR","2011-08-06",2011,8,218,0,61400,24900,86300
"TR","2011-08-07",2011,8,219,0,56100,25600,81700
"TR","2011-08-08",2011,8,220,161000,58300,26700,246000
"TR","2011-08-09",2011,8,221,1330,53200,26300,80830
"TR","2011-08-10",2011,8,222,58600,52200,26800,137600
"TR","2011-08-11",2011,8,223,32900,50200,26900,110000
"TR","2011-08-12",2011,8,224,0,48100,26900,75000
"TR","2011-08-13",2011,8,225,87900,48800,27500,164200
"TR","2011-08-14",2011,8,226,0,47100,27200,74300
"TR","2011-08-15",2011,8,227,110000,48200,28000,186200
"TR","2011-08-16",2011,8,228,0,46600,27500,74100
"TR","2011-08-17",2011,8,229,0,45600,27700,73300
"TR","2011-08-18",2011,8,230,141000,47600,28400,217000
"TR","2011-08-19",2011,8,231,0,45800,27700,73500
"TR","2011-08-20",2011,8,232,94700,47000,28100,169800
"TR","2011-08-21",2011,8,233,39500,45900,28200,113600
"TR","2011-08-22",2011,8,234,4660,44300,27800,76760
"TR","2011-08-23",2011,8,235,0,43400,27700,71100
"TR","2011-08-24",2011,8,236,0,42700,28000,70700
"TR","2011-08-25",2011,8,237,210000,46400,28600,285000
"TR","2011-08-26",2011,8,238,0,44300,27600,71900
"TR","2011-08-27",2011,8,239,0,43300,27800,71100
"TR","2011-08-28",2011,8,240,16600,42300,28000,86900
"TR","2011-08-29",2011,8,241,0,41000,28000,69000
"TR","2011-08-30",2011,8,242,0,40000,28100,68100
"TR","2011-08-31",2011,8,243,0,39200,28200,67400
"TR","2011-09-01",2011,9,244,90000,40100,28200,158300
"TR","2011-09-02",2011,9,245,15800,39500,27900,83200
"TR","2011-09-03",2011,9,246,0,38800,28100,66900
"TR","2011-09-04",2011,9,247,2500,38200,28200,68900
"TR","2011-09-05",2011,9,248,44100,38500,28200,110800
"TR","2011-09-06",2011,9,249,29600,38500,28100,96200
"TR","2011-09-07",2011,9,250,0,38000,28000,66000
"TR","2011-09-08",2011,9,251,0,37800,28100,65900
"TR","2011-09-09",2011,9,252,0,37400,28100,65500
"TR","2011-09-10",2011,9,253,0,37000,28200,65200
"TR","2011-09-11",2011,9,254,0,36600,28300,64900
"TR","2011-09-12",2011,9,255,0,36100,28300,64400
"TR","2011-09-13",2011,9,256,0,35700,28400,64100
"TR","2011-09-14",2011,9,257,0,35300,28400,63700
"TR","2011-09-15",2011,9,258,21900,35400,28300,85600
"TR","2011-09-16",2011,9,259,18000,35600,28100,81700
"TR","2011-09-17",2011,9,260,3040,35600,28000,66640
"TR","2011-09-18",2011,9,261,0,35500,27900,63400
"TR","2011-09-19",2011,9,262,0,35500,27900,63400
"TR","2011-09-20",2011,9,263,104000,37400,28000,169400
"TR","2011-09-21",2011,9,264,0,36700,27600,64300
"TR","2011-09-22",2011,9,265,7390,36500,27700,71590
"TR","2011-09-23",2011,9,266,81200,37800,27800,146800
"TR","2011-09-24",2011,9,267,13200,37500,27500,78200
"TR","2011-09-25",2011,9,268,21900,37600,27500,87000
"TR","2011-09-26",2011,9,269,14800,37400,27500,79700
"TR","2011-09-27",2011,9,270,1520,37000,27500,66020
"TR","2011-09-28",2011,9,271,64100,38300,27400,129800
"TR","2011-09-29",2011,9,272,30200,38600,27300,96100
"TR","2011-09-30",2011,9,273,1520,37900,27300,66720
"TR","2011-10-01",2011,10,274,102000,40000,27300,169300
"TR","2011-10-02",2011,10,275,29300,40100,27000,96400
"TR","2011-10-03",2011,10,276,0,39400,27000,66400
"TR","2011-10-04",2011,10,277,0,38900,27200,66100
"TR","2011-10-05",2011,10,278,0,38200,27400,65600
"TR","2011-10-06",2011,10,279,0,37600,27500,65100
"TR","2011-10-07",2011,10,280,0,37300,27700,65000
"TR","2011-10-08",2011,10,281,0,37200,27900,65100
"TR","2011-10-09",2011,10,282,0,37100,28100,65200
"TR","2011-10-10",2011,10,283,0,37000,28300,65300
"TR","2011-10-11",2011,10,284,0,36900,28400,65300
"TR","2011-10-12",2011,10,285,1850,36900,28500,67250
"TR","2011-10-13",2011,10,286,4570,36900,28600,70070
"TR","2011-10-14",2011,10,287,176000,41200,28900,246100
"TR","2011-10-15",2011,10,288,329000,48700,29500,407200
"TR","2011-10-16",2011,10,289,25600,44100,26300,96000
"TR","2011-10-17",2011,10,290,0,42800,26300,69100
"TR","2011-10-18",2011,10,291,0,42200,26500,68700
"TR","2011-10-19",2011,10,292,3710,41800,26500,72010
"TR","2011-10-20",2011,10,293,24200,42100,26600,92900
"TR","2011-10-21",2011,10,294,31200,42400,26600,100200
"TR","2011-10-22",2011,10,295,11300,42100,26400,79800
"TR","2011-10-23",2011,10,296,0,41800,26300,68100
"TR","2011-10-24",2011,10,297,1850,41600,26400,69850
"TR","2011-10-25",2011,10,298,85000,43200,26500,154700
"TR","2011-10-26",2011,10,299,3710,42600,26200,72510
"TR","2011-10-27",2011,10,300,132000,45200,26800,204000
"TR","2011-10-28",2011,10,301,15600,44000,25800,85400
"TR","2011-10-29",2011,10,302,0,43100,25800,68900
"TR","2011-10-30",2011,10,303,17000,43000,25900,85900
"TR","2011-10-31",2011,10,304,0,42600,25800,68400
"TR","2011-11-01",2011,11,305,24800,42800,25900,93500
"TR","2011-11-02",2011,11,306,1820,42200,25800,69820
"TR","2011-11-03",2011,11,307,27100,42100,25900,95100
"TR","2011-11-04",2011,11,308,1260,41600,25500,68360
"TR","2011-11-05",2011,11,309,0,41400,25400,66800
"TR","2011-11-06",2011,11,310,0,41200,25400,66600
"TR","2011-11-07",2011,11,311,0,41000,25300,66300
"TR","2011-11-08",2011,11,312,0,40700,25200,65900
"TR","2011-11-09",2011,11,313,0,40500,25100,65600
"TR","2011-11-10",2011,11,314,0,40300,25000,65300
"TR","2011-11-11",2011,11,315,61600,40800,24600,127000
"TR","2011-11-12",2011,11,316,68100,41300,24200,133600
"TR","2011-11-13",2011,11,317,0,41100,24300,65400
"TR","2011-11-14",2011,11,318,0,41900,25100,67000
"TR","2011-11-15",2011,11,319,0,40800,25100,65900
"TR","2011-11-16",2011,11,320,0,40100,25000,65100
"TR","2011-11-17",2011,11,321,0,39700,24900,64600
"TR","2011-11-18",2011,11,322,12500,39900,24800,77200
"TR","2011-11-19",2011,11,323,0,39600,24800,64400
"TR","2011-11-20",2011,11,324,0,39500,24900,64400
"TR","2011-11-21",2011,11,325,182000,40800,24100,246900
"TR","2011-11-22",2011,11,326,0,40700,24000,64700
"TR","2011-11-23",2011,11,327,0,40600,24200,64800
"TR","2011-11-24",2011,11,328,0,40400,24400,64800
"TR","2011-11-25",2011,11,329,0,40200,24500,64700
"TR","2011-11-26",2011,11,330,0,41200,25200,66400
"TR","2011-11-27",2011,11,331,87900,42400,25400,155700
"TR","2011-11-28",2011,11,332,51700,42700,24800,119200
"TR","2011-11-29",2011,11,333,2160,42000,24300,68460
"TR","2011-11-30",2011,11,334,0,41300,24300,65600
"TR","2011-12-01",2011,12,335,0,41000,24400,65400
"TR","2011-12-02",2011,12,336,50000,41200,24200,115400
"TR","2011-12-03",2011,12,337,85500,41500,23800,150800
"TR","2011-12-04",2011,12,338,0,41400,23800,65200
"TR","2011-12-05",2011,12,339,107000,41900,23500,172400
"TR","2011-12-06",2011,12,340,0,41800,23400,65200
"TR","2011-12-07",2011,12,341,0,41600,23500,65100
"TR","2011-12-08",2011,12,342,0,41400,23600,65000
"TR","2011-12-09",2011,12,343,0,41200,23700,64900
"TR","2011-12-10",2011,12,344,0,41000,23700,64700
"TR","2011-12-11",2011,12,345,0,40800,23700,64500
"TR","2011-12-12",2011,12,346,0,40700,23700,64400
"TR","2011-12-13",2011,12,347,2250,40800,24000,67050
"TR","2011-12-14",2011,12,348,20900,41100,23800,85800
"TR","2011-12-15",2011,12,349,22600,41900,24100,88600
"TR","2011-12-16",2011,12,350,186000,46300,29700,262000
"TR","2011-12-17",2011,12,351,19500,44000,23200,86700
"TR","2011-12-18",2011,12,352,0,43500,23000,66500
"TR","2011-12-19",2011,12,353,710,43300,23100,67110
"TR","2011-12-20",2011,12,354,0,43100,23200,66300
"TR","2011-12-21",2011,12,355,0,42800,23300,66100
"TR","2011-12-22",2011,12,356,0,42500,23400,65900
"TR","2011-12-23",2011,12,357,4350,42300,23400,70050
"TR","2011-12-24",2011,12,358,0,42100,23400,65500
"TR","2011-12-25",2011,12,359,126000,42600,23000,191600
"TR","2011-12-26",2011,12,360,0,42400,22900,65300
"TR","2011-12-27",2011,12,361,0,42100,23000,65100
"TR","2011-12-28",2011,12,362,1210,42200,23800,67210
"TR","2011-12-29",2011,12,363,6480,41900,23200,71580
"TR","2011-12-30",2011,12,364,0,41600,23300,64900
"TR","2011-12-31",2011,12,365,34500,41600,23200,99300
"TR","2012-01-01",2012,1,1,0,41300,23200,64500
"TR","2012-01-02",2012,1,2,178000,42200,22500,242700
"TR","2012-01-03",2012,1,3,38000,42200,22300,102500
"TR","2012-01-04",2012,1,4,2370,41900,22500,66770
"TR","2012-01-05",2012,1,5,0,41700,22600,64300
"TR","2012-01-06",2012,1,6,0,41400,22800,64200
"TR","2012-01-07",2012,1,7,0,41100,22900,64000
"TR","2012-01-08",2012,1,8,0,40800,23000,63800
"TR","2012-01-09",2012,1,9,0,40600,23100,63700
"TR","2012-01-10",2012,1,10,0,40400,23100,63500
"TR","2012-01-11",2012,1,11,0,40100,23200,63300
"TR","2012-01-12",2012,1,12,0,39900,23200,63100
"TR","2012-01-13",2012,1,13,47000,40100,23100,110200
"TR","2012-01-14",2012,1,14,54200,40300,22800,117300
"TR","2012-01-15",2012,1,15,4050,40100,22800,66950
"TR","2012-01-16",2012,1,16,0,39900,22900,62800
"TR","2012-01-17",2012,1,17,0,39700,23000,62700
"TR","2012-01-18",2012,1,18,5630,39600,23100,68330
"TR","2012-01-19",2012,1,19,30300,39600,23000,92900
"TR","2012-01-20",2012,1,20,19400,39600,22900,81900
"TR","2012-01-21",2012,1,21,0,39400,22900,62300
"TR","2012-01-22",2012,1,22,0,39200,23000,62200
"TR","2012-01-23",2012,1,23,0,39100,23000,62100
"TR","2012-01-24",2012,1,24,96400,39500,22700,158600
"TR","2012-01-25",2012,1,25,97500,40100,22300,159900
"TR","2012-01-26",2012,1,26,14200,40000,22300,76500
"TR","2012-01-27",2012,1,27,0,39700,22400,62100
"TR","2012-01-28",2012,1,28,0,39500,22600,62100
"TR","2012-01-29",2012,1,29,51500,39600,22500,113600
"TR","2012-01-30",2012,1,30,1180,39400,22500,63080
"TR","2012-01-31",2012,1,31,4250,39300,22600,66150
"TR","2012-02-01",2012,2,32,2020,39100,22700,63820
"TR","2012-02-02",2012,2,33,0,38900,22800,61700
"TR","2012-02-03",2012,2,34,4770,38700,22800,66270
"TR","2012-02-04",2012,2,35,0,38500,22900,61400
"TR","2012-02-05",2012,2,36,0,38400,22900,61300
"TR","2012-02-06",2012,2,37,0,38200,22900,61100
"TR","2012-02-07",2012,2,38,0,38000,23000,61000
"TR","2012-02-08",2012,2,39,0,37900,23000,60900
"TR","2012-02-09",2012,2,40,0,37700,23000,60700
"TR","2012-02-10",2012,2,41,0,37600,23000,60600
"TR","2012-02-11",2012,2,42,15400,37600,22900,75900
"TR","2012-02-12",2012,2,43,0,37500,22900,60400
"TR","2012-02-13",2012,2,44,0,37400,22900,60300
"TR","2012-02-14",2012,2,45,0,37200,23000,60200
"TR","2012-02-15",2012,2,46,712,37100,23000,60812
"TR","2012-02-16",2012,2,47,4510,37000,23000,64510
"TR","2012-02-17",2012,2,48,1220,36900,23000,61120
"TR","2012-02-18",2012,2,49,0,36700,23000,59700
"TR","2012-02-19",2012,2,50,4680,36700,23000,64380
"TR","2012-02-20",2012,2,51,0,36600,23000,59600
"TR","2012-02-21",2012,2,52,0,36500,23000,59500
"TR","2012-02-22",2012,2,53,0,36400,23000,59400
"TR","2012-02-23",2012,2,54,25000,36400,22900,84300
"TR","2012-02-24",2012,2,55,0,36300,22900,59200
"TR","2012-02-25",2012,2,56,0,36200,22900,59100
"TR","2012-02-26",2012,2,57,10500,36200,22900,69600
"TR","2012-02-27",2012,2,58,0,36100,22900,59000
"TR","2012-02-28",2012,2,59,11900,36100,22900,70900
"TR","2012-02-29",2012,2,60,0,36000,22900,58900
"TR","2012-03-01",2012,3,61,324000,38000,21700,383700
"TR","2012-03-02",2012,3,62,143000,38900,21000,202900
"TR","2012-03-03",2012,3,63,0,38700,21200,59900
"TR","2012-03-04",2012,3,64,154000,39300,21000,214300
"TR","2012-03-05",2012,3,65,4460,39100,21000,64560
"TR","2012-03-06",2012,3,66,0,38800,21300,60100
"TR","2012-03-07",2012,3,67,11200,38600,21500,71300
"TR","2012-03-08",2012,3,68,0,38200,21700,59900
"TR","2012-03-09",2012,3,69,60000,38300,21600,119900
"TR","2012-03-10",2012,3,70,34100,38300,21500,93900
"TR","2012-03-11",2012,3,71,0,38000,21700,59700
"TR","2012-03-12",2012,3,72,0,37600,21900,59500
"TR","2012-03-13",2012,3,73,95600,49000,48400,193000
"TR","2012-03-14",2012,3,74,34300,51400,47100,132800
"TR","2012-03-15",2012,3,75,0,48100,29800,77900
"TR","2012-03-16",2012,3,76,0,51800,38800,90600
"TR","2012-03-17",2012,3,77,0,52100,39200,91300
"TR","2012-03-18",2012,3,78,0,48500,41700,90200
"TR","2012-03-19",2012,3,79,0,45500,23100,68600
"TR","2012-03-20",2012,3,80,0,44300,23000,67300
"TR","2012-03-21",2012,3,81,4320,43500,22900,70720
"TR","2012-03-22",2012,3,82,0,42700,22900,65600
"TR","2012-03-23",2012,3,83,33200,42700,23200,99100
"TR","2012-03-24",2012,3,84,41200,42600,23300,107100
"TR","2012-03-25",2012,3,85,11400,41800,23200,76400
"TR","2012-03-26",2012,3,86,0,41200,23300,64500
"TR","2012-03-27",2012,3,87,0,40800,23500,64300
"TR","2012-03-28",2012,3,88,10600,40600,23600,74800
"TR","2012-03-29",2012,3,89,0,40000,23800,63800
"TR","2012-03-30",2012,3,90,0,39700,23900,63600
"TR","2012-03-31",2012,3,91,17700,39600,24000,81300
"TR","2012-04-01",2012,4,92,13700,39500,24000,77200
"TR","2012-04-02",2012,4,93,0,38900,24000,62900
"TR","2012-04-03",2012,4,94,31500,39300,24100,94900
"TR","2012-04-04",2012,4,95,87100,40500,24200,151800
"TR","2012-04-05",2012,4,96,959,39300,23700,63959
"TR","2012-04-06",2012,4,97,0,38700,23700,62400
"TR","2012-04-07",2012,4,98,0,38300,23800,62100
"TR","2012-04-08",2012,4,99,0,38100,23900,62000
"TR","2012-04-09",2012,4,100,60400,39000,24100,123500
"TR","2012-04-10",2012,4,101,0,38200,23700,61900
"TR","2012-04-11",2012,4,102,0,37800,23700,61500
"TR","2012-04-12",2012,4,103,0,37700,23800,61500
"TR","2012-04-13",2012,4,104,0,37600,23800,61400
"TR","2012-04-14",2012,4,105,0,37400,23900,61300
"TR","2012-04-15",2012,4,106,26000,37700,24000,87700
"TR","2012-04-16",2012,4,107,12900,37400,24000,74300
"TR","2012-04-17",2012,4,108,33900,37800,23900,95600
"TR","2012-04-18",2012,4,109,56300,38200,24000,118500
"TR","2012-04-19",2012,4,110,286000,42500,26500,355000
"TR","2012-04-20",2012,4,111,159000,46700,39200,244900
"TR","2012-04-21",2012,4,112,0,42700,22900,65600
"TR","2012-04-22",2012,4,113,0,41900,22500,64400
"TR","2012-04-23",2012,4,114,0,41300,22600,63900
"TR","2012-04-24",2012,4,115,0,40900,22600,63500
"TR","2012-04-25",2012,4,116,0,40600,22600,63200
"TR","2012-04-26",2012,4,117,0,40300,22700,63000
"TR","2012-04-27",2012,4,118,73400,41600,22900,137900
"TR","2012-04-28",2012,4,119,4820,40600,22500,67920
"TR","2012-04-29",2012,4,120,0,39800,22600,62400
"TR","2012-04-30",2012,4,121,0,39200,22700,61900
"TR","2012-05-01",2012,5,122,104000,41100,23100,168200
"TR","2012-05-02",2012,5,123,9980,40000,22700,72680
"TR","2012-05-03",2012,5,124,170000,43300,26700,240000
"TR","2012-05-04",2012,5,125,155000,45500,26900,227400
"TR","2012-05-05",2012,5,126,163000,46000,32700,241700
"TR","2012-05-06",2012,5,127,11400,43900,21900,77200
"TR","2012-05-07",2012,5,128,204000,49700,29900,283600
"TR","2012-05-08",2012,5,129,671000,90500,66200,827700
"TR","2012-05-09",2012,5,130,0,70700,20200,90900
"TR","2012-05-10",2012,5,131,14600,63800,20900,99300
"TR","2012-05-11",2012,5,132,0,57700,21400,79100
"TR","2012-05-12",2012,5,133,0,52400,21800,74200
"TR","2012-05-13",2012,5,134,11100,48200,22100,81400
"TR","2012-05-14",2012,5,135,0,45000,22300,67300
"TR","2012-05-15",2012,5,136,0,43900,22600,66500
"TR","2012-05-16",2012,5,137,0,42700,22900,65600
"TR","2012-05-17",2012,5,138,0,41800,23000,64800
"TR","2012-05-18",2012,5,139,0,41000,23100,64100
"TR","2012-05-19",2012,5,140,16600,40700,23200,80500
"TR","2012-05-20",2012,5,141,0,40000,23300,63300
"TR","2012-05-21",2012,5,142,0,39400,23500,62900
"TR","2012-05-22",2012,5,143,185000,41900,23800,250700
"TR","2012-05-23",2012,5,144,0,40200,23100,63300
"TR","2012-05-24",2012,5,145,0,39500,23300,62800
"TR","2012-05-25",2012,5,146,22200,39100,23400,84700
"TR","2012-05-26",2012,5,147,460000,48600,24500,533100
"TR","2012-05-27",2012,5,148,0,42800,22400,65200
"TR","2012-05-28",2012,5,149,404000,54600,23800,482400
"TR","2012-05-29",2012,5,150,0,46900,21800,68700
"TR","2012-05-30",2012,5,151,37600,45600,22400,105600
"TR","2012-05-31",2012,5,152,74200,45900,22700,142800
"TR","2012-06-01",2012,6,153,0,44600,22600,67200
"TR","2012-06-02",2012,6,154,0,43800,23100,66900
"TR","2012-06-03",2012,6,155,0,42700,23500,66200
"TR","2012-06-04",2012,6,156,0,41600,23700,65300
"TR","2012-06-05",2012,6,157,0,40800,23800,64600
"TR","2012-06-06",2012,6,158,4420,40100,24000,68520
"TR","2012-06-07",2012,6,159,21200,39700,24100,85000
"TR","2012-06-08",2012,6,160,0,38900,24200,63100
"TR","2012-06-09",2012,6,161,0,38300,24300,62600
"TR","2012-06-10",2012,6,162,52800,38500,24400,115700
"TR","2012-06-11",2012,6,163,0,37600,24400,62000
"TR","2012-06-12",2012,6,164,13300,37100,24600,75000
"TR","2012-06-13",2012,6,165,0,36200,24900,61100
"TR","2012-06-14",2012,6,166,0,35700,24900,60600
"TR","2012-06-15",2012,6,167,0,35100,25000,60100
"TR","2012-06-16",2012,6,168,467000,43900,25200,536100
"TR","2012-06-17",2012,6,169,2750,39900,23400,66050
"TR","2012-06-18",2012,6,170,60300,40000,24000,124300
"TR","2012-06-19",2012,6,171,552000,54500,35500,642000
"TR","2012-06-20",2012,6,172,111000,50400,24500,185900
"TR","2012-06-21",2012,6,173,81900,49600,24800,156300
"TR","2012-06-22",2012,6,174,1410000,128000,119000,1657000
"TR","2012-06-23",2012,6,175,0,91800,35800,127600
"TR","2012-06-24",2012,6,176,20800,86800,21300,128900
"TR","2012-06-25",2012,6,177,187000,88400,28100,303500
"TR","2012-06-26",2012,6,178,405000,103000,42900,550900
"TR","2012-06-27",2012,6,179,0,90500,21700,112200
"TR","2012-06-28",2012,6,180,0,84800,22400,107200
"TR","2012-06-29",2012,6,181,0,79900,23000,102900
"TR","2012-06-30",2012,6,182,0,74900,23500,98400
"TR","2012-07-01",2012,7,183,0,67800,24000,91800
"TR","2012-07-02",2012,7,184,0,59900,24500,84400
"TR","2012-07-03",2012,7,185,0,54100,24700,78800
"TR","2012-07-04",2012,7,186,393000,67700,25900,486600
"TR","2012-07-05",2012,7,187,4430,59000,24400,87830
"TR","2012-07-06",2012,7,188,0,53600,24700,78300
"TR","2012-07-07",2012,7,189,0,48800,25200,74000
"TR","2012-07-08",2012,7,190,302000,56300,26500,384800
"TR","2012-07-09",2012,7,191,0,50200,24900,75100
"TR","2012-07-10",2012,7,192,4430,47900,25400,77730
"TR","2012-07-11",2012,7,193,0,46500,25500,72000
"TR","2012-07-12",2012,7,194,0,45400,25700,71100
"TR","2012-07-13",2012,7,195,0,44300,25900,70200
"TR","2012-07-14",2012,7,196,0,43300,26100,69400
"TR","2012-07-15",2012,7,197,15400,42600,26100,84100
"TR","2012-07-16",2012,7,198,179000,45500,26200,250700
"TR","2012-07-17",2012,7,199,0,43600,25600,69200
"TR","2012-07-18",2012,7,200,0,42500,25900,68400
"TR","2012-07-19",2012,7,201,16500,41700,26000,84200
"TR","2012-07-20",2012,7,202,22100,41300,26100,89500
"TR","2012-07-21",2012,7,203,0,40600,26100,66700
"TR","2012-07-22",2012,7,204,0,40000,26300,66300
"TR","2012-07-23",2012,7,205,0,38800,26500,65300
"TR","2012-07-24",2012,7,206,13300,37900,26700,77900
"TR","2012-07-25",2012,7,207,0,36900,26800,63700
"TR","2012-07-26",2012,7,208,296000,42300,26700,365000
"TR","2012-07-27",2012,7,209,222000,45000,25700,292700
"TR","2012-07-28",2012,7,210,161000,45800,25200,232000
"TR","2012-07-29",2012,7,211,3910,43200,25100,72210
"TR","2012-07-30",2012,7,212,0,41500,25600,67100
"TR","2012-07-31",2012,7,213,1770,40500,25800,68070
"TR","2012-08-01",2012,8,214,0,39800,25900,65700
"TR","2012-08-02",2012,8,215,0,39200,26100,65300
"TR","2012-08-03",2012,8,216,118000,40900,26500,185400
"TR","2012-08-04",2012,8,217,0,39500,26300,65800
"TR","2012-08-05",2012,8,218,135000,41500,26700,203200
"TR","2012-08-06",2012,8,219,14400,40500,26400,81300
"TR","2012-08-07",2012,8,220,0,39600,26500,66100
"TR","2012-08-08",2012,8,221,35900,39600,26800,102300
"TR","2012-08-09",2012,8,222,0,38600,26900,65500
"TR","2012-08-10",2012,8,223,105000,40200,27000,172200
"TR","2012-08-11",2012,8,224,386000,48900,27400,462300
"TR","2012-08-12",2012,8,225,0,43700,25800,69500
"TR","2012-08-13",2012,8,226,0,42600,26400,69000
"TR","2012-08-14",2012,8,227,0,41400,26700,68100
"TR","2012-08-15",2012,8,228,92800,42400,27000,162200
"TR","2012-08-16",2012,8,229,0,40800,26800,67600
"TR","2012-08-17",2012,8,230,45000,41000,26900,112900
"TR","2012-08-18",2012,8,231,49200,41100,26900,117200
"TR","2012-08-19",2012,8,232,8650,40500,26800,75950
"TR","2012-08-20",2012,8,233,110000,42100,27100,179200
"TR","2012-08-21",2012,8,234,89200,42600,27000,158800
"TR","2012-08-22",2012,8,235,0,40800,26900,67700
"TR","2012-08-23",2012,8,236,0,39500,27300,66800
"TR","2012-08-24",2012,8,237,34200,39000,27400,100600
"TR","2012-08-25",2012,8,238,62800,39300,27300,129400
"TR","2012-08-26",2012,8,239,0,38400,27100,65500
"TR","2012-08-27",2012,8,240,0,37800,27200,65000
"TR","2012-08-28",2012,8,241,7990,36900,27500,72390
"TR","2012-08-29",2012,8,242,0,35800,27600,63400
"TR","2012-08-30",2012,8,243,0,35000,27700,62700
"TR","2012-08-31",2012,8,244,0,34200,27900,62100
"TR","2012-09-01",2012,9,245,0,33400,28100,61500
"TR","2012-09-02",2012,9,246,0,33100,28000,61100
"TR","2012-09-03",2012,9,247,0,32900,27900,60800
"TR","2012-09-04",2012,9,248,1320,32600,27800,61720
"TR","2012-09-05",2012,9,249,0,32400,27800,60200
"TR","2012-09-06",2012,9,250,1320,32100,27800,61220
"TR","2012-09-07",2012,9,251,54800,32800,27700,115300
"TR","2012-09-08",2012,9,252,131000,35000,27400,193400
"TR","2012-09-09",2012,9,253,66500,35600,26900,129000
"TR","2012-09-10",2012,9,254,73200,36400,26700,136300
"TR","2012-09-11",2012,9,255,25800,36300,26500,88600
"TR","2012-09-12",2012,9,256,0,35700,26600,62300
"TR","2012-09-13",2012,9,257,0,35100,26800,61900
"TR","2012-09-14",2012,9,258,27100,35000,26800,88900
"TR","2012-09-15",2012,9,259,0,34600,26700,61300
"TR","2012-09-16",2012,9,260,0,34400,26700,61100
"TR","2012-09-17",2012,9,261,0,34100,26800,60900
"TR","2012-09-18",2012,9,262,8270,33900,26800,68970
"TR","2012-09-19",2012,9,263,102000,35700,26700,164400
"TR","2012-09-20",2012,9,264,24500,35800,26300,86600
"TR","2012-09-21",2012,9,265,108000,37700,26300,172000
"TR","2012-09-22",2012,9,266,93200,38900,26200,158300
"TR","2012-09-23",2012,9,267,28200,38500,26000,92700
"TR","2012-09-24",2012,9,268,17300,38200,26000,81500
"TR","2012-09-25",2012,9,269,0,37600,25900,63500
"TR","2012-09-26",2012,9,270,0,37300,26100,63400
"TR","2012-09-27",2012,9,271,0,36900,26000,62900
"TR","2012-09-28",2012,9,272,0,36600,26000,62600
"TR","2012-09-29",2012,9,273,0,36300,26000,62300
"TR","2012-09-30",2012,9,274,0,35900,26000,61900
"TR","2012-10-01",2012,10,275,0,35600,26000,61600
"TR","2012-10-02",2012,10,276,0,35400,26000,61400
"TR","2012-10-03",2012,10,277,0,35000,26100,61100
"TR","2012-10-04",2012,10,278,0,34700,26100,60800
"TR","2012-10-05",2012,10,279,0,34500,26200,60700
"TR","2012-10-06",2012,10,280,0,34300,26300,60600
"TR","2012-10-07",2012,10,281,8180,34500,26200,68880
"TR","2012-10-08",2012,10,282,0,34500,26100,60600
"TR","2012-10-09",2012,10,283,0,34600,26100,60700
"TR","2012-10-10",2012,10,284,14100,35000,26100,75200
"TR","2012-10-11",2012,10,285,68400,36400,26000,130800
"TR","2012-10-12",2012,10,286,12800,36500,25700,75000
"TR","2012-10-13",2012,10,287,0,36200,25700,61900
"TR","2012-10-14",2012,10,288,20300,36400,25700,82400
"TR","2012-10-15",2012,10,289,21800,36600,25700,84100
"TR","2012-10-16",2012,10,290,7290,36400,25600,69290
"TR","2012-10-17",2012,10,291,11400,36500,25600,73500
"TR","2012-10-18",2012,10,292,2030,36200,25600,63830
"TR","2012-10-19",2012,10,293,266000,42900,26400,335300
"TR","2012-10-20",2012,10,294,59800,41000,24900,125700
"TR","2012-10-21",2012,10,295,0,40100,24600,64700
"TR","2012-10-22",2012,10,296,0,39300,24700,64000
"TR","2012-10-23",2012,10,297,0,38900,24800,63700
"TR","2012-10-24",2012,10,298,4000,38500,24900,67400
"TR","2012-10-25",2012,10,299,9380,38400,24900,72680
"TR","2012-10-26",2012,10,300,715000,66700,35000,816700
"TR","2012-10-27",2012,10,301,542000,73800,37200,653000
"TR","2012-10-28",2012,10,302,0,65700,23800,89500
"TR","2012-10-29",2012,10,303,0,60800,22400,83200
"TR","2012-10-30",2012,10,304,0,57400,24200,81600
"TR","2012-10-31",2012,10,305,0,55300,25700,81000
"TR","2012-11-01",2012,11,306,0,52600,24300,76900
"TR","2012-11-02",2012,11,307,0,50400,24900,75300
"TR","2012-11-03",2012,11,308,0,48500,24600,73100
"TR","2012-11-04",2012,11,309,0,46700,23900,70600
"TR","2012-11-05",2012,11,310,0,45700,23300,69000
"TR","2012-11-06",2012,11,311,0,45500,23400,68900
"TR","2012-11-07",2012,11,312,20000,45600,23400,89000
"TR","2012-11-08",2012,11,313,20900,45400,26500,92800
"TR","2012-11-09",2012,11,314,11500,45200,23600,80300
"TR","2012-11-10",2012,11,315,0,44600,23500,68100
"TR","2012-11-11",2012,11,316,0,44200,23500,67700
"TR","2012-11-12",2012,11,317,44700,44800,23600,113100
"TR","2012-11-13",2012,11,318,233000,53600,33500,320100
"TR","2012-11-14",2012,11,319,4320,49100,23300,76720
"TR","2012-11-15",2012,11,320,2160,46900,22900,71960
"TR","2012-11-16",2012,11,321,0,45300,23000,68300
"TR","2012-11-17",2012,11,322,0,44800,23100,67900
"TR","2012-11-18",2012,11,323,0,44300,23100,67400
"TR","2012-11-19",2012,11,324,0,43800,23100,66900
"TR","2012-11-20",2012,11,325,0,43500,23100,66600
"TR","2012-11-21",2012,11,326,0,43200,23100,66300
"TR","2012-11-22",2012,11,327,0,42900,23000,65900
"TR","2012-11-23",2012,11,328,0,42600,23000,65600
"TR","2012-11-24",2012,11,329,44300,43200,23100,110600
"TR","2012-11-25",2012,11,330,42500,42600,22600,107700
"TR","2012-11-26",2012,11,331,42500,42700,22400,107600
"TR","2012-11-27",2012,11,332,15100,42600,22500,80200
"TR","2012-11-28",2012,11,333,0,42400,22600,65000
"TR","2012-11-29",2012,11,334,37100,42500,22600,102200
"TR","2012-11-30",2012,11,335,0,42200,22700,64900
"TR","2012-12-01",2012,12,336,0,42000,22800,64800
"TR","2012-12-02",2012,12,337,0,41800,22900,64700
"TR","2012-12-03",2012,12,338,8500,42500,23200,74200
"TR","2012-12-04",2012,12,339,0,42300,23400,65700
"TR","2012-12-05",2012,12,340,10200,42000,23300,75500
"TR","2012-12-06",2012,12,341,0,41600,23200,64800
"TR","2012-12-07",2012,12,342,5620,41400,23200,70220
"TR","2012-12-08",2012,12,343,15200,41600,23200,80000
"TR","2012-12-09",2012,12,344,0,41300,23100,64400
"TR","2012-12-10",2012,12,345,0,41100,23100,64200
"TR","2012-12-11",2012,12,346,27300,41100,23000,91400
"TR","2012-12-12",2012,12,347,0,41000,23000,64000
"TR","2012-12-13",2012,12,348,4170,40900,23000,68070
"TR","2012-12-14",2012,12,349,0,40700,23000,63700
"TR","2012-12-15",2012,12,350,0,40600,23100,63700
"TR","2012-12-16",2012,12,351,0,40400,23100,63500
"TR","2012-12-17",2012,12,352,85400,42700,25900,154000
"TR","2012-12-18",2012,12,353,15500,41900,22700,80100
"TR","2012-12-19",2012,12,354,0,41400,22800,64200
"TR","2012-12-20",2012,12,355,0,41200,22800,64000
"TR","2012-12-21",2012,12,356,21600,41100,22800,85500
"TR","2012-12-22",2012,12,357,81900,41500,22500,145900
"TR","2012-12-23",2012,12,358,0,41300,22500,63800
"TR","2012-12-24",2012,12,359,10100,41200,22500,73800
"TR","2012-12-25",2012,12,360,0,41000,22600,63600
"TR","2012-12-26",2012,12,361,2340,40900,22600,65840
"TR","2012-12-27",2012,12,362,0,40700,22700,63400
"TR","2012-12-28",2012,12,363,0,40500,22700,63200
"TR","2012-12-29",2012,12,364,0,40400,22700,63100
"TR","2012-12-30",2012,12,365,10800,40300,22700,73800
"TR","2012-12-31",2012,12,366,1920,40100,22700,64720
"TR","2013-01-01",2013,1,1,0,40000,22700,62700
"TR","2013-01-02",2013,1,2,0,39900,22800,62700
"TR","2013-01-03",2013,1,3,0,39700,22800,62500
"TR","2013-01-04",2013,1,4,0,39600,22800,62400
"TR","2013-01-05",2013,1,5,0,39400,22800,62200
"TR","2013-01-06",2013,1,6,0,39300,22800,62100
"TR","2013-01-07",2013,1,7,9380,39200,22800,71380
"TR","2013-01-08",2013,1,8,2020,39100,22800,63920
"TR","2013-01-09",2013,1,9,0,38900,22800,61700
"TR","2013-01-10",2013,1,10,0,38800,22800,61600
"TR","2013-01-11",2013,1,11,0,38700,22800,61500
"TR","2013-01-12",2013,1,12,87500,39100,22400,149000
"TR","2013-01-13",2013,1,13,11400,40600,32000,84000
"TR","2013-01-14",2013,1,14,0,39900,23100,63000
"TR","2013-01-15",2013,1,15,3210,39500,22600,65310
"TR","2013-01-16",2013,1,16,0,39300,22500,61800
"TR","2013-01-17",2013,1,17,0,39100,22600,61700
"TR","2013-01-18",2013,1,18,6420,39100,22600,68120
"TR","2013-01-19",2013,1,19,18800,39000,22500,80300
"TR","2013-01-20",2013,1,20,53800,39300,22200,115300
"TR","2013-01-21",2013,1,21,75600,39600,21900,137100
"TR","2013-01-22",2013,1,22,0,39400,22000,61400
"TR","2013-01-23",2013,1,23,0,39300,22100,61400
"TR","2013-01-24",2013,1,24,0,39100,22100,61200
"TR","2013-01-25",2013,1,25,16300,39100,22100,77500
"TR","2013-01-26",2013,1,26,55800,39300,21900,117000
"TR","2013-01-27",2013,1,27,17200,39200,21900,78300
"TR","2013-01-28",2013,1,28,0,39100,22000,61100
"TR","2013-01-29",2013,1,29,222000,40200,21200,283400
"TR","2013-01-30",2013,1,30,145000,41000,20700,206700
"TR","2013-01-31",2013,1,31,30400,40900,20700,92000
"TR","2013-02-01",2013,2,32,156000,41600,20400,218000
"TR","2013-02-02",2013,2,33,2250,41300,20500,64050
"TR","2013-02-03",2013,2,34,0,41000,20800,61800
"TR","2013-02-04",2013,2,35,0,40700,21000,61700
"TR","2013-02-05",2013,2,36,0,40400,21100,61500
"TR","2013-02-06",2013,2,37,31000,40300,21100,92400
"TR","2013-02-07",2013,2,38,0,40100,21200,61300
"TR","2013-02-08",2013,2,39,35800,40100,21200,97100
"TR","2013-02-09",2013,2,40,0,39800,21300,61100
"TR","2013-02-10",2013,2,41,0,39600,21400,61000
"TR","2013-02-11",2013,2,42,0,39300,21500,60800
"TR","2013-02-12",2013,2,43,131000,39900,21000,191900
"TR","2013-02-13",2013,2,44,17100,39800,20900,77800
"TR","2013-02-14",2013,2,45,0,39600,21100,60700
"TR","2013-02-15",2013,2,46,4060,39300,21300,64660
"TR","2013-02-16",2013,2,47,1130,39100,21400,61630
"TR","2013-02-17",2013,2,48,0,38900,21500,60400
"TR","2013-02-18",2013,2,49,0,38700,21500,60200
"TR","2013-02-19",2013,2,50,0,38500,21600,60100
"TR","2013-02-20",2013,2,51,31200,38500,21500,91200
"TR","2013-02-21",2013,2,52,5400,38300,21500,65200
"TR","2013-02-22",2013,2,53,0,38200,21600,59800
"TR","2013-02-23",2013,2,54,6760,38000,21600,66360
"TR","2013-02-24",2013,2,55,60600,38200,21400,120200
"TR","2013-02-25",2013,2,56,12700,38100,21400,72200
"TR","2013-02-26",2013,2,57,0,37900,21500,59400
"TR","2013-02-27",2013,2,58,0,37700,21600,59300
"TR","2013-02-28",2013,2,59,0,37500,21700,59200
"TR","2013-03-01",2013,3,60,0,37400,21700,59100
"TR","2013-03-02",2013,3,61,0,37200,21800,59000
"TR","2013-03-03",2013,3,62,0,37000,21800,58800
"TR","2013-03-04",2013,3,63,0,36900,21800,58700
"TR","2013-03-05",2013,3,64,0,36700,21900,58600
"TR","2013-03-06",2013,3,65,0,36500,21900,58400
"TR","2013-03-07",2013,3,66,0,36300,22000,58300
"TR","2013-03-08",2013,3,67,0,36100,22000,58100
"TR","2013-03-09",2013,3,68,0,36000,22000,58000
"TR","2013-03-10",2013,3,69,0,35800,22100,57900
"TR","2013-03-11",2013,3,70,188000,37000,21300,246300
"TR","2013-03-12",2013,3,71,251000,38500,20300,309800
"TR","2013-03-13",2013,3,72,75900,38800,20000,134700
"TR","2013-03-14",2013,3,73,20500,38700,20200,79400
"TR","2013-03-15",2013,3,74,0,38400,20500,58900
"TR","2013-03-16",2013,3,75,0,38100,20700,58800
"TR","2013-03-17",2013,3,76,77200,38400,20600,136200
"TR","2013-03-18",2013,3,77,0,38100,20600,58700
"TR","2013-03-19",2013,3,78,0,37900,20800,58700
"TR","2013-03-20",2013,3,79,137000,38600,20400,196000
"TR","2013-03-21",2013,3,80,0,38300,20400,58700
"TR","2013-03-22",2013,3,81,0,38000,20600,58600
"TR","2013-03-23",2013,3,82,0,37800,20800,58600
"TR","2013-03-24",2013,3,83,0,37500,21000,58500
"TR","2013-03-25",2013,3,84,0,37200,21100,58300
"TR","2013-03-26",2013,3,85,0,36900,21200,58100
"TR","2013-03-27",2013,3,86,0,36700,21400,58100
"TR","2013-03-28",2013,3,87,0,36300,21500,57800
"TR","2013-03-29",2013,3,88,0,36000,21600,57600
"TR","2013-03-30",2013,3,89,0,35600,21700,57300
"TR","2013-03-31",2013,3,90,80400,35700,21500,137600
"TR","2013-04-01",2013,4,91,205000,38000,20700,263700
"TR","2013-04-02",2013,4,92,0,37300,20600,57900
"TR","2013-04-03",2013,4,93,0,36800,20800,57600
"TR","2013-04-04",2013,4,94,0,36500,21000,57500
"TR","2013-04-05",2013,4,95,0,36300,21200,57500
"TR","2013-04-06",2013,4,96,0,36000,21300,57300
"TR","2013-04-07",2013,4,97,126000,36700,20800,183500
"TR","2013-04-08",2013,4,98,218000,39100,20200,277300
"TR","2013-04-09",2013,4,99,156000,41600,29600,227200
"TR","2013-04-10",2013,4,100,193000,47500,42200,282700
"TR","2013-04-11",2013,4,101,0,44100,23500,67600
"TR","2013-04-12",2013,4,102,0,43600,22800,66400
"TR","2013-04-13",2013,4,103,158000,44000,21000,223000
"TR","2013-04-14",2013,4,104,87700,43900,19800,151400
"TR","2013-04-15",2013,4,105,30800,43500,20000,94300
"TR","2013-04-16",2013,4,106,659000,54700,18400,732100
"TR","2013-04-17",2013,4,107,0,50500,18100,68600
"TR","2013-04-18",2013,4,108,0,47000,18700,65700
"TR","2013-04-19",2013,4,109,86400,48000,24500,158900
"TR","2013-04-20",2013,4,110,369000,54300,20200,443500
"TR","2013-04-21",2013,4,111,57400,51600,18100,127100
"TR","2013-04-22",2013,4,112,0,48100,18500,66600
"TR","2013-04-23",2013,4,113,76300,47000,18800,142100
"TR","2013-04-24",2013,4,114,551000,58600,17900,627500
"TR","2013-04-25",2013,4,115,0,53500,17600,71100
"TR","2013-04-26",2013,4,116,31400,53200,24900,109500
"TR","2013-04-27",2013,4,117,43600,57800,33100,134500
"TR","2013-04-28",2013,4,118,5760,78700,74100,158560
"TR","2013-04-29",2013,4,119,0,69800,39300,109100
"TR","2013-04-30",2013,4,120,60600,419000,643000,1122600
"TR","2013-05-01",2013,5,121,54200,561000,889000,1504200
"TR","2013-05-02",2013,5,122,103000,541000,615000,1259000
"TR","2013-05-03",2013,5,123,76800,168000,30400,275200
"TR","2013-05-04",2013,5,124,191000,153000,18400,362400
"TR","2013-05-05",2013,5,125,165000,145000,17900,327900
"TR","2013-05-06",2013,5,126,0,139000,24300,163300
"TR","2013-05-07",2013,5,127,0,141000,41200,182200
"TR","2013-05-08",2013,5,128,0,128000,24900,152900
"TR","2013-05-09",2013,5,129,0,122000,22700,144700
"TR","2013-05-10",2013,5,130,0,117000,23300,140300
"TR","2013-05-11",2013,5,131,227000,115000,24900,366900
"TR","2013-05-12",2013,5,132,19000,111000,26100,156100
"TR","2013-05-13",2013,5,133,13600,106000,25700,145300
"TR","2013-05-14",2013,5,134,0,102000,26200,128200
"TR","2013-05-15",2013,5,135,0,98200,27000,125200
"TR","2013-05-16",2013,5,136,0,93800,27300,121100
"TR","2013-05-17",2013,5,137,4430,90000,27100,121530
"TR","2013-05-18",2013,5,138,4200,86700,27300,118200
"TR","2013-05-19",2013,5,139,70700,84000,27400,182100
"TR","2013-05-20",2013,5,140,216000,85700,28300,330000
"TR","2013-05-21",2013,5,141,164000,84900,28700,277600
"TR","2013-05-22",2013,5,142,314000,89500,33500,437000
"TR","2013-05-23",2013,5,143,227000,91100,43200,361300
"TR","2013-05-24",2013,5,144,25500,83500,27900,136900
"TR","2013-05-25",2013,5,145,4250,78800,28300,111350
"TR","2013-05-26",2013,5,146,0,72100,28600,100700
"TR","2013-05-27",2013,5,147,0,66200,29000,95200
"TR","2013-05-28",2013,5,148,0,61200,28800,90000
"TR","2013-05-29",2013,5,149,0,57500,28900,86400
"TR","2013-05-30",2013,5,150,10400,55000,28900,94300
"TR","2013-05-31",2013,5,151,265000,64600,31100,360700
"TR","2013-06-01",2013,6,152,332000,80900,48300,461200
"TR","2013-06-02",2013,6,153,351000,92500,54200,497700
"TR","2013-06-03",2013,6,154,84600,83800,31800,200200
"TR","2013-06-04",2013,6,155,0,75200,28800,104000
"TR","2013-06-05",2013,6,156,0,69700,29500,99200
"TR","2013-06-06",2013,6,157,68700,67700,30300,166700
"TR","2013-06-07",2013,6,158,445000,95100,52700,592800
"TR","2013-06-08",2013,6,159,113000,85800,34500,233300
"TR","2013-06-09",2013,6,160,10000,76900,29800,116700
"TR","2013-06-10",2013,6,161,0,70700,30100,100800
"TR","2013-06-11",2013,6,162,17600,66500,30500,114600
"TR","2013-06-12",2013,6,163,0,62100,30500,92600
"TR","2013-06-13",2013,6,164,0,58000,30900,88900
"TR","2013-06-14",2013,6,165,0,54800,30700,85500
"TR","2013-06-15",2013,6,166,0,52800,30700,83500
"TR","2013-06-16",2013,6,167,7590,51600,30800,89990
"TR","2013-06-17",2013,6,168,251000,60300,32300,343600
"TR","2013-06-18",2013,6,169,125000,61900,32200,219100
"TR","2013-06-19",2013,6,170,5490,57600,31700,94790
"TR","2013-06-20",2013,6,171,0,54300,31500,85800
"TR","2013-06-21",2013,6,172,0,52100,31700,83800
"TR","2013-06-22",2013,6,173,614000,83700,36700,734400
"TR","2013-06-23",2013,6,174,89700,71900,31400,193000
"TR","2013-06-24",2013,6,175,5090,65600,30900,101590
"TR","2013-06-25",2013,6,176,288000,85000,40800,413800
"TR","2013-06-26",2013,6,177,0,72800,30900,103700
"TR","2013-06-27",2013,6,178,0,67000,31300,98300
"TR","2013-06-28",2013,6,179,157000,69300,32800,259100
"TR","2013-06-29",2013,6,180,618000,106000,82500,806500
"TR","2013-06-30",2013,6,181,126000,92200,35800,254000
"TR","2013-07-01",2013,7,182,11300,85600,30600,127500
"TR","2013-07-02",2013,7,183,0,77400,30900,108300
"TR","2013-07-03",2013,7,184,0,69300,31300,100600
"TR","2013-07-04",2013,7,185,0,61700,31000,92700
"TR","2013-07-05",2013,7,186,0,57400,30700,88100
"TR","2013-07-06",2013,7,187,0,54100,30800,84900
"TR","2013-07-07",2013,7,188,0,52100,31000,83100
"TR","2013-07-08",2013,7,189,424000,67000,32300,523300
"TR","2013-07-09",2013,7,190,259000,71600,32600,363200
"TR","2013-07-10",2013,7,191,0,62800,31000,93800
"TR","2013-07-11",2013,7,192,280000,73700,34200,387900
"TR","2013-07-12",2013,7,193,0,64900,31100,96000
"TR","2013-07-13",2013,7,194,0,60500,31500,92000
"TR","2013-07-14",2013,7,195,0,56400,31500,87900
"TR","2013-07-15",2013,7,196,0,53100,31300,84400
"TR","2013-07-16",2013,7,197,0,51800,31200,83000
"TR","2013-07-17",2013,7,198,8710,50700,31200,90610
"TR","2013-07-18",2013,7,199,0,49600,31200,80800
"TR","2013-07-19",2013,7,200,32300,49200,31200,112700
"TR","2013-07-20",2013,7,201,13300,48300,31200,92800
"TR","2013-07-21",2013,7,202,0,47200,31200,78400
"TR","2013-07-22",2013,7,203,0,46500,31300,77800
"TR","2013-07-23",2013,7,204,0,45900,31300,77200
"TR","2013-07-24",2013,7,205,106000,47400,31400,184800
"TR","2013-07-25",2013,7,206,0,45900,30900,76800
"TR","2013-07-26",2013,7,207,0,45400,31000,76400
"TR","2013-07-27",2013,7,208,86700,46600,31100,164400
"TR","2013-07-28",2013,7,209,20200,45900,30800,96900
"TR","2013-07-29",2013,7,210,24300,45700,30900,100900
"TR","2013-07-30",2013,7,211,8480,45300,30900,84680
"TR","2013-07-31",2013,7,212,20500,44800,31100,96400
"TR","2013-08-01",2013,8,213,7450,43900,31000,82350
"TR","2013-08-02",2013,8,214,2110,43300,31100,76510
"TR","2013-08-03",2013,8,215,26200,43500,31300,101000
"TR","2013-08-04",2013,8,216,0,42800,31400,74200
"TR","2013-08-05",2013,8,217,0,42500,31500,74000
"TR","2013-08-06",2013,8,218,4550,42200,31600,78350
"TR","2013-08-07",2013,8,219,422000,51600,32700,506300
"TR","2013-08-08",2013,8,220,276000,54300,31900,362200
"TR","2013-08-09",2013,8,221,0,50400,30300,80700
"TR","2013-08-10",2013,8,222,11000,49600,30900,91500
"TR","2013-08-11",2013,8,223,0,48600,31200,79800
"TR","2013-08-12",2013,8,224,0,47900,31400,79300
"TR","2013-08-13",2013,8,225,52400,48100,31700,132200
"TR","2013-08-14",2013,8,226,13100,47100,31900,92100
"TR","2013-08-15",2013,8,227,0,46200,31700,77900
"TR","2013-08-16",2013,8,228,0,45800,31800,77600
"TR","2013-08-17",2013,8,229,0,45000,32000,77000
"TR","2013-08-18",2013,8,230,0,43900,32000,75900
"TR","2013-08-19",2013,8,231,0,42900,32100,75000
"TR","2013-08-20",2013,8,232,12000,42400,31900,86300
"TR","2013-08-21",2013,8,233,0,41800,31800,73600
"TR","2013-08-22",2013,8,234,0,41400,31800,73200
"TR","2013-08-23",2013,8,235,106000,42700,31900,180600
"TR","2013-08-24",2013,8,236,0,41200,31700,72900
"TR","2013-08-25",2013,8,237,0,40200,31900,72100
"TR","2013-08-26",2013,8,238,0,39100,32000,71100
"TR","2013-08-27",2013,8,239,6e+05,53400,33300,686700
"TR","2013-08-28",2013,8,240,940000,97200,85200,1122400
"TR","2013-08-29",2013,8,241,2660,77100,30700,110460
"TR","2013-08-30",2013,8,242,0,69700,28600,98300
"TR","2013-08-31",2013,8,243,891000,115000,89800,1095800
"TR","2013-09-01",2013,9,244,0,92100,31400,123500
"TR","2013-09-02",2013,9,245,10100,86500,28200,124800
"TR","2013-09-03",2013,9,246,6180,81600,29000,116780
"TR","2013-09-04",2013,9,247,5280,75900,29500,110680
"TR","2013-09-05",2013,9,248,0,70000,30000,1e+05
"TR","2013-09-06",2013,9,249,0,65500,30400,95900
"TR","2013-09-07",2013,9,250,0,61700,30700,92400
"TR","2013-09-08",2013,9,251,5380,58400,31000,94780
"TR","2013-09-09",2013,9,252,0,55600,31100,86700
"TR","2013-09-10",2013,9,253,21700,54100,31200,107000
"TR","2013-09-11",2013,9,254,33900,53400,31600,118900
"TR","2013-09-12",2013,9,255,6770,51600,31500,89870
"TR","2013-09-13",2013,9,256,0,50600,31600,82200
"TR","2013-09-14",2013,9,257,0,50100,31600,81700
"TR","2013-09-15",2013,9,258,0,49600,31700,81300
"TR","2013-09-16",2013,9,259,93900,51300,32200,177400
"TR","2013-09-17",2013,9,260,11800,50600,31700,94100
"TR","2013-09-18",2013,9,261,0,50000,31700,81700
"TR","2013-09-19",2013,9,262,12700,49700,31900,94300
"TR","2013-09-20",2013,9,263,2850,49000,31900,83750
"TR","2013-09-21",2013,9,264,133000,51500,32800,217300
"TR","2013-09-22",2013,9,265,12100,50100,32000,94200
"TR","2013-09-23",2013,9,266,7170,49400,31900,88470
"TR","2013-09-24",2013,9,267,7500,49100,32000,88600
"TR","2013-09-25",2013,9,268,0,48500,31900,80400
"TR","2013-09-26",2013,9,269,0,48000,32000,80000
"TR","2013-09-27",2013,9,270,0,47500,32000,79500
"TR","2013-09-28",2013,9,271,0,47000,32000,79000
"TR","2013-09-29",2013,9,272,0,46400,31900,78300
"TR","2013-09-30",2013,9,273,114000,48800,32100,194900
"TR","2013-10-01",2013,10,274,0,48300,31700,80000
"TR","2013-10-02",2013,10,275,0,47800,32000,79800
"TR","2013-10-03",2013,10,276,0,46900,31900,78800
"TR","2013-10-04",2013,10,277,372000,59900,34000,465900
"TR","2013-10-05",2013,10,278,68300,58000,31200,157500
"TR","2013-10-06",2013,10,279,229000,71200,32600,332800
"TR","2013-10-07",2013,10,280,436000,95500,60000,591500
"TR","2013-10-08",2013,10,281,91600,85700,37100,214400
"TR","2013-10-09",2013,10,282,0,78200,29400,107600
"TR","2013-10-10",2013,10,283,0,71500,29400,100900
"TR","2013-10-11",2013,10,284,0,66600,29700,96300
"TR","2013-10-12",2013,10,285,0,62900,30000,92900
"TR","2013-10-13",2013,10,286,0,60200,30300,90500
"TR","2013-10-14",2013,10,287,2750,58300,30400,91450
"TR","2013-10-15",2013,10,288,0,56800,30400,87200
"TR","2013-10-16",2013,10,289,109000,61200,30900,201100
"TR","2013-10-17",2013,10,290,306000,81700,45800,433500
"TR","2013-10-18",2013,10,291,8570,71400,30900,110870
"TR","2013-10-19",2013,10,292,84700,72700,34800,192200
"TR","2013-10-20",2013,10,293,57200,72300,34900,164400
"TR","2013-10-21",2013,10,294,72300,73500,34900,180700
"TR","2013-10-22",2013,10,295,145000,77700,38900,261600
"TR","2013-10-23",2013,10,296,67600,73500,29900,171000
"TR","2013-10-24",2013,10,297,1340,74500,36200,112040
"TR","2013-10-25",2013,10,298,17300,69700,31200,118200
"TR","2013-10-26",2013,10,299,9360,66900,30400,106660
"TR","2013-10-27",2013,10,300,33700,66100,30900,130700
"TR","2013-10-28",2013,10,301,9030,63900,31000,103930
"TR","2013-10-29",2013,10,302,130000,71000,36600,237600
"TR","2013-10-30",2013,10,303,0,67300,31500,98800
"TR","2013-10-31",2013,10,304,35600,67400,33100,136100
"TR","2013-11-01",2013,11,305,50700,68400,34400,153500
"TR","2013-11-02",2013,11,306,40600,68100,35200,143900
"TR","2013-11-03",2013,11,307,43500,66200,31600,141300
"TR","2013-11-04",2013,11,308,51600,66100,31900,149600
"TR","2013-11-05",2013,11,309,0,63900,32600,96500
"TR","2013-11-06",2013,11,310,47000,64500,32600,144100
"TR","2013-11-07",2013,11,311,215000,75100,41700,331800
"TR","2013-11-08",2013,11,312,0,69100,31400,100500
"TR","2013-11-09",2013,11,313,4320,66400,31300,102020
"TR","2013-11-10",2013,11,314,132000,67800,30900,230700
"TR","2013-11-11",2013,11,315,3360,68300,34900,106560
"TR","2013-11-12",2013,11,316,30000,68100,34800,132900
"TR","2013-11-13",2013,11,317,6010,65200,31700,102910
"TR","2013-11-14",2013,11,318,0,63200,31800,95000
"TR","2013-11-15",2013,11,319,0,61700,32100,93800
"TR","2013-11-16",2013,11,320,0,60400,32400,92800
"TR","2013-11-17",2013,11,321,0,59700,36500,96200
"TR","2013-11-18",2013,11,322,161000,71100,44000,276100
"TR","2013-11-19",2013,11,323,18400,67600,34200,120200
"TR","2013-11-20",2013,11,324,0,64200,31700,95900
"TR","2013-11-21",2013,11,325,0,62400,31900,94300
"TR","2013-11-22",2013,11,326,126000,65200,31900,223100
"TR","2013-11-23",2013,11,327,64600,65200,31500,161300
"TR","2013-11-24",2013,11,328,18500,63900,31600,114000
"TR","2013-11-25",2013,11,329,8480,62700,31800,102980
"TR","2013-11-26",2013,11,330,0,61500,31900,93400
"TR","2013-11-27",2013,11,331,2530,60500,32100,95130
"TR","2013-11-28",2013,11,332,9960,59900,32200,102060
"TR","2013-11-29",2013,11,333,26500,59800,32200,118500
"TR","2013-11-30",2013,11,334,2160,59100,32200,93460
"TR","2013-12-01",2013,12,335,0,58400,32400,90800
"TR","2013-12-02",2013,12,336,0,57900,32400,90300
"TR","2013-12-03",2013,12,337,0,57500,32500,90000
"TR","2013-12-04",2013,12,338,88500,59300,32100,179900
"TR","2013-12-05",2013,12,339,53300,60000,31800,145100
"TR","2013-12-06",2013,12,340,185000,63500,31100,279600
"TR","2013-12-07",2013,12,341,0,61900,31100,93000
"TR","2013-12-08",2013,12,342,0,60600,31400,92000
"TR","2013-12-09",2013,12,343,0,59600,31600,91200
"TR","2013-12-10",2013,12,344,29200,59400,31600,120200
"TR","2013-12-11",2013,12,345,11900,58900,31600,102400
"TR","2013-12-12",2013,12,346,0,58200,31700,89900
"TR","2013-12-13",2013,12,347,0,57600,31800,89400
"TR","2013-12-14",2013,12,348,6270,57200,31900,95370
"TR","2013-12-15",2013,12,349,1210,56800,31900,89910
"TR","2013-12-16",2013,12,350,21100,56900,31800,109800
"TR","2013-12-17",2013,12,351,0,56500,31900,88400
"TR","2013-12-18",2013,12,352,22100,56700,31800,110600
"TR","2013-12-19",2013,12,353,1120,56300,31800,89220
"TR","2013-12-20",2013,12,354,0,55900,31900,87800
"TR","2013-12-21",2013,12,355,26600,56200,31800,114600
"TR","2013-12-22",2013,12,356,4850,55900,31700,92450
"TR","2013-12-23",2013,12,357,0,55500,31800,87300
"TR","2013-12-24",2013,12,358,30600,55900,31700,118200
"TR","2013-12-25",2013,12,359,0,55500,31700,87200
"TR","2013-12-26",2013,12,360,45900,56400,31500,133800
"TR","2013-12-27",2013,12,361,3130,55900,31500,90530
"TR","2013-12-28",2013,12,362,0,55500,31500,87000
"TR","2013-12-29",2013,12,363,0,55000,31600,86600
"TR","2013-12-30",2013,12,364,710,54700,31600,87010
"TR","2013-12-31",2013,12,365,0,54400,31600,86000
"TR","2014-01-01",2014,1,1,0,54200,31600,85800
"TR","2014-01-02",2014,1,2,0,54000,31600,85600
"TR","2014-01-03",2014,1,3,0,53800,31600,85400
"TR","2014-01-04",2014,1,4,0,53600,31500,85100
"TR","2014-01-05",2014,1,5,62000,55000,31200,148200
"TR","2014-01-06",2014,1,6,0,54500,31200,85700
"TR","2014-01-07",2014,1,7,0,54100,31200,85300
"TR","2014-01-08",2014,1,8,0,53700,31200,84900
"TR","2014-01-09",2014,1,9,0,53400,31200,84600
"TR","2014-01-10",2014,1,10,0,53200,31200,84400
"TR","2014-01-11",2014,1,11,0,53000,31200,84200
"TR","2014-01-12",2014,1,12,110000,55400,30700,196100
"TR","2014-01-13",2014,1,13,0,54600,30600,85200
"TR","2014-01-14",2014,1,14,0,53800,30800,84600
"TR","2014-01-15",2014,1,15,0,53300,30800,84100
"TR","2014-01-16",2014,1,16,8980,53100,30800,92880
"TR","2014-01-17",2014,1,17,59400,54100,30600,144100
"TR","2014-01-18",2014,1,18,72200,55300,30200,157700
"TR","2014-01-19",2014,1,19,0,54400,30200,84600
"TR","2014-01-20",2014,1,20,8490,53900,30300,92690
"TR","2014-01-21",2014,1,21,3750,53300,30400,87450
"TR","2014-01-22",2014,1,22,1880,52900,30400,85180
"TR","2014-01-23",2014,1,23,30800,53200,30300,114300
"TR","2014-01-24",2014,1,24,21700,53200,30200,105100
"TR","2014-01-25",2014,1,25,3750,52700,30200,86650
"TR","2014-01-26",2014,1,26,38300,53200,30100,121600
"TR","2014-01-27",2014,1,27,17400,53000,30000,100400
"TR","2014-01-28",2014,1,28,32100,53300,29900,115300
"TR","2014-01-29",2014,1,29,0,52700,29900,82600
"TR","2014-01-30",2014,1,30,0,52100,30000,82100
"TR","2014-01-31",2014,1,31,13000,52000,30000,95000
"TR","2014-02-01",2014,2,32,172000,55700,29300,257000
"TR","2014-02-02",2014,2,33,0,54500,29200,83700
"TR","2014-02-03",2014,2,34,0,53500,29400,82900
"TR","2014-02-04",2014,2,35,0,52700,29500,82200
"TR","2014-02-05",2014,2,36,0,52100,29600,81700
"TR","2014-02-06",2014,2,37,0,51500,29600,81100
"TR","2014-02-07",2014,2,38,0,51100,29700,80800
"TR","2014-02-08",2014,2,39,0,50800,29700,80500
"TR","2014-02-09",2014,2,40,0,50700,29700,80400
"TR","2014-02-10",2014,2,41,0,50500,29700,80200
"TR","2014-02-11",2014,2,42,0,50400,29700,80100
"TR","2014-02-12",2014,2,43,0,50300,29700,80000
"TR","2014-02-13",2014,2,44,14100,50300,29700,94100
"TR","2014-02-14",2014,2,45,0,50100,29600,79700
"TR","2014-02-15",2014,2,46,62300,50400,29400,142100
"TR","2014-02-16",2014,2,47,0,50300,29300,79600
"TR","2014-02-17",2014,2,48,31500,50400,29200,111100
"TR","2014-02-18",2014,2,49,15100,50300,29200,94600
"TR","2014-02-19",2014,2,50,55100,51300,29000,135400
"TR","2014-02-20",2014,2,51,0,50600,29000,79600
"TR","2014-02-21",2014,2,52,0,50200,29100,79300
"TR","2014-02-22",2014,2,53,217000,54500,28300,299800
"TR","2014-02-23",2014,2,54,31800,53800,28000,113600
"TR","2014-02-24",2014,2,55,0,52600,28200,80800
"TR","2014-02-25",2014,2,56,0,51500,28400,79900
"TR","2014-02-26",2014,2,57,0,50700,28500,79200
"TR","2014-02-27",2014,2,58,0,50100,28600,78700
"TR","2014-02-28",2014,2,59,30800,50200,28600,109600
"TR","2014-03-01",2014,3,60,0,49900,28600,78500
"TR","2014-03-02",2014,3,61,9310,49800,28600,87710
"TR","2014-03-03",2014,3,62,0,49600,28700,78300
"TR","2014-03-04",2014,3,63,0,49400,28700,78100
"TR","2014-03-05",2014,3,64,50700,49600,28500,128800
"TR","2014-03-06",2014,3,65,0,49400,28500,77900
"TR","2014-03-07",2014,3,66,0,49200,28500,77700
"TR","2014-03-08",2014,3,67,31000,49100,28500,108600
"TR","2014-03-09",2014,3,68,4140,48900,28500,81540
"TR","2014-03-10",2014,3,69,0,48700,28500,77200
"TR","2014-03-11",2014,3,70,0,48500,28600,77100
"TR","2014-03-12",2014,3,71,0,48000,28800,76800
"TR","2014-03-13",2014,3,72,0,47800,28900,76700
"TR","2014-03-14",2014,3,73,0,47600,28800,76400
"TR","2014-03-15",2014,3,74,0,47400,28800,76200
"TR","2014-03-16",2014,3,75,45900,47400,28600,121900
"TR","2014-03-17",2014,3,76,0,47300,28500,75800
"TR","2014-03-18",2014,3,77,4140,47200,28500,79840
"TR","2014-03-19",2014,3,78,71400,47600,28200,147200
"TR","2014-03-20",2014,3,79,118000,48200,27700,193900
"TR","2014-03-21",2014,3,80,21000,48100,27600,96700
"TR","2014-03-22",2014,3,81,0,47900,27800,75700
"TR","2014-03-23",2014,3,82,77500,48100,27600,153200
"TR","2014-03-24",2014,3,83,0,47900,27600,75500
"TR","2014-03-25",2014,3,84,0,47700,27800,75500
"TR","2014-03-26",2014,3,85,1310,47500,27800,76610
"TR","2014-03-27",2014,3,86,0,47400,27900,75300
"TR","2014-03-28",2014,3,87,0,47200,27900,75100
"TR","2014-03-29",2014,3,88,245000,48500,27000,320500
"TR","2014-03-30",2014,3,89,0,48300,26900,75200
"TR","2014-03-31",2014,3,90,0,47900,27200,75100
"TR","2014-04-01",2014,4,91,0,47500,27500,75000
"TR","2014-04-02",2014,4,92,0,47200,27600,74800
"TR","2014-04-03",2014,4,93,1410,47000,27700,76110
"TR","2014-04-04",2014,4,94,0,46700,27700,74400
"TR","2014-04-05",2014,4,95,386000,50600,26200,462800
"TR","2014-04-06",2014,4,96,202000,54600,25300,281900
"TR","2014-04-07",2014,4,97,2820,52400,25500,80720
"TR","2014-04-08",2014,4,98,0,50400,25900,76300
"TR","2014-04-09",2014,4,99,0,48800,26300,75100
"TR","2014-04-10",2014,4,100,0,48500,26500,75000
"TR","2014-04-11",2014,4,101,1920,53600,30300,85820
"TR","2014-04-12",2014,4,102,0,53100,35500,88600
"TR","2014-04-13",2014,4,103,111000,61400,41800,214200
"TR","2014-04-14",2014,4,104,105000,74500,54500,234000
"TR","2014-04-15",2014,4,105,114000,73100,39000,226100
"TR","2014-04-16",2014,4,106,0,65800,27900,93700
"TR","2014-04-17",2014,4,107,0,61800,27200,89000
"TR","2014-04-18",2014,4,108,724000,76100,25100,825200
"TR","2014-04-19",2014,4,109,0,70200,24900,95100
"TR","2014-04-20",2014,4,110,0,65500,25600,91100
"TR","2014-04-21",2014,4,111,26900,65300,29700,121900
"TR","2014-04-22",2014,4,112,0,71800,45100,116900
"TR","2014-04-23",2014,4,113,0,74200,46100,120300
"TR","2014-04-24",2014,4,114,0,68500,32800,101300
"TR","2014-04-25",2014,4,115,35600,81100,51700,168400
"TR","2014-04-26",2014,4,116,231000,96500,59100,386600
"TR","2014-04-27",2014,4,117,29100,90200,41200,160500
"TR","2014-04-28",2014,4,118,0,85200,37700,122900
"TR","2014-04-29",2014,4,119,57800,93300,49300,200400
"TR","2014-04-30",2014,4,120,17000,102000,65300,184300
"TR","2014-05-01",2014,5,121,247000,108000,67100,422100
"TR","2014-05-02",2014,5,122,2e+05,148000,111000,459000
"TR","2014-05-03",2014,5,123,17000,105000,50200,172200
"TR","2014-05-04",2014,5,124,48700,102000,54800,205500
"TR","2014-05-05",2014,5,125,22200,97000,36000,155200
"TR","2014-05-06",2014,5,126,83100,96200,40100,219400
"TR","2014-05-07",2014,5,127,7000,91400,37000,135400
"TR","2014-05-08",2014,5,128,0,87900,37400,125300
"TR","2014-05-09",2014,5,129,187000,94200,48100,329300
"TR","2014-05-10",2014,5,130,776000,143000,109000,1028000
"TR","2014-05-11",2014,5,131,22500,106000,39500,168000
"TR","2014-05-12",2014,5,132,10400,101000,37800,149200
"TR","2014-05-13",2014,5,133,432000,124000,73400,629400
"TR","2014-05-14",2014,5,134,44600,106000,41700,192300
"TR","2014-05-15",2014,5,135,7240,101000,39700,147940
"TR","2014-05-16",2014,5,136,0,97400,40300,137700
"TR","2014-05-17",2014,5,137,0,94400,41000,135400
"TR","2014-05-18",2014,5,138,0,91600,41300,132900
"TR","2014-05-19",2014,5,139,0,88400,41500,129900
"TR","2014-05-20",2014,5,140,0,83400,41500,124900
"TR","2014-05-21",2014,5,141,715000,129000,85400,929400
"TR","2014-05-22",2014,5,142,4200,102000,41400,147600
"TR","2014-05-23",2014,5,143,0,96200,41700,137900
"TR","2014-05-24",2014,5,144,0,93100,42400,135500
"TR","2014-05-25",2014,5,145,0,88700,42200,130900
"TR","2014-05-26",2014,5,146,0,82600,41800,124400
"TR","2014-05-27",2014,5,147,0,77600,40900,118500
"TR","2014-05-28",2014,5,148,196000,83700,43700,323400
"TR","2014-05-29",2014,5,149,0,78600,41900,120500
"TR","2014-05-30",2014,5,150,0,74600,42000,116600
"TR","2014-05-31",2014,5,151,0,70100,41300,111400
"TR","2014-06-01",2014,6,152,0,66700,40800,107500
"TR","2014-06-02",2014,6,153,165000,71800,41700,278500
"TR","2014-06-03",2014,6,154,205000,79100,43400,327500
"TR","2014-06-04",2014,6,155,306000,93600,46700,446300
"TR","2014-06-05",2014,6,156,1400,83200,42400,127000
"TR","2014-06-06",2014,6,157,0,78500,42300,120800
"TR","2014-06-07",2014,6,158,48600,76800,42700,168100
"TR","2014-06-08",2014,6,159,64400,76100,42800,183300
"TR","2014-06-09",2014,6,160,53400,74900,42600,170900
"TR","2014-06-10",2014,6,161,0,71500,41800,113300
"TR","2014-06-11",2014,6,162,1400,69200,41700,112300
"TR","2014-06-12",2014,6,163,0,67000,41400,108400
"TR","2014-06-13",2014,6,164,105000,69600,42000,216600
"TR","2014-06-14",2014,6,165,34200,68700,41400,144300
"TR","2014-06-15",2014,6,166,0,66400,40900,107300
"TR","2014-06-16",2014,6,167,444000,92400,47700,584100
"TR","2014-06-17",2014,6,168,118000,86600,43200,247800
"TR","2014-06-18",2014,6,169,8240,79900,41400,129540
"TR","2014-06-19",2014,6,170,0,74900,41000,115900
"TR","2014-06-20",2014,6,171,0,71300,40700,112000
"TR","2014-06-21",2014,6,172,227000,80600,43900,351500
"TR","2014-06-22",2014,6,173,53300,78100,42400,173800
"TR","2014-06-23",2014,6,174,0,73600,41200,114800
"TR","2014-06-24",2014,6,175,383000,100000,49100,532100
"TR","2014-06-25",2014,6,176,55900,89700,41400,187000
"TR","2014-06-26",2014,6,177,106000,88300,42300,236600
"TR","2014-06-27",2014,6,178,183000,94800,52100,329900
"TR","2014-06-28",2014,6,179,0,85000,40500,125500
"TR","2014-06-29",2014,6,180,718000,130000,102000,950000
"TR","2014-06-30",2014,6,181,230000,116000,56000,402000
"TR","2014-07-01",2014,7,182,7210,104000,39000,150210
"TR","2014-07-02",2014,7,183,2800,97600,39100,139500
"TR","2014-07-03",2014,7,184,162000,99000,41900,302900
"TR","2014-07-04",2014,7,185,0,93100,40000,133100
"TR","2014-07-05",2014,7,186,4540,85800,40100,130440
"TR","2014-07-06",2014,7,187,0,78900,39000,117900
"TR","2014-07-07",2014,7,188,35000,75200,39000,149200
"TR","2014-07-08",2014,7,189,207000,81600,41900,330500
"TR","2014-07-09",2014,7,190,137000,84200,42300,263500
"TR","2014-07-10",2014,7,191,9330,78100,40500,127930
"TR","2014-07-11",2014,7,192,0,73500,40000,113500
"TR","2014-07-12",2014,7,193,0,70000,39900,109900
"TR","2014-07-13",2014,7,194,5610,66900,39400,111910
"TR","2014-07-14",2014,7,195,12300,64500,39000,115800
"TR","2014-07-15",2014,7,196,0,62400,38600,101000
"TR","2014-07-16",2014,7,197,136000,67300,39800,243100
"TR","2014-07-17",2014,7,198,885,64600,38700,104185
"TR","2014-07-18",2014,7,199,0,62000,38700,100700
"TR","2014-07-19",2014,7,200,0,59900,38500,98400
"TR","2014-07-20",2014,7,201,0,58200,38400,96600
"TR","2014-07-21",2014,7,202,0,57200,38200,95400
"TR","2014-07-22",2014,7,203,41600,57400,38300,137300
"TR","2014-07-23",2014,7,204,44100,57400,38200,139700
"TR","2014-07-24",2014,7,205,0,56000,37900,93900
"TR","2014-07-25",2014,7,206,0,55300,37800,93100
"TR","2014-07-26",2014,7,207,12600,54900,37600,105100
"TR","2014-07-27",2014,7,208,71400,55800,38000,165200
"TR","2014-07-28",2014,7,209,77300,56600,38000,171900
"TR","2014-07-29",2014,7,210,138000,59900,38500,236400
"TR","2014-07-30",2014,7,211,46600,59600,37900,144100
"TR","2014-07-31",2014,7,212,5610,57600,37600,100810
"TR","2014-08-01",2014,8,213,0,55900,37500,93400
"TR","2014-08-02",2014,8,214,0,55100,37800,92900
"TR","2014-08-03",2014,8,215,0,53900,38000,91900
"TR","2014-08-04",2014,8,216,0,52900,37900,90800
"TR","2014-08-05",2014,8,217,76000,53900,38200,168100
"TR","2014-08-06",2014,8,218,67800,54500,38300,160600
"TR","2014-08-07",2014,8,219,0,53400,37900,91300
"TR","2014-08-08",2014,8,220,0,52800,37900,90700
"TR","2014-08-09",2014,8,221,0,52100,37900,90000
"TR","2014-08-10",2014,8,222,0,51500,37800,89300
"TR","2014-08-11",2014,8,223,0,50900,37800,88700
"TR","2014-08-12",2014,8,224,4860,50400,37500,92760
"TR","2014-08-13",2014,8,225,450000,63900,40900,554800
"TR","2014-08-14",2014,8,226,0,57800,37500,95300
"TR","2014-08-15",2014,8,227,0,55400,38000,93400
"TR","2014-08-16",2014,8,228,0,53900,37900,91800
"TR","2014-08-17",2014,8,229,0,52600,37800,90400
"TR","2014-08-18",2014,8,230,210000,57400,39300,306700
"TR","2014-08-19",2014,8,231,203000,67300,39900,310200
"TR","2014-08-20",2014,8,232,62000,65100,37600,164700
"TR","2014-08-21",2014,8,233,0,61400,37100,98500
"TR","2014-08-22",2014,8,234,0,58900,37200,96100
"TR","2014-08-23",2014,8,235,4220,56600,37200,98020
"TR","2014-08-24",2014,8,236,2110,54600,37100,93810
"TR","2014-08-25",2014,8,237,0,53400,36900,90300
"TR","2014-08-26",2014,8,238,321000,66700,39200,426900
"TR","2014-08-27",2014,8,239,0,60400,36400,96800
"TR","2014-08-28",2014,8,240,18500,58500,36500,113500
"TR","2014-08-29",2014,8,241,0,56400,36400,92800
"TR","2014-08-30",2014,8,242,46700,56500,36600,139800
"TR","2014-08-31",2014,8,243,537000,89800,43400,670200
"TR","2014-09-01",2014,9,244,92900,78400,36900,208200
"TR","2014-09-02",2014,9,245,155000,81300,43000,279300
"TR","2014-09-03",2014,9,246,70400,76700,37300,184400
"TR","2014-09-04",2014,9,247,0,70500,34900,105400
"TR","2014-09-05",2014,9,248,420000,96600,61700,578300
"TR","2014-09-06",2014,9,249,529000,114000,80400,723400
"TR","2014-09-07",2014,9,250,0,97700,33400,131100
"TR","2014-09-08",2014,9,251,4270,92100,34400,130770
"TR","2014-09-09",2014,9,252,0,87300,34900,122200
"TR","2014-09-10",2014,9,253,7610,81200,35300,124110
"TR","2014-09-11",2014,9,254,245000,90100,42200,377300
"TR","2014-09-12",2014,9,255,453000,110000,72700,635700
"TR","2014-09-13",2014,9,256,941,95100,36000,132041
"TR","2014-09-14",2014,9,257,107000,95700,42000,244700
"TR","2014-09-15",2014,9,258,0,90300,36100,126400
"TR","2014-09-16",2014,9,259,0,85600,36600,122200
"TR","2014-09-17",2014,9,260,0,80500,36600,117100
"TR","2014-09-18",2014,9,261,0,76200,36700,112900
"TR","2014-09-19",2014,9,262,0,72600,36800,109400
"TR","2014-09-20",2014,9,263,0,69500,36700,106200
"TR","2014-09-21",2014,9,264,0,66700,36800,103500
"TR","2014-09-22",2014,9,265,137000,71400,38400,246800
"TR","2014-09-23",2014,9,266,0,68200,37200,105400
"TR","2014-09-24",2014,9,267,0,66100,37400,103500
"TR","2014-09-25",2014,9,268,0,64000,37200,101200
"TR","2014-09-26",2014,9,269,44100,65200,37200,146500
"TR","2014-09-27",2014,9,270,0,63800,37400,101200
"TR","2014-09-28",2014,9,271,0,62100,37400,99500
"TR","2014-09-29",2014,9,272,0,60400,37200,97600
"TR","2014-09-30",2014,9,273,37500,60300,37200,135000
"TR","2014-10-01",2014,10,274,15800,60100,37000,112900
"TR","2014-10-02",2014,10,275,20800,60300,37200,118300
"TR","2014-10-03",2014,10,276,48600,61400,37500,147500
"TR","2014-10-04",2014,10,277,367000,85000,42100,494100
"TR","2014-10-05",2014,10,278,223000,93600,54200,370800
"TR","2014-10-06",2014,10,279,36200,85900,41500,163600
"TR","2014-10-07",2014,10,280,0,79500,36600,116100
"TR","2014-10-08",2014,10,281,21200,76500,37100,134800
"TR","2014-10-09",2014,10,282,0,73100,37000,110100
"TR","2014-10-10",2014,10,283,0,70600,37000,107600
"TR","2014-10-11",2014,10,284,0,68900,37000,105900
"TR","2014-10-12",2014,10,285,0,67500,36900,104400
"TR","2014-10-13",2014,10,286,0,66200,36800,103000
"TR","2014-10-14",2014,10,287,9870,65400,36800,112070
"TR","2014-10-15",2014,10,288,431000,98500,61400,590900
"TR","2014-10-16",2014,10,289,83300,90600,45200,219100
"TR","2014-10-17",2014,10,290,0,83600,37000,120600
"TR","2014-10-18",2014,10,291,29700,80200,37200,147100
"TR","2014-10-19",2014,10,292,38000,78600,37700,154300
"TR","2014-10-20",2014,10,293,2280,75200,37300,114780
"TR","2014-10-21",2014,10,294,8070,73100,37500,118670
"TR","2014-10-22",2014,10,295,15600,71600,37500,124700
"TR","2014-10-23",2014,10,296,0,69500,37200,106700
"TR","2014-10-24",2014,10,297,11600,68600,37300,117500
"TR","2014-10-25",2014,10,298,58400,70600,37800,166800
"TR","2014-10-26",2014,10,299,0,68900,37600,106500
"TR","2014-10-27",2014,10,300,0,67000,37300,104300
"TR","2014-10-28",2014,10,301,124000,75400,39300,238700
"TR","2014-10-29",2014,10,302,46500,76200,40000,162700
"TR","2014-10-30",2014,10,303,39300,75800,40500,155600
"TR","2014-10-31",2014,10,304,9320,72600,37400,119320
"TR","2014-11-01",2014,11,305,151000,74500,36900,262400
"TR","2014-11-02",2014,11,306,0,72600,36800,109400
"TR","2014-11-03",2014,11,307,0,71200,37200,108400
"TR","2014-11-04",2014,11,308,0,73400,43500,116900
"TR","2014-11-05",2014,11,309,52700,73000,40100,165800
"TR","2014-11-06",2014,11,310,5240,70900,38000,114140
"TR","2014-11-07",2014,11,311,138000,73900,38900,250800
"TR","2014-11-08",2014,11,312,0,71600,37000,108600
"TR","2014-11-09",2014,11,313,103000,73000,36800,212800
"TR","2014-11-10",2014,11,314,50200,72800,36400,159400
"TR","2014-11-11",2014,11,315,0,71000,36600,107600
"TR","2014-11-12",2014,11,316,403000,78600,35200,516800
"TR","2014-11-13",2014,11,317,157000,80600,34500,272100
"TR","2014-11-14",2014,11,318,71200,79000,34500,184700
"TR","2014-11-15",2014,11,319,21000,76500,34800,132300
"TR","2014-11-16",2014,11,320,0,74000,35100,109100
"TR","2014-11-17",2014,11,321,10300,72400,35400,118100
"TR","2014-11-18",2014,11,322,0,70800,35600,106400
"TR","2014-11-19",2014,11,323,8540,69700,35700,113940
"TR","2014-11-20",2014,11,324,18000,69100,35800,122900
"TR","2014-11-21",2014,11,325,7220,68400,35900,111520
"TR","2014-11-22",2014,11,326,0,67500,36000,103500
"TR","2014-11-23",2014,11,327,0,66700,36100,102800
"TR","2014-11-24",2014,11,328,3530,65900,36300,105730
"TR","2014-11-25",2014,11,329,73300,69600,43000,185900
"TR","2014-11-26",2014,11,330,298000,74800,35500,408300
"TR","2014-11-27",2014,11,331,0,72400,34600,107000
"TR","2014-11-28",2014,11,332,50300,71600,34800,156700
"TR","2014-11-29",2014,11,333,0,69900,35000,104900
"TR","2014-11-30",2014,11,334,9010,68700,35200,112910
"TR","2014-12-01",2014,12,335,0,67400,35400,102800
"TR","2014-12-02",2014,12,336,0,66600,35600,102200
"TR","2014-12-03",2014,12,337,0,65800,35600,101400
"TR","2014-12-04",2014,12,338,15400,65700,35600,116700
"TR","2014-12-05",2014,12,339,0,65100,35600,100700
"TR","2014-12-06",2014,12,340,0,64600,35700,100300
"TR","2014-12-07",2014,12,341,0,64100,35700,99800
"TR","2014-12-08",2014,12,342,0,63700,35700,99400
"TR","2014-12-09",2014,12,343,11000,63600,35700,110300
"TR","2014-12-10",2014,12,344,0,63200,35700,98900
"TR","2014-12-11",2014,12,345,0,62900,35700,98600
"TR","2014-12-12",2014,12,346,0,62700,35700,98400
"TR","2014-12-13",2014,12,347,0,62400,35700,98100
"TR","2014-12-14",2014,12,348,0,62100,35700,97800
"TR","2014-12-15",2014,12,349,2440,62000,35600,100040
"TR","2014-12-16",2014,12,350,6600,64300,37900,108800
"TR","2014-12-17",2014,12,351,148000,68600,39800,256400
"TR","2014-12-18",2014,12,352,45200,67500,35000,147700
"TR","2014-12-19",2014,12,353,0,65900,34800,100700
"TR","2014-12-20",2014,12,354,0,64900,34900,99800
"TR","2014-12-21",2014,12,355,0,64000,35000,99000
"TR","2014-12-22",2014,12,356,0,63300,35000,98300
"TR","2014-12-23",2014,12,357,67600,64400,34800,166800
"TR","2014-12-24",2014,12,358,30800,64200,34600,129600
"TR","2014-12-25",2014,12,359,66600,65200,34400,166200
"TR","2014-12-26",2014,12,360,0,64100,34400,98500
"TR","2014-12-27",2014,12,361,17700,63600,34500,115800
"TR","2014-12-28",2014,12,362,71000,64800,34200,170000
"TR","2014-12-29",2014,12,363,65300,65200,33900,164400
"TR","2014-12-30",2014,12,364,56200,65100,33800,155100
"TR","2014-12-31",2014,12,365,0,64000,33900,97900
"TR","2015-01-01",2015,1,1,0,63000,34000,97000
"TR","2015-01-02",2015,1,2,25100,62900,34000,122000
"TR","2015-01-03",2015,1,3,4940,62200,34100,101240
"TR","2015-01-04",2015,1,4,0,61600,34100,95700
"TR","2015-01-05",2015,1,5,60800,62500,33900,157200
"TR","2015-01-06",2015,1,6,0,61800,33900,95700
"TR","2015-01-07",2015,1,7,0,61200,34000,95200
"TR","2015-01-08",2015,1,8,24700,61200,33900,119800
"TR","2015-01-09",2015,1,9,0,60600,34000,94600
"TR","2015-01-10",2015,1,10,75500,62000,33700,171200
"TR","2015-01-11",2015,1,11,0,61200,33600,94800
"TR","2015-01-12",2015,1,12,0,60600,33700,94300
"TR","2015-01-13",2015,1,13,7600,60200,33800,101600
"TR","2015-01-14",2015,1,14,0,59700,33800,93500
"TR","2015-01-15",2015,1,15,3750,59400,33800,96950
"TR","2015-01-16",2015,1,16,0,59000,33800,92800
"TR","2015-01-17",2015,1,17,0,58600,33800,92400
"TR","2015-01-18",2015,1,18,0,58200,33900,92100
"TR","2015-01-19",2015,1,19,0,57800,33900,91700
"TR","2015-01-20",2015,1,20,5630,57700,33900,97230
"TR","2015-01-21",2015,1,21,12100,57700,33800,103600
"TR","2015-01-22",2015,1,22,0,57400,33800,91200
"TR","2015-01-23",2015,1,23,0,57100,33800,90900
"TR","2015-01-24",2015,1,24,0,56900,33800,90700
"TR","2015-01-25",2015,1,25,0,56600,33800,90400
"TR","2015-01-26",2015,1,26,0,56400,33700,90100
"TR","2015-01-27",2015,1,27,3750,56400,33700,93850
"TR","2015-01-28",2015,1,28,82300,58300,33200,173800
"TR","2015-01-29",2015,1,29,0,57700,33200,90900
"TR","2015-01-30",2015,1,30,0,57100,33200,90300
"TR","2015-01-31",2015,1,31,12700,57100,33200,103000
"TR","2015-02-01",2015,2,32,0,56700,33200,89900
"TR","2015-02-02",2015,2,33,0,56400,33200,89600
"TR","2015-02-03",2015,2,34,0,56200,33200,89400
"TR","2015-02-04",2015,2,35,0,56000,33100,89100
"TR","2015-02-05",2015,2,36,2640,55900,33100,91640
"TR","2015-02-06",2015,2,37,0,55700,33100,88800
"TR","2015-02-07",2015,2,38,0,55500,33000,88500
"TR","2015-02-08",2015,2,39,0,55300,33000,88300
"TR","2015-02-09",2015,2,40,0,55100,33000,88100
"TR","2015-02-10",2015,2,41,0,54900,32900,87800
"TR","2015-02-11",2015,2,42,0,54800,32900,87700
"TR","2015-02-12",2015,2,43,22100,55200,32700,110000
"TR","2015-02-13",2015,2,44,15500,55300,32600,103400
"TR","2015-02-14",2015,2,45,0,55000,32600,87600
"TR","2015-02-15",2015,2,46,22100,55300,32500,109900
"TR","2015-02-16",2015,2,47,0,55000,32400,87400
"TR","2015-02-17",2015,2,48,0,54700,32400,87100
"TR","2015-02-18",2015,2,49,0,54500,32400,86900
"TR","2015-02-19",2015,2,50,1420,54300,32400,88120
"TR","2015-02-20",2015,2,51,0,54100,32300,86400
"TR","2015-02-21",2015,2,52,0,53900,32300,86200
"TR","2015-02-22",2015,2,53,22600,54300,32200,109100
"TR","2015-02-23",2015,2,54,0,54100,32100,86200
"TR","2015-02-24",2015,2,55,0,53800,32100,85900
"TR","2015-02-25",2015,2,56,1130,53600,32100,86830
"TR","2015-02-26",2015,2,57,12700,53700,32000,98400
"TR","2015-02-27",2015,2,58,0,53400,31900,85300
"TR","2015-02-28",2015,2,59,0,53300,31900,85200
"TR","2015-03-01",2015,3,60,0,53200,31900,85100
"TR","2015-03-02",2015,3,61,0,53100,31900,85000
"TR","2015-03-03",2015,3,62,0,53000,31800,84800
"TR","2015-03-04",2015,3,63,0,52900,31800,84700
"TR","2015-03-05",2015,3,64,56800,53500,31500,141800
"TR","2015-03-06",2015,3,65,0,53200,31500,84700
"TR","2015-03-07",2015,3,66,0,53000,31500,84500
"TR","2015-03-08",2015,3,67,0,52800,31500,84300
"TR","2015-03-09",2015,3,68,0,52600,31600,84200
"TR","2015-03-10",2015,3,69,0,52400,31600,84000
"TR","2015-03-11",2015,3,70,0,52000,31700,83700
"TR","2015-03-12",2015,3,71,0,51700,31800,83500
"TR","2015-03-13",2015,3,72,0,51400,31800,83200
"TR","2015-03-14",2015,3,73,0,51200,31800,83000
"TR","2015-03-15",2015,3,74,0,51900,31900,83800
"TR","2015-03-16",2015,3,75,0,52400,32800,85200
"TR","2015-03-17",2015,3,76,0,62800,56600,119400
"TR","2015-03-18",2015,3,77,60900,61700,43500,166100
"TR","2015-03-19",2015,3,78,0,58000,32000,90000
"TR","2015-03-20",2015,3,79,0,57200,33400,90600
"TR","2015-03-21",2015,3,80,0,58400,36300,94700
"TR","2015-03-22",2015,3,81,17900,64400,45800,128100
"TR","2015-03-23",2015,3,82,0,59500,32300,91800
"TR","2015-03-24",2015,3,83,0,57700,32100,89800
"TR","2015-03-25",2015,3,84,0,58000,33700,91700
"TR","2015-03-26",2015,3,85,123000,64600,40600,228200
"TR","2015-03-27",2015,3,86,7840,60500,32400,100740
"TR","2015-03-28",2015,3,87,0,58800,31900,90700
"TR","2015-03-29",2015,3,88,0,57500,32000,89500
"TR","2015-03-30",2015,3,89,0,56300,32100,88400
"TR","2015-03-31",2015,3,90,128000,59000,31700,218700
"TR","2015-04-01",2015,4,91,6700,65000,34100,105800
"TR","2015-04-02",2015,4,92,0,69600,51300,120900
"TR","2015-04-03",2015,4,93,52200,129000,108000,289200
"TR","2015-04-04",2015,4,94,0,82500,45900,128400
"TR","2015-04-05",2015,4,95,0,75800,33500,109300
"TR","2015-04-06",2015,4,96,0,71900,39300,111200
"TR","2015-04-07",2015,4,97,186000,78500,40900,305400
"TR","2015-04-08",2015,4,98,4230,75000,38100,117330
"TR","2015-04-09",2015,4,99,47100,73400,36000,156500
"TR","2015-04-10",2015,4,100,277000,86800,48900,412700
"TR","2015-04-11",2015,4,101,306000,90400,40500,436900
"TR","2015-04-12",2015,4,102,0,89100,41500,130600
"TR","2015-04-13",2015,4,103,0,82600,38800,121400
"TR","2015-04-14",2015,4,104,105000,83700,39700,228400
"TR","2015-04-15",2015,4,105,0,76700,32800,109500
"TR","2015-04-16",2015,4,106,0,72600,33100,105700
"TR","2015-04-17",2015,4,107,0,69300,33200,102500
"TR","2015-04-18",2015,4,108,0,66700,33200,99900
"TR","2015-04-19",2015,4,109,0,64500,33100,97600
"TR","2015-04-20",2015,4,110,28400,64100,33300,125800
"TR","2015-04-21",2015,4,111,97700,66700,34300,198700
"TR","2015-04-22",2015,4,112,203000,72900,34600,310500
"TR","2015-04-23",2015,4,113,149000,77600,38500,265100
"TR","2015-04-24",2015,4,114,19600,72800,34700,127100
"TR","2015-04-25",2015,4,115,0,72800,41100,113900
"TR","2015-04-26",2015,4,116,4820,69800,35100,109720
"TR","2015-04-27",2015,4,117,0,67100,34800,101900
"TR","2015-04-28",2015,4,118,0,65000,34800,99800
"TR","2015-04-29",2015,4,119,0,63100,34600,97700
"TR","2015-04-30",2015,4,120,0,61800,34400,96200
"TR","2015-05-01",2015,5,121,0,60700,34100,94800
"TR","2015-05-02",2015,5,122,0,59300,34200,93500
"TR","2015-05-03",2015,5,123,0,57900,34000,91900
"TR","2015-05-04",2015,5,124,0,56800,33700,90500
"TR","2015-05-05",2015,5,125,288000,72300,48500,408800
"TR","2015-05-06",2015,5,126,0,64600,34100,98700
"TR","2015-05-07",2015,5,127,24900,63200,34200,122300
"TR","2015-05-08",2015,5,128,92900,65500,35100,193500
"TR","2015-05-09",2015,5,129,134000,68900,35800,238700
"TR","2015-05-10",2015,5,130,14600,65000,34300,113900
"TR","2015-05-11",2015,5,131,0,62200,34100,96300
"TR","2015-05-12",2015,5,132,170000,68700,36100,274800
"TR","2015-05-13",2015,5,133,97100,70800,37300,205200
"TR","2015-05-14",2015,5,134,32300,68300,34900,135500
"TR","2015-05-15",2015,5,135,0,65100,34500,99600
"TR","2015-05-16",2015,5,136,306000,84400,56700,447100
"TR","2015-05-17",2015,5,137,2390,73200,33700,109290
"TR","2015-05-18",2015,5,138,0,68500,33700,102200
"TR","2015-05-19",2015,5,139,54300,67600,34100,156000
"TR","2015-05-20",2015,5,140,6540,64900,33600,105040
"TR","2015-05-21",2015,5,141,0,62600,33500,96100
"TR","2015-05-22",2015,5,142,0,60500,33800,94300
"TR","2015-05-23",2015,5,143,0,58000,33500,91500
"TR","2015-05-24",2015,5,144,0,55700,33200,88900
"TR","2015-05-25",2015,5,145,0,54000,33100,87100
"TR","2015-05-26",2015,5,146,589000,84000,39300,712300
"TR","2015-05-27",2015,5,147,113000,77200,37300,227500
"TR","2015-05-28",2015,5,148,386000,100000,61400,547400
"TR","2015-05-29",2015,5,149,38300,86900,34600,159800
"TR","2015-05-30",2015,5,150,1400,78300,32100,111800
"TR","2015-05-31",2015,5,151,293000,92500,44400,429900
"TR","2015-06-01",2015,6,152,9800,81800,33000,124600
"TR","2015-06-02",2015,6,153,0,76300,33200,109500
"TR","2015-06-03",2015,6,154,0,72000,33500,105500
"TR","2015-06-04",2015,6,155,0,67900,33500,101400
"TR","2015-06-05",2015,6,156,792000,121000,75000,988000
"TR","2015-06-06",2015,6,157,22100,94000,32600,148700
"TR","2015-06-07",2015,6,158,0,88600,32800,121400
"TR","2015-06-08",2015,6,159,304000,102000,50000,456000
"TR","2015-06-09",2015,6,160,31500,91500,34100,157100
"TR","2015-06-10",2015,6,161,18100,85700,34300,138100
"TR","2015-06-11",2015,6,162,56200,82400,35200,173800
"TR","2015-06-12",2015,6,163,0,76600,34600,111200
"TR","2015-06-13",2015,6,164,2790,72600,34800,110190
"TR","2015-06-14",2015,6,165,0,68900,34800,103700
"TR","2015-06-15",2015,6,166,2e+05,74900,36900,311800
"TR","2015-06-16",2015,6,167,0,69800,35300,105100
"TR","2015-06-17",2015,6,168,266000,82300,39200,387500
"TR","2015-06-18",2015,6,169,8040,74000,36000,118040
"TR","2015-06-19",2015,6,170,96300,75100,37300,208700
"TR","2015-06-20",2015,6,171,0,70000,36200,106200
"TR","2015-06-21",2015,6,172,0,66400,35800,102200
"TR","2015-06-22",2015,6,173,202000,73900,38400,314300
"TR","2015-06-23",2015,6,174,204000,87000,40600,331600
"TR","2015-06-24",2015,6,175,293000,99300,53800,446100
"TR","2015-06-25",2015,6,176,0,84800,35500,120300
"TR","2015-06-26",2015,6,177,162000,88100,40800,290900
"TR","2015-06-27",2015,6,178,42600,82700,36800,162100
"TR","2015-06-28",2015,6,179,0,76800,36200,113000
"TR","2015-06-29",2015,6,180,0,72400,36200,108600
"TR","2015-06-30",2015,6,181,59600,71000,36500,167100
"TR","2015-07-01",2015,7,182,99200,72300,37200,208700
"TR","2015-07-02",2015,7,183,0,67900,36000,103900
"TR","2015-07-03",2015,7,184,0,63800,36100,99900
"TR","2015-07-04",2015,7,185,0,60600,35400,96000
"TR","2015-07-05",2015,7,186,120000,63300,36300,219600
"TR","2015-07-06",2015,7,187,0,59800,35300,95100
"TR","2015-07-07",2015,7,188,61700,59600,35500,156800
"TR","2015-07-08",2015,7,189,233000,68400,37500,338900
"TR","2015-07-09",2015,7,190,0,63200,35500,98700
"TR","2015-07-10",2015,7,191,0,60100,35400,95500
"TR","2015-07-11",2015,7,192,0,57500,35300,92800
"TR","2015-07-12",2015,7,193,0,56100,35100,91200
"TR","2015-07-13",2015,7,194,0,55100,34900,90000
"TR","2015-07-14",2015,7,195,223000,60900,36400,320300
"TR","2015-07-15",2015,7,196,232000,69100,37400,338500
"TR","2015-07-16",2015,7,197,0,62100,35100,97200
"TR","2015-07-17",2015,7,198,0,58000,34800,92800
"TR","2015-07-18",2015,7,199,210000,65100,36700,311800
"TR","2015-07-19",2015,7,200,78400,64600,35900,178900
"TR","2015-07-20",2015,7,201,8710,60900,35200,104810
"TR","2015-07-21",2015,7,202,138000,66500,36600,241100
"TR","2015-07-22",2015,7,203,0,61900,35100,97000
"TR","2015-07-23",2015,7,204,0,58900,34900,93800
"TR","2015-07-24",2015,7,205,0,56400,34600,91000
"TR","2015-07-25",2015,7,206,0,54900,34400,89300
"TR","2015-07-26",2015,7,207,439000,75500,38900,553400
"TR","2015-07-27",2015,7,208,0,65400,34200,99600
"TR","2015-07-28",2015,7,209,0,59900,34500,94400
"TR","2015-07-29",2015,7,210,0,55200,33800,89000
"TR","2015-07-30",2015,7,211,2660,53900,33400,89960
"TR","2015-07-31",2015,7,212,0,53000,33300,86300
"TR","2015-08-01",2015,8,213,61100,53500,33400,148000
"TR","2015-08-02",2015,8,214,59700,53700,33500,146900
"TR","2015-08-03",2015,8,215,0,52700,33500,86200
"TR","2015-08-04",2015,8,216,69200,53700,34000,156900
"TR","2015-08-05",2015,8,217,14100,53000,34000,101100
"TR","2015-08-06",2015,8,218,0,52100,34100,86200
"TR","2015-08-07",2015,8,219,0,51500,34200,85700
"TR","2015-08-08",2015,8,220,238000,56300,35600,329900
"TR","2015-08-09",2015,8,221,70500,55800,34900,161200
"TR","2015-08-10",2015,8,222,110000,57800,35100,202900
"TR","2015-08-11",2015,8,223,103000,59400,35300,197700
"TR","2015-08-12",2015,8,224,0,56000,34600,90600
"TR","2015-08-13",2015,8,225,0,53800,35000,88800
"TR","2015-08-14",2015,8,226,0,52300,34800,87100
"TR","2015-08-15",2015,8,227,0,51400,34700,86100
"TR","2015-08-16",2015,8,228,0,50300,34800,85100
"TR","2015-08-17",2015,8,229,0,49300,34500,83800
"TR","2015-08-18",2015,8,230,118000,51100,34900,204000
"TR","2015-08-19",2015,8,231,38400,50900,34500,123800
"TR","2015-08-20",2015,8,232,263000,57100,35900,356000
"TR","2015-08-21",2015,8,233,144000,59600,35400,239000
"TR","2015-08-22",2015,8,234,43800,58200,34400,136400
"TR","2015-08-23",2015,8,235,0,55100,34300,89400
"TR","2015-08-24",2015,8,236,146000,59300,35300,240600
"TR","2015-08-25",2015,8,237,359000,83600,37800,480400
"TR","2015-08-26",2015,8,238,2660,71300,32800,106760
"TR","2015-08-27",2015,8,239,0,66400,33100,99500
"TR","2015-08-28",2015,8,240,0,62200,33500,95700
"TR","2015-08-29",2015,8,241,0,57900,33600,91500
"TR","2015-08-30",2015,8,242,0,55100,33400,88500
"TR","2015-08-31",2015,8,243,0,53200,33400,86600
"TR","2015-09-01",2015,9,244,0,52300,33300,85600
"TR","2015-09-02",2015,9,245,0,51500,33400,84900
"TR","2015-09-03",2015,9,246,92400,52800,33600,178800
"TR","2015-09-04",2015,9,247,315000,64600,35800,415400
"TR","2015-09-05",2015,9,248,0,58200,33300,91500
"TR","2015-09-06",2015,9,249,0,55200,33600,88800
"TR","2015-09-07",2015,9,250,0,52900,33700,86600
"TR","2015-09-08",2015,9,251,162000,57100,34700,253800
"TR","2015-09-09",2015,9,252,23500,54800,33700,112000
"TR","2015-09-10",2015,9,253,57600,55300,34000,146900
"TR","2015-09-11",2015,9,254,34100,54800,33800,122700
"TR","2015-09-12",2015,9,255,0,53000,33500,86500
"TR","2015-09-13",2015,9,256,1670,52500,33500,87670
"TR","2015-09-14",2015,9,257,0,51900,33500,85400
"TR","2015-09-15",2015,9,258,0,51300,33400,84700
"TR","2015-09-16",2015,9,259,0,50700,33400,84100
"TR","2015-09-17",2015,9,260,1320,49900,33300,84520
"TR","2015-09-18",2015,9,261,0,49100,33300,82400
"TR","2015-09-19",2015,9,262,116000,51100,33700,200800
"TR","2015-09-20",2015,9,263,49100,51200,33400,133700
"TR","2015-09-21",2015,9,264,0,50400,33000,83400
"TR","2015-09-22",2015,9,265,0,49900,33100,83000
"TR","2015-09-23",2015,9,266,0,49200,33100,82300
"TR","2015-09-24",2015,9,267,4510,48600,33000,86110
"TR","2015-09-25",2015,9,268,8020,48200,32900,89120
"TR","2015-09-26",2015,9,269,4310,47700,32800,84810
"TR","2015-09-27",2015,9,270,0,47300,32800,80100
"TR","2015-09-28",2015,9,271,0,46900,32800,79700
"TR","2015-09-29",2015,9,272,13200,46600,32700,92500
"TR","2015-09-30",2015,9,273,27900,46800,32600,107300
"TR","2015-10-01",2015,10,274,0,46500,32400,78900
